watch,combination,risk,dist,samples,meanRSS,maxRSS,minRSS,rangeRSS
31,RL,1,50,8,-73.5,-68,-79,11
31,RL,0,50,2,-69,-68,-70,2
31,RL,1,50,3,-72.3333333333333,-71,-73,2
31,RL,1,50,5,-76.2,-73,-80,7
31,RL,0,50,2,-76,-74,-78,4
31,RL,0,50,1,-71,-71,-71,0
31,RL,1,50,6,-72.5,-68,-75,7
31,RL,1,50,4,-72,-68,-75,7
31,RL,1,50,8,-73.375,-71,-76,5
31,RL,1,50,3,-74.6666666666667,-74,-76,2
31,RL,1,50,7,-72.4285714285714,-69,-75,6
31,RL,0,50,2,-71,-71,-71,0
31,RL,1,50,7,-68.8571428571429,-67,-73,6
31,RL,1,50,4,-67.75,-67,-70,3
31,RL,1,50,10,-69.4,-67,-73,6
31,RL,1,50,9,-69.6666666666667,-67,-73,6
31,RL,0,50,2,-67.5,-66,-69,3
31,RL,0,50,1,-72,-72,-72,0
31,RL,1,50,6,-68.1666666666667,-66,-70,4
31,RL,1,50,7,-68.7142857142857,-66,-70,4
31,RL,1,50,7,-69.1428571428571,-67,-70,3
31,RL,0,50,2,-67,-67,-67,0
31,RL,1,50,4,-69,-68,-70,2
31,RL,1,50,6,-67.5,-66,-70,4
31,RL,1,50,8,-66.75,-66,-68,2
31,RL,1,50,8,-67.375,-66,-70,4
31,RL,1,50,6,-69.6666666666667,-68,-72,4
31,RL,0,50,1,-70,-70,-70,0
31,RL,1,50,4,-70,-70,-70,0
31,RL,1,50,10,-69.1,-68,-71,3
31,RL,1,50,5,-68.6,-68,-71,3
31,RL,1,50,7,-69.2857142857143,-68,-71,3
31,RL,1,50,7,-69.7142857142857,-68,-71,3
31,RL,1,50,6,-69.3333333333333,-68,-70,2
31,RL,1,50,4,-69.25,-68,-70,2
31,RL,0,50,2,-69,-68,-70,2
31,RL,1,50,9,-68.8888888888889,-67,-72,5
31,RL,0,50,2,-70.5,-69,-72,3
31,RL,1,50,4,-68.25,-67,-70,3
31,RL,0,50,1,-70,-70,-70,0
31,RL,1,50,4,-69.5,-67,-71,4
31,RL,1,50,4,-69.5,-68,-70,2
31,RL,1,50,8,-68.5,-67,-70,3
31,RL,0,50,2,-68.5,-67,-70,3
31,RL,0,50,2,-69.5,-67,-72,5
31,RL,1,50,9,-67.4444444444444,-66,-69,3
31,RL,1,50,10,-67.7,-66,-69,3
31,RL,1,50,8,-67.5,-66,-69,3
31,RL,1,50,6,-67.3333333333333,-66,-69,3
31,RL,1,50,9,-67.4444444444444,-66,-69,3
31,RL,1,50,7,-68.2857142857143,-66,-70,4
31,RL,0,50,1,-68,-68,-68,0
31,RL,1,50,5,-67.8,-67,-69,2
31,RL,1,50,3,-66.3333333333333,-66,-67,1
31,RL,1,50,5,-67,-65,-68,3
31,RL,1,50,9,-68.2222222222222,-66,-70,4
31,RL,1,50,10,-68.2,-66,-72,6
31,RL,1,50,6,-67,-66,-69,3
31,RL,1,50,5,-67.2,-66,-69,3
31,RL,1,50,4,-67,-66,-68,2
31,RL,1,50,8,-67.375,-66,-70,4
31,RL,1,50,3,-66.6666666666667,-66,-68,2
31,RL,1,50,10,-70.5,-67,-76,9
31,RL,0,50,1,-68,-68,-68,0
31,RL,1,50,5,-71.8,-67,-76,9
31,RL,1,50,9,-71.1111111111111,-68,-73,5
31,RL,1,50,9,-67.7777777777778,-66,-69,3
31,RL,1,50,3,-68,-66,-69,3
31,RL,1,50,3,-65.3333333333333,-65,-66,1
31,RL,0,50,1,-70,-70,-70,0
31,RL,1,50,8,-67.375,-63,-71,8
31,RL,1,50,9,-66.8888888888889,-63,-71,8
31,RL,0,50,1,-69,-69,-69,0
31,RL,1,50,7,-66.7142857142857,-64,-70,6
31,RL,1,50,7,-68.4285714285714,-66,-70,4
31,RL,0,50,1,-69,-69,-69,0
31,RL,1,50,3,-66.3333333333333,-66,-67,1
31,RL,1,50,10,-66.6,-65,-68,3
31,RL,1,50,6,-66.6666666666667,-66,-68,2
31,RL,1,50,6,-66.5,-66,-68,2
31,RL,1,50,8,-65.5,-63,-69,6
31,RL,1,50,4,-69.25,-67,-73,6
31,RL,0,50,1,-68,-68,-68,0
31,RL,1,50,3,-68.3333333333333,-66,-73,7
31,RL,1,50,4,-69.5,-66,-76,10
31,RL,1,50,9,-68,-67,-71,4
31,RL,1,50,3,-69,-68,-71,3
31,RL,1,50,6,-69.6666666666667,-68,-72,4
31,RL,1,50,9,-72.5555555555556,-68,-87,19
31,RL,0,50,1,-70,-70,-70,0
31,RL,1,50,7,-82.2857142857143,-70,-93,23
31,RL,1,50,6,-83.3333333333333,-75,-93,18
31,RL,1,50,10,-71.6,-68,-75,7
31,RL,1,50,5,-69.4,-67,-72,5
31,RL,1,50,3,-70,-67,-72,5
31,RL,0,50,1,-71,-71,-71,0
31,RL,1,50,7,-68,-66,-72,6
31,RL,1,50,6,-68.1666666666667,-66,-72,6
31,RL,1,50,10,-70.7,-66,-76,10
31,RL,1,50,3,-72.6666666666667,-70,-76,6
31,RL,0,50,1,-70,-70,-70,0
31,RL,1,50,9,-75,-70,-77,7
31,RL,0,50,1,-73,-73,-73,0
31,RL,1,50,4,-76.5,-76,-77,1
31,RL,1,50,8,-80.125,-76,-86,10
31,RL,1,50,3,-78.3333333333333,-73,-82,9
31,RL,1,50,8,-75.5,-73,-82,9
31,RL,1,50,9,-75.1111111111111,-73,-78,5
31,RL,1,50,6,-75.8333333333333,-72,-79,7
31,RL,1,50,9,-73.1111111111111,-72,-75,3
31,RL,0,50,1,-72,-72,-72,0
31,RL,1,50,6,-74.1666666666667,-72,-82,10
31,RL,1,50,8,-76.75,-73,-83,10
31,RL,1,50,3,-76.3333333333333,-73,-82,9
31,RL,0,50,1,-74,-74,-74,0
31,RL,0,50,2,-79,-75,-83,8
31,RL,1,50,8,-73.5,-72,-80,8
31,RL,1,50,5,-72,-72,-72,0
31,RL,1,50,9,-72.7777777777778,-69,-75,6
31,RL,1,50,7,-73,-71,-74,3
31,RL,0,50,2,-73,-73,-73,0
31,RL,0,50,2,-74,-74,-74,0
31,RL,1,50,8,-74,-71,-76,5
31,RL,1,50,4,-72.5,-70,-76,6
31,RL,1,50,4,-71.75,-69,-76,7
31,RL,1,50,3,-70.6666666666667,-70,-71,1
31,RL,0,50,1,-72,-72,-72,0
31,RL,1,50,6,-71.5,-69,-74,5
31,RL,1,50,6,-72.1666666666667,-69,-76,7
31,RL,1,50,8,-72.125,-68,-75,7
31,RL,1,50,6,-72.8333333333333,-68,-75,7
31,RL,1,50,6,-73,-68,-77,9
31,RL,1,50,6,-73.3333333333333,-72,-75,3
31,RL,1,50,5,-72.6,-71,-76,5
31,RL,1,50,10,-72,-70,-76,6
31,RL,1,50,7,-71.4285714285714,-70,-74,4
31,RL,1,50,9,-73,-71,-76,5
31,RL,1,50,5,-72.4,-71,-75,4
31,RL,1,50,3,-72.6666666666667,-71,-75,4
31,RL,0,50,1,-75,-75,-75,0
31,RL,1,50,9,-73.3333333333333,-71,-77,6
31,RL,0,50,1,-74,-74,-74,0
31,RL,0,50,2,-74,-74,-74,0
31,RL,0,50,1,-74,-74,-74,0
31,RL,1,50,8,-72.125,-67,-78,11
31,RL,1,50,6,-72.1666666666667,-67,-78,11
31,RL,1,50,5,-73.6,-72,-75,3
31,RL,1,50,10,-73.7,-70,-76,6
31,RL,1,50,7,-73.4285714285714,-70,-76,6
31,RL,0,50,1,-70,-70,-70,0
31,RL,0,50,2,-72.5,-72,-73,1
31,RL,1,50,4,-73,-71,-75,4
31,RL,1,50,9,-73.3333333333333,-71,-76,5
31,RL,1,50,3,-72.6666666666667,-70,-74,4
31,RL,0,50,2,-73,-73,-73,0
31,RL,1,50,10,-72.4,-70,-77,7
31,RL,0,50,2,-73.5,-70,-77,7
31,RL,1,50,10,-72.3,-70,-74,4
31,RL,0,50,1,-73,-73,-73,0
31,RL,1,50,9,-72.2222222222222,-69,-77,8
31,RL,0,50,2,-72.5,-72,-73,1
31,RL,1,50,10,-73.5,-71,-79,8
31,RL,1,50,6,-75.5,-71,-78,7
31,RL,0,50,2,-73.5,-71,-76,5
31,RL,1,50,4,-75.75,-72,-84,12
31,RL,1,50,3,-72.3333333333333,-72,-73,1
31,RL,1,50,3,-72.6666666666667,-72,-74,2
31,RL,1,50,5,-74.4,-71,-77,6
31,RL,1,50,3,-73,-71,-74,3
31,RL,1,50,9,-73.6666666666667,-67,-82,15
31,LR,1,50,9,-61.1111111111111,-60,-63,3
31,LR,0,50,2,-60.5,-60,-61,1
31,LR,0,50,1,-61,-61,-61,0
31,LR,1,50,3,-60.6666666666667,-60,-62,2
31,LR,1,50,9,-60.7777777777778,-60,-62,2
31,LR,1,50,3,-61,-60,-62,2
31,LR,0,50,1,-60,-60,-60,0
31,LR,1,50,4,-62.25,-60,-63,3
31,LR,1,50,8,-62.25,-59,-63,4
31,LR,0,50,1,-61,-61,-61,0
31,LR,1,50,3,-63,-63,-63,0
31,LR,1,50,4,-62,-60,-63,3
31,LR,1,50,5,-61.6,-60,-63,3
31,LR,0,50,1,-60,-60,-60,0
31,LR,1,50,10,-61.3,-59,-62,3
31,LR,0,50,2,-61.5,-61,-62,1
31,LR,1,50,6,-61.1666666666667,-60,-63,3
31,LR,1,50,7,-61.1428571428571,-60,-62,2
31,LR,1,50,9,-60.6666666666667,-59,-62,3
31,LR,1,50,7,-60.2857142857143,-59,-62,3
31,LR,0,50,1,-60,-60,-60,0
31,LR,1,50,9,-63.2222222222222,-59,-66,7
31,LR,1,50,3,-62.6666666666667,-62,-64,2
31,LR,1,50,8,-62,-59,-64,5
31,LR,1,50,9,-62,-59,-64,5
31,LR,1,50,4,-60.25,-59,-62,3
31,LR,1,50,10,-59.2,-58,-60,2
31,LR,1,50,7,-58.8571428571429,-58,-60,2
31,LR,0,50,2,-58.5,-58,-59,1
31,LR,1,50,9,-58.2222222222222,-58,-59,1
31,LR,0,50,1,-58,-58,-58,0
31,LR,1,50,6,-58.5,-58,-59,1
31,LR,1,50,7,-59.4285714285714,-58,-60,2
31,LR,0,50,1,-59,-59,-59,0
31,LR,1,50,10,-59.4,-58,-60,2
31,LR,0,50,1,-58,-58,-58,0
31,LR,0,50,1,-60,-60,-60,0
31,LR,1,50,10,-61.6,-60,-64,4
31,LR,0,50,1,-62,-62,-62,0
31,LR,0,50,1,-62,-62,-62,0
31,LR,1,50,9,-60.7777777777778,-59,-62,3
31,LR,1,50,8,-61.75,-59,-64,5
31,LR,1,50,8,-60.625,-59,-64,5
31,LR,1,50,8,-60.25,-59,-63,4
31,LR,1,50,7,-61.2857142857143,-59,-63,4
31,LR,1,50,10,-59.1,-58,-62,4
31,LR,1,50,8,-59,-58,-61,3
31,LR,0,50,1,-58,-58,-58,0
31,LR,1,50,10,-57.9,-57,-61,4
31,LR,1,50,3,-59.3333333333333,-58,-61,3
31,LR,1,50,9,-57.5555555555556,-56,-61,5
31,LR,1,50,5,-57,-57,-57,0
31,LR,1,50,10,-56.9,-56,-58,2
31,LR,1,50,9,-57.2222222222222,-56,-58,2
31,LR,1,50,6,-56.8333333333333,-56,-58,2
31,LR,1,50,6,-57.1666666666667,-56,-58,2
31,LR,1,50,7,-59.2857142857143,-58,-63,5
31,LR,0,50,1,-58,-58,-58,0
31,LR,1,50,4,-60,-58,-63,5
31,LR,1,50,8,-61,-59,-64,5
31,LR,1,50,9,-61.6666666666667,-59,-65,6
31,LR,1,50,7,-62.4285714285714,-60,-65,5
31,LR,1,50,5,-63.4,-62,-65,3
31,LR,1,50,4,-63.5,-63,-64,1
31,LR,1,50,8,-62.875,-62,-64,2
31,LR,1,50,9,-62.7777777777778,-62,-64,2
31,LR,1,50,4,-61.25,-61,-62,1
31,LR,1,50,10,-61.6,-61,-63,2
31,LR,1,50,7,-61.7142857142857,-61,-63,2
31,LR,1,50,7,-60.7142857142857,-59,-62,3
31,LR,0,50,1,-60,-60,-60,0
31,LR,1,50,10,-59.8,-59,-61,2
31,LR,1,50,8,-59.875,-59,-61,2
31,LR,1,50,3,-60.3333333333333,-60,-61,1
31,LR,1,50,6,-59.6666666666667,-59,-60,1
31,LR,1,50,10,-59.5,-59,-61,2
31,LR,1,50,3,-59.3333333333333,-59,-60,1
31,LR,1,50,10,-58.9,-57,-61,4
31,LR,1,50,10,-58.6,-56,-61,5
31,LR,1,50,3,-60.6666666666667,-60,-61,1
31,LR,1,50,8,-58.25,-56,-61,5
31,LR,1,50,8,-57,-56,-59,3
31,LR,1,50,3,-56.6666666666667,-56,-57,1
31,LR,0,50,2,-58.5,-54,-63,9
26,RL,1,50,5,-75,-66,-84,18
26,RL,1,50,9,-68.8888888888889,-64,-78,14
26,RL,0,50,2,-74.5,-71,-78,7
26,RL,1,50,7,-73,-67,-80,13
26,RL,1,50,3,-72,-70,-75,5
26,RL,1,50,3,-70.6666666666667,-67,-75,8
26,RL,1,50,7,-70.1428571428571,-68,-72,4
26,RL,1,50,5,-69.8,-68,-72,4
26,RL,0,50,2,-70,-70,-70,0
26,RL,1,50,8,-69.25,-68,-71,3
26,RL,1,50,5,-68,-66,-70,4
26,RL,1,50,3,-68,-67,-69,2
26,RL,1,50,5,-66.4,-66,-67,1
26,RL,1,50,8,-66.625,-65,-68,3
26,RL,1,50,9,-67.2222222222222,-65,-70,5
26,RL,0,50,2,-67.5,-67,-68,1
26,RL,1,50,7,-67.1428571428571,-65,-70,5
26,RL,1,50,3,-68.6666666666667,-68,-70,2
26,RL,1,50,5,-66.8,-66,-68,2
26,RL,1,50,8,-68.375,-66,-70,4
26,RL,1,50,4,-68.25,-67,-69,2
26,RL,1,50,7,-69.1428571428571,-68,-70,2
26,RL,1,50,5,-68.4,-67,-71,4
26,RL,1,50,5,-68.6,-68,-71,3
26,RL,1,50,10,-67.4,-66,-70,4
26,RL,1,50,7,-66.4285714285714,-65,-70,5
26,RL,1,50,9,-66.3333333333333,-65,-70,5
26,RL,1,50,5,-67,-65,-70,5
26,RL,1,50,7,-66.2857142857143,-65,-67,2
26,RL,0,50,1,-66,-66,-66,0
26,RL,0,50,2,-62,-62,-62,0
26,RL,1,50,8,-66,-64,-68,4
26,RL,0,50,1,-64,-64,-64,0
26,RL,1,50,7,-65.8571428571429,-64,-68,4
26,RL,1,50,3,-66,-65,-67,2
26,RL,1,50,5,-65.4,-65,-66,1
26,RL,1,50,5,-64.8,-61,-66,5
26,RL,0,50,1,-69,-69,-69,0
26,RL,1,50,6,-70.5,-67,-79,12
26,RL,1,50,10,-73,-66,-87,21
26,RL,1,50,4,-71.5,-66,-81,15
26,RL,1,50,3,-71.6666666666667,-70,-75,5
26,RL,1,50,10,-69.3,-66,-75,9
26,RL,1,50,10,-72,-67,-78,11
26,RL,1,50,4,-69.5,-67,-75,8
26,RL,1,50,6,-73.3333333333333,-68,-78,10
26,RL,1,50,6,-76.3333333333333,-73,-81,8
26,RL,1,50,9,-74.4444444444444,-72,-76,4
26,RL,1,50,8,-74.125,-72,-81,9
26,RL,0,50,2,-73.5,-73,-74,1
26,RL,1,50,9,-70.2222222222222,-65,-75,10
26,RL,1,50,4,-71.25,-66,-75,9
26,RL,1,50,10,-70.1,-65,-77,12
26,RL,1,50,5,-67.8,-65,-71,6
26,RL,1,50,6,-73.6666666666667,-69,-77,8
26,RL,1,50,7,-73,-69,-77,8
26,RL,1,50,10,-72.4,-69,-77,8
26,RL,1,50,10,-72.7,-68,-77,9
26,RL,1,50,10,-72.1,-67,-77,10
26,RL,0,50,1,-75,-75,-75,0
26,RL,1,50,6,-70.8333333333333,-68,-74,6
26,RL,1,50,7,-71.4285714285714,-68,-74,6
26,RL,0,50,1,-69,-69,-69,0
26,RL,1,50,5,-72,-67,-77,10
26,RL,0,50,2,-72,-71,-73,2
26,RL,1,50,3,-74.3333333333333,-72,-76,4
26,RL,0,50,1,-72,-72,-72,0
26,RL,1,50,4,-73.25,-72,-75,3
26,RL,1,50,9,-73.2222222222222,-66,-80,14
26,RL,1,50,3,-75,-71,-80,9
26,RL,1,50,8,-72.875,-66,-78,12
26,RL,1,50,10,-71.7,-68,-75,7
26,RL,1,50,7,-71.7142857142857,-70,-74,4
26,RL,1,50,3,-72.6666666666667,-72,-73,1
26,RL,1,50,4,-70.25,-69,-72,3
26,RL,0,50,2,-70.5,-68,-73,5
26,RL,1,50,8,-73.25,-68,-77,9
26,RL,0,50,2,-74.5,-72,-77,5
26,RL,1,50,8,-71.75,-68,-77,9
26,RL,0,50,2,-72.5,-72,-73,1
26,RL,1,50,5,-75.4,-70,-81,11
26,RL,1,50,9,-71.4444444444444,-67,-76,9
26,LR,1,50,10,-58.9,-55,-60,5
26,LR,1,50,8,-59.5,-59,-60,1
26,LR,1,50,4,-59.25,-59,-60,1
26,LR,1,50,6,-59.6666666666667,-59,-60,1
26,LR,1,50,9,-59.4444444444444,-59,-60,1
26,LR,1,50,4,-59.25,-59,-60,1
26,LR,1,50,6,-59.6666666666667,-59,-60,1
26,LR,1,50,7,-60.5714285714286,-59,-62,3
26,LR,1,50,8,-60.75,-58,-63,5
26,LR,1,50,3,-61,-58,-63,5
26,LR,1,50,5,-61.8,-61,-62,1
26,LR,1,50,6,-60.3333333333333,-58,-62,4
26,LR,1,50,3,-59,-58,-61,3
26,LR,1,50,9,-61.2222222222222,-58,-63,5
26,LR,1,50,8,-61.125,-58,-63,5
26,LR,1,50,8,-60.875,-58,-63,5
26,LR,1,50,8,-60.875,-58,-63,5
26,LR,1,50,5,-60,-58,-62,4
26,LR,1,50,7,-59,-57,-62,5
26,LR,1,50,8,-59.75,-57,-65,8
26,LR,1,50,5,-61.6,-58,-67,9
26,LR,1,50,7,-61,-57,-64,7
26,LR,1,50,5,-61.2,-57,-64,7
26,LR,0,50,1,-60,-60,-60,0
26,LR,1,50,5,-60,-59,-61,2
26,LR,1,50,5,-59.8,-59,-61,2
26,LR,0,50,2,-59.5,-59,-60,1
26,LR,1,50,5,-57.4,-56,-59,3
26,LR,1,50,3,-57.6666666666667,-56,-59,3
26,LR,1,50,9,-57,-56,-58,2
26,LR,0,50,2,-57.5,-57,-58,1
26,LR,1,50,7,-56.8571428571429,-56,-58,2
26,LR,0,50,1,-56,-56,-56,0
26,LR,1,50,4,-58,-56,-59,3
26,LR,1,50,4,-58,-56,-59,3
26,LR,0,50,1,-58,-58,-58,0
26,LR,1,50,3,-60.6666666666667,-60,-62,2
26,LR,0,50,2,-60,-60,-60,0
26,LR,0,50,2,-62.5,-62,-63,1
26,LR,1,50,8,-60.25,-57,-64,7
26,LR,0,50,1,-59,-59,-59,0
26,LR,1,50,8,-59.625,-57,-62,5
26,LR,1,50,8,-60.625,-58,-62,4
26,LR,1,50,5,-60.2,-58,-61,3
26,LR,1,50,4,-60.25,-58,-62,4
26,LR,1,50,6,-58.6666666666667,-56,-62,6
26,LR,0,50,1,-59,-59,-59,0
26,LR,1,50,10,-57.6,-55,-60,5
26,LR,1,50,9,-57.8888888888889,-55,-60,5
26,LR,1,50,3,-55.3333333333333,-54,-56,2
26,LR,1,50,10,-55.8,-55,-56,1
26,LR,1,50,4,-55.75,-55,-56,1
26,LR,1,50,4,-54.5,-54,-55,1
26,LR,0,50,2,-55,-54,-56,2
26,LR,1,50,4,-57,-56,-58,2
26,LR,0,50,1,-54,-54,-54,0
26,LR,1,50,3,-59,-57,-60,3
26,LR,1,50,5,-58,-57,-60,3
26,LR,1,50,5,-63.2,-59,-66,7
26,LR,1,50,8,-62.5,-61,-64,3
26,LR,1,50,3,-62.3333333333333,-62,-63,1
26,LR,1,50,4,-62,-61,-63,2
26,LR,1,50,10,-61.9,-61,-63,2
26,LR,1,50,5,-62,-61,-63,2
26,LR,1,50,5,-61.2,-61,-62,1
26,LR,1,50,7,-60.8571428571429,-60,-62,2
26,LR,1,50,7,-60.7142857142857,-60,-62,2
26,LR,1,50,10,-59.6,-58,-61,3
26,LR,1,50,3,-60.3333333333333,-60,-61,1
26,LR,0,50,2,-59,-58,-60,2
26,LR,0,50,1,-58,-58,-58,0
26,LR,1,50,9,-58.5555555555556,-58,-60,2
26,LR,1,50,3,-58.6666666666667,-58,-60,2
26,LR,1,50,6,-58.6666666666667,-58,-60,2
26,LR,1,50,3,-58.3333333333333,-58,-59,1
26,LR,1,50,8,-58.125,-57,-59,2
26,LR,1,50,7,-58.7142857142857,-57,-60,3
26,LR,1,50,9,-59.2222222222222,-58,-60,2
26,LR,1,50,3,-58.6666666666667,-58,-60,2
31,RL,0,100,1,-64,-64,-64,0
31,RL,1,100,9,-73.3333333333333,-66,-87,21
31,RL,1,100,4,-74.5,-71,-78,7
31,RL,1,100,3,-74,-66,-79,13
31,RL,1,100,7,-74.8571428571429,-71,-79,8
31,RL,1,100,6,-74.1666666666667,-71,-77,6
31,RL,1,100,6,-73.1666666666667,-71,-77,6
31,RL,0,100,1,-73,-73,-73,0
31,RL,0,100,1,-71,-71,-71,0
31,RL,1,100,3,-70.3333333333333,-67,-72,5
31,RL,0,100,1,-77,-77,-77,0
31,RL,1,100,9,-75.3333333333333,-67,-91,24
31,RL,1,100,6,-76.5,-67,-91,24
31,RL,1,100,5,-74.2,-68,-79,11
31,RL,0,100,2,-78.5,-78,-79,1
31,RL,1,100,9,-70,-66,-76,10
31,RL,0,100,1,-72,-72,-72,0
31,RL,1,100,5,-68.6,-64,-76,12
31,RL,1,100,10,-73.3,-64,-91,27
31,RL,0,100,2,-67,-67,-67,0
31,RL,0,100,2,-67,-67,-67,0
31,RL,1,100,4,-65.75,-63,-67,4
31,RL,1,100,5,-74,-67,-85,18
31,RL,0,100,1,-70,-70,-70,0
31,RL,1,100,4,-68.25,-67,-70,3
31,RL,1,100,8,-72.375,-65,-82,17
31,RL,1,100,9,-72.4444444444444,-65,-82,17
31,RL,1,100,6,-73.3333333333333,-65,-82,17
31,RL,1,100,9,-72.7777777777778,-66,-79,13
31,RL,1,100,8,-73.375,-66,-79,13
31,RL,1,100,4,-72,-65,-79,14
31,RL,1,100,9,-74.8888888888889,-67,-90,23
31,RL,1,100,10,-73.8,-66,-81,15
31,RL,1,100,8,-71.75,-66,-79,13
31,RL,0,100,2,-68.5,-67,-70,3
31,RL,1,100,6,-66.6666666666667,-65,-68,3
31,RL,1,100,6,-68.6666666666667,-65,-71,6
31,RL,1,100,9,-72.5555555555556,-67,-77,10
31,RL,1,100,7,-70.5714285714286,-65,-77,12
31,RL,1,100,10,-69.4,-65,-79,14
31,RL,1,100,5,-65.8,-65,-67,2
31,RL,1,100,7,-70.5714285714286,-66,-79,13
31,RL,1,100,7,-73.4285714285714,-67,-84,17
31,RL,1,100,6,-76,-67,-85,18
31,RL,1,100,6,-77,-68,-90,22
31,RL,0,100,1,-80,-80,-80,0
31,RL,1,100,9,-71.7777777777778,-68,-76,8
31,RL,1,100,8,-71.75,-68,-76,8
31,RL,0,100,1,-74,-74,-74,0
31,RL,0,100,1,-71,-71,-71,0
31,RL,1,100,3,-71.3333333333333,-70,-72,2
31,RL,1,100,4,-74.5,-72,-81,9
31,RL,1,100,7,-72.5714285714286,-69,-78,9
31,RL,1,100,7,-70.4285714285714,-66,-74,8
31,RL,1,100,9,-69.8888888888889,-63,-75,12
31,RL,1,100,6,-69.5,-63,-75,12
31,RL,1,100,7,-69.5714285714286,-63,-73,10
31,RL,1,100,9,-78.2222222222222,-72,-84,12
31,RL,0,100,1,-77,-77,-77,0
31,RL,1,100,6,-70.6666666666667,-69,-74,5
31,RL,1,100,6,-70.8333333333333,-69,-73,4
31,RL,1,100,6,-71.1666666666667,-69,-74,5
31,RL,0,100,2,-69.5,-69,-70,1
31,RL,1,100,5,-79.4,-72,-86,14
31,RL,1,100,9,-81.2222222222222,-77,-88,11
31,RL,1,100,9,-80.7777777777778,-74,-88,14
31,RL,0,100,1,-80,-80,-80,0
31,RL,1,100,5,-70.2,-66,-77,11
31,RL,1,100,3,-67.3333333333333,-66,-68,2
31,RL,1,100,10,-69,-66,-73,7
31,RL,1,100,6,-68.6666666666667,-66,-70,4
31,RL,1,100,4,-70,-70,-70,0
31,RL,1,100,5,-73.2,-68,-87,19
31,RL,1,100,9,-76.5555555555556,-72,-92,20
31,RL,1,100,5,-76,-72,-92,20
31,RL,1,100,7,-70.5714285714286,-68,-72,4
31,RL,1,100,7,-69.5714285714286,-67,-73,6
31,RL,1,100,6,-70.5,-67,-73,6
31,RL,1,100,10,-73.7,-67,-88,21
31,RL,0,100,2,-79,-70,-88,18
31,RL,1,100,7,-72,-67,-77,10
31,RL,1,100,7,-71.4285714285714,-67,-77,10
31,RL,0,100,2,-72.5,-70,-75,5
31,RL,1,100,7,-78.2857142857143,-75,-81,6
31,RL,1,100,5,-78.4,-75,-81,6
31,RL,1,100,4,-79.5,-78,-81,3
31,RL,1,100,8,-75.625,-67,-91,24
31,RL,1,100,8,-69.625,-67,-72,5
31,RL,1,100,5,-69.4,-68,-72,4
31,RL,1,100,8,-68.5,-66,-74,8
31,RL,1,100,10,-70.2,-66,-74,8
31,RL,0,100,1,-70,-70,-70,0
31,RL,1,100,4,-72.25,-72,-73,1
31,RL,1,100,10,-68.3,-66,-71,5
31,RL,1,100,10,-80.1,-70,-88,18
31,RL,1,100,9,-81.2222222222222,-76,-88,12
31,RL,1,100,4,-84,-80,-88,8
31,RL,1,100,8,-70.875,-66,-76,10
31,RL,1,100,5,-72.6,-69,-76,7
31,RL,1,100,8,-72.875,-69,-76,7
31,RL,1,100,6,-74.1666666666667,-72,-75,3
31,RL,1,100,3,-75,-75,-75,0
31,RL,1,100,6,-75.8333333333333,-72,-80,8
31,RL,1,100,9,-77.7777777777778,-72,-86,14
31,RL,1,100,10,-76,-72,-86,14
31,RL,1,100,5,-72.4,-72,-74,2
31,RL,1,100,8,-70.625,-67,-75,8
31,RL,0,100,1,-67,-67,-67,0
31,RL,0,100,1,-67,-67,-67,0
31,RL,1,100,5,-73,-70,-76,6
31,RL,1,100,5,-74.6,-70,-77,7
31,RL,1,100,6,-72.8333333333333,-66,-80,14
31,RL,1,100,5,-79.8,-78,-82,4
31,RL,1,100,4,-79.75,-78,-82,4
31,RL,1,100,8,-78.625,-74,-82,8
31,RL,1,100,3,-74.6666666666667,-73,-77,4
31,RL,0,100,2,-65,-65,-65,0
31,RL,1,100,9,-73.4444444444444,-69,-78,9
31,RL,1,100,8,-74.25,-71,-78,7
31,RL,1,100,4,-75.75,-73,-78,5
31,RL,1,100,4,-75.5,-73,-78,5
31,RL,1,100,7,-72.4285714285714,-68,-82,14
31,RL,1,100,6,-72.3333333333333,-70,-74,4
31,RL,1,100,5,-72,-70,-74,4
31,RL,1,100,6,-72.3333333333333,-70,-74,4
31,RL,1,100,9,-82,-73,-96,23
31,RL,1,100,6,-70.1666666666667,-67,-75,8
31,RL,1,100,7,-70.1428571428571,-67,-75,8
31,RL,1,100,7,-71.1428571428571,-68,-73,5
31,RL,1,100,4,-71,-68,-73,5
31,RL,1,100,6,-72.1666666666667,-71,-73,2
31,RL,0,100,2,-72.5,-72,-73,1
31,RL,0,100,1,-72,-72,-72,0
31,RL,1,100,3,-76.3333333333333,-73,-80,7
31,RL,1,100,5,-75.4,-72,-80,8
31,RL,1,100,4,-73.25,-68,-83,15
31,RL,1,100,10,-79.7,-76,-84,8
31,RL,0,100,1,-81,-81,-81,0
31,RL,1,100,4,-77.5,-75,-79,4
31,RL,1,100,3,-74.6666666666667,-70,-79,9
31,RL,1,100,4,-71.75,-70,-76,6
31,RL,1,100,10,-72.3,-69,-76,7
31,RL,1,100,8,-72,-69,-76,7
31,RL,1,100,10,-73.1,-69,-78,9
31,RL,0,100,2,-79.5,-76,-83,7
31,RL,0,100,2,-71,-71,-71,0
31,RL,1,100,4,-68,-66,-70,4
31,RL,0,100,1,-70,-70,-70,0
31,RL,1,100,9,-74.2222222222222,-70,-82,12
31,RL,1,100,4,-83.75,-81,-86,5
31,RL,1,100,5,-70,-67,-78,11
31,RL,1,100,8,-76.625,-68,-85,17
31,RL,1,100,6,-80.5,-75,-85,10
31,RL,1,100,4,-80.75,-75,-85,10
31,RL,1,100,7,-81.4285714285714,-76,-85,9
31,RL,1,100,4,-77,-76,-78,2
31,RL,1,100,5,-73,-72,-76,4
31,RL,1,100,10,-71.4,-69,-72,3
31,RL,1,100,9,-71.1111111111111,-69,-75,6
31,RL,1,100,7,-79.8571428571429,-70,-87,17
31,RL,1,100,6,-82.8333333333333,-78,-88,10
31,RL,1,100,6,-82.3333333333333,-77,-88,11
31,RL,0,100,2,-76,-74,-78,4
31,RL,0,100,1,-74,-74,-74,0
31,RL,1,100,6,-80.5,-76,-87,11
31,RL,1,100,7,-82,-76,-87,11
31,RL,0,100,1,-76,-76,-76,0
31,RL,1,100,5,-71.8,-68,-75,7
31,RL,1,100,5,-72.8,-66,-77,11
31,RL,1,100,9,-85.4444444444444,-80,-90,10
31,RL,1,100,10,-84.7,-82,-89,7
31,RL,1,100,4,-75.25,-72,-84,12
31,RL,0,100,1,-73,-73,-73,0
31,RL,1,100,8,-73.375,-70,-80,10
31,RL,1,100,9,-72,-68,-80,12
31,RL,1,100,9,-73.5555555555556,-69,-84,15
31,RL,1,100,10,-72.9,-66,-84,18
31,RL,0,100,2,-70.5,-70,-71,1
31,RL,1,100,6,-74.8333333333333,-73,-77,4
31,RL,1,100,8,-80.375,-76,-88,12
31,RL,1,100,6,-78.3333333333333,-74,-81,7
31,RL,1,100,9,-69.5555555555556,-66,-76,10
31,RL,1,100,8,-74.875,-70,-81,11
31,RL,0,100,2,-80.5,-80,-81,1
31,RL,1,100,8,-71.375,-67,-85,18
31,RL,1,100,6,-75.8333333333333,-67,-85,18
31,RL,1,100,10,-80.4,-70,-85,15
31,RL,1,100,8,-80.625,-77,-85,8
31,RL,1,100,7,-80.5714285714286,-77,-85,8
31,RL,1,100,4,-82.25,-78,-85,7
31,RL,1,100,6,-80.6666666666667,-77,-85,8
31,RL,1,100,5,-80.2,-77,-85,8
31,RL,1,100,9,-79.5555555555556,-74,-94,20
31,RL,0,100,2,-78.5,-77,-80,3
31,RL,1,100,10,-74.9,-63,-82,19
31,RL,1,100,3,-81,-80,-82,2
31,RL,1,100,8,-79.125,-76,-82,6
31,RL,1,100,10,-73.1,-63,-82,19
31,LR,1,100,7,-67.2857142857143,-64,-72,8
31,LR,1,100,10,-67.3,-64,-71,7
31,LR,1,100,6,-68.8333333333333,-68,-71,3
31,LR,1,100,8,-68.875,-66,-71,5
31,LR,1,100,8,-68.75,-66,-70,4
31,LR,1,100,7,-69.8571428571429,-68,-72,4
31,LR,0,100,2,-70,-70,-70,0
31,LR,0,100,2,-70,-70,-70,0
31,LR,1,100,8,-66.375,-64,-68,4
31,LR,1,100,5,-63.8,-63,-64,1
31,LR,0,100,2,-64,-64,-64,0
31,LR,1,100,6,-63.3333333333333,-63,-64,1
31,LR,1,100,6,-65.1666666666667,-64,-67,3
31,LR,1,100,7,-65.5714285714286,-64,-67,3
31,LR,1,100,5,-65,-63,-67,4
31,LR,1,100,8,-67.25,-64,-70,6
31,LR,1,100,9,-70.5555555555556,-64,-79,15
31,LR,1,100,10,-74.7,-68,-90,22
31,LR,1,100,8,-74.375,-69,-90,21
31,LR,0,100,2,-72.5,-70,-75,5
31,LR,0,100,2,-73,-70,-76,6
31,LR,1,100,10,-78,-70,-88,18
31,LR,1,100,4,-75,-70,-86,16
31,LR,1,100,5,-78.4,-70,-88,18
31,LR,1,100,9,-78.4444444444444,-69,-90,21
31,LR,1,100,7,-78.2857142857143,-69,-90,21
31,LR,1,100,9,-73.4444444444444,-67,-90,23
31,LR,1,100,9,-67.8888888888889,-65,-73,8
31,LR,1,100,8,-67.375,-65,-68,3
31,LR,1,100,9,-67.1111111111111,-65,-68,3
31,LR,1,100,8,-67.375,-65,-68,3
31,LR,1,100,4,-67.25,-65,-68,3
31,LR,1,100,4,-66.75,-66,-67,1
31,LR,1,100,9,-65,-62,-67,5
31,LR,0,100,2,-63.5,-62,-65,3
31,LR,0,100,2,-67,-66,-68,2
31,LR,1,100,9,-67.5555555555556,-65,-71,6
31,LR,1,100,4,-67.5,-64,-70,6
31,LR,1,100,5,-69,-65,-70,5
31,LR,1,100,5,-69,-65,-70,5
31,LR,0,100,1,-67,-67,-67,0
31,LR,1,100,9,-68.8888888888889,-66,-70,4
31,LR,1,100,6,-69.3333333333333,-66,-70,4
31,LR,0,100,2,-70,-70,-70,0
31,LR,1,100,6,-68.6666666666667,-63,-74,11
31,LR,1,100,6,-66.6666666666667,-64,-70,6
31,LR,1,100,10,-66.8,-64,-69,5
31,LR,1,100,5,-66.4,-64,-68,4
31,LR,0,100,2,-67,-66,-68,2
31,LR,0,100,1,-68,-68,-68,0
31,LR,1,100,10,-66.9,-65,-69,4
31,LR,1,100,5,-67.4,-66,-69,3
31,LR,1,100,9,-66.8888888888889,-65,-69,4
31,LR,1,100,3,-65.6666666666667,-65,-66,1
31,LR,1,100,10,-69.1,-66,-72,6
31,LR,1,100,3,-71,-71,-71,0
31,LR,1,100,3,-68,-66,-72,6
31,LR,0,100,2,-67.5,-65,-70,5
31,LR,1,100,8,-68.625,-66,-70,4
31,LR,1,100,4,-68.5,-68,-69,1
31,LR,1,100,10,-68.2,-67,-70,3
31,LR,1,100,5,-68.6,-68,-70,2
31,LR,1,100,10,-67.1,-64,-68,4
31,LR,1,100,8,-66.625,-64,-71,7
31,LR,1,100,5,-66.6,-64,-71,7
31,LR,1,100,5,-67.6,-66,-71,5
31,LR,1,100,5,-66.6,-65,-68,3
31,LR,1,100,7,-73.4285714285714,-68,-92,24
31,LR,1,100,9,-70.3333333333333,-68,-74,6
31,LR,1,100,4,-69.5,-68,-70,2
31,LR,1,100,8,-68.25,-66,-72,6
31,LR,0,100,2,-68,-66,-70,4
31,LR,0,100,2,-67.5,-66,-69,3
31,LR,1,100,10,-68.3,-67,-72,5
31,LR,1,100,5,-67.8,-67,-69,2
31,LR,1,100,7,-68.7142857142857,-66,-77,11
31,LR,1,100,10,-69.9,-66,-81,15
31,LR,1,100,9,-70.2222222222222,-66,-81,15
31,LR,1,100,4,-72,-66,-81,15
31,LR,1,100,9,-72.8888888888889,-66,-84,18
31,LR,1,100,7,-77.5714285714286,-74,-84,10
31,LR,1,100,9,-77.2222222222222,-74,-84,10
26,RL,1,100,10,-70.6,-62,-92,30
26,RL,1,100,9,-72.1111111111111,-66,-92,26
26,RL,1,100,8,-72.5,-66,-92,26
26,RL,1,100,9,-70.6666666666667,-66,-74,8
26,RL,1,100,5,-69.6,-66,-74,8
26,RL,0,100,1,-74,-74,-74,0
26,RL,1,100,7,-68.1428571428571,-63,-73,10
26,RL,1,100,8,-71,-66,-76,10
26,RL,1,100,6,-70.8333333333333,-66,-76,10
26,RL,1,100,9,-73.2222222222222,-66,-82,16
26,RL,1,100,7,-72.4285714285714,-64,-82,18
26,RL,1,100,4,-70.25,-66,-81,15
26,RL,1,100,8,-69.375,-64,-74,10
26,RL,1,100,7,-71.1428571428571,-65,-77,12
26,RL,1,100,10,-70.5,-66,-82,16
26,RL,0,100,2,-66,-66,-66,0
26,RL,1,100,10,-70.4,-66,-77,11
26,RL,1,100,6,-68.6666666666667,-66,-71,5
26,RL,1,100,3,-78.6666666666667,-74,-81,7
26,RL,1,100,8,-71.125,-66,-77,11
26,RL,1,100,6,-70.3333333333333,-66,-73,7
26,RL,1,100,4,-71.5,-70,-73,3
26,RL,1,100,10,-71.5,-64,-80,16
26,RL,1,100,4,-75,-71,-80,9
26,RL,1,100,6,-69.1666666666667,-67,-72,5
26,RL,0,100,1,-70,-70,-70,0
26,RL,1,100,8,-73.125,-67,-82,15
26,RL,1,100,10,-71.3,-67,-82,15
26,RL,1,100,3,-74.6666666666667,-68,-82,14
26,RL,1,100,7,-75.7142857142857,-69,-86,17
26,RL,1,100,4,-70.25,-68,-76,8
26,RL,1,100,4,-69.5,-68,-73,5
26,RL,1,100,8,-75.75,-68,-95,27
26,RL,1,100,10,-79.7,-70,-95,25
26,RL,0,100,1,-70,-70,-70,0
26,RL,0,100,1,-68,-68,-68,0
26,RL,0,100,2,-75,-72,-78,6
26,RL,1,100,3,-67.3333333333333,-65,-70,5
26,RL,1,100,5,-72.4,-67,-80,13
26,RL,0,100,1,-68,-68,-68,0
26,RL,1,100,7,-73.2857142857143,-68,-81,13
26,RL,1,100,10,-74.1,-67,-92,25
26,RL,1,100,7,-76.2857142857143,-68,-92,24
26,RL,1,100,6,-77.3333333333333,-68,-92,24
26,RL,1,100,3,-78,-72,-88,16
26,RL,1,100,9,-68,-65,-73,8
26,RL,0,100,1,-68,-68,-68,0
26,RL,1,100,3,-69.6666666666667,-65,-73,8
26,RL,1,100,6,-73.6666666666667,-68,-84,16
26,RL,1,100,9,-70.5555555555556,-65,-74,9
26,RL,0,100,2,-73,-73,-73,0
26,RL,1,100,8,-69.125,-65,-74,9
26,RL,0,100,2,-67.5,-65,-70,5
26,RL,1,100,7,-70.1428571428571,-67,-74,7
26,RL,1,100,7,-69.8571428571429,-67,-74,7
26,RL,0,100,1,-90,-90,-90,0
26,RL,1,100,4,-80.75,-70,-91,21
26,RL,1,100,6,-76.6666666666667,-69,-93,24
26,RL,1,100,5,-72.4,-67,-77,10
26,RL,0,100,2,-74,-72,-76,4
26,RL,0,100,2,-75,-71,-79,8
26,RL,1,100,6,-70.3333333333333,-68,-73,5
26,RL,1,100,7,-72,-68,-78,10
26,RL,1,100,4,-73.5,-68,-78,10
26,RL,1,100,6,-74.3333333333333,-68,-78,10
26,RL,1,100,4,-74.5,-71,-78,7
26,RL,1,100,6,-76.5,-66,-85,19
26,RL,1,100,6,-71,-69,-73,4
26,RL,1,100,7,-70.2857142857143,-67,-73,6
26,RL,1,100,4,-70.5,-69,-73,4
26,RL,0,100,1,-70,-70,-70,0
26,RL,1,100,7,-80.4285714285714,-70,-90,20
26,RL,1,100,6,-77.5,-68,-87,19
26,RL,0,100,2,-86.5,-81,-92,11
26,RL,1,100,3,-80,-75,-84,9
26,RL,1,100,9,-78.4444444444444,-66,-89,23
26,RL,1,100,10,-73.1,-67,-83,16
26,RL,1,100,6,-73.6666666666667,-70,-79,9
26,RL,1,100,3,-75,-70,-83,13
26,RL,1,100,10,-76.2,-71,-83,12
26,RL,1,100,9,-73,-65,-83,18
26,RL,0,100,1,-71,-71,-71,0
26,RL,0,100,1,-85,-85,-85,0
26,RL,1,100,6,-68.8333333333333,-64,-72,8
26,RL,1,100,7,-76,-64,-83,19
26,RL,1,100,10,-79.1,-71,-87,16
26,RL,1,100,9,-78.2222222222222,-71,-83,12
26,LR,0,100,2,-71,-71,-71,0
26,LR,1,100,3,-69.6666666666667,-67,-71,4
26,LR,1,100,3,-64.3333333333333,-64,-65,1
26,LR,1,100,6,-65.6666666666667,-64,-69,5
26,LR,1,100,6,-67,-64,-69,5
26,LR,1,100,10,-67,-65,-70,5
26,LR,1,100,7,-67.2857142857143,-65,-70,5
26,LR,1,100,6,-67.8333333333333,-66,-70,4
26,LR,1,100,8,-66.75,-66,-68,2
26,LR,1,100,8,-67.25,-66,-70,4
26,LR,1,100,3,-64.3333333333333,-61,-66,5
26,LR,1,100,7,-65,-63,-66,3
26,LR,1,100,10,-64.4,-63,-67,4
26,LR,0,100,1,-64,-64,-64,0
26,LR,0,100,1,-63,-63,-63,0
26,LR,0,100,2,-63.5,-63,-64,1
26,LR,1,100,8,-62.5,-60,-65,5
26,LR,1,100,4,-62.5,-61,-64,3
26,LR,1,100,4,-62.5,-61,-64,3
26,LR,1,100,5,-61.2,-59,-65,6
26,LR,0,100,1,-61,-61,-61,0
26,LR,1,100,6,-62.6666666666667,-61,-65,4
26,LR,1,100,7,-62.4285714285714,-61,-65,4
26,LR,1,100,6,-63,-62,-65,3
26,LR,1,100,7,-63.1428571428571,-62,-65,3
26,LR,1,100,3,-63.3333333333333,-62,-64,2
26,LR,1,100,6,-63,-61,-65,4
26,LR,0,100,2,-62.5,-62,-63,1
26,LR,1,100,6,-65.3333333333333,-64,-66,2
26,LR,1,100,9,-65.4444444444444,-63,-67,4
26,LR,1,100,9,-69.3333333333333,-65,-88,23
26,LR,1,100,5,-67.4,-65,-73,8
26,LR,1,100,9,-70.3333333333333,-65,-88,23
26,LR,1,100,5,-85.2,-73,-94,21
26,LR,1,100,5,-75.4,-68,-92,24
26,LR,0,100,2,-71.5,-68,-75,7
26,LR,1,100,7,-76,-68,-87,19
26,LR,1,100,7,-71.7142857142857,-68,-84,16
26,LR,1,100,5,-76,-68,-84,16
26,LR,1,100,4,-74.5,-67,-87,20
26,LR,1,100,5,-67.6,-67,-68,1
26,LR,1,100,5,-66.6,-63,-68,5
26,LR,1,100,6,-65.1666666666667,-61,-68,7
26,LR,0,100,1,-65,-65,-65,0
26,LR,1,100,7,-64.1428571428571,-61,-67,6
26,LR,1,100,8,-66.125,-64,-67,3
26,LR,1,100,4,-66,-64,-67,3
26,LR,1,100,5,-66.4,-64,-68,4
26,LR,1,100,4,-68,-64,-70,6
26,LR,0,100,2,-65,-63,-67,4
26,LR,1,100,3,-68,-67,-70,3
26,LR,1,100,3,-66,-63,-68,5
26,LR,1,100,9,-67.3333333333333,-63,-70,7
26,LR,0,100,2,-68,-68,-68,0
26,LR,1,100,10,-68.4,-64,-70,6
26,LR,0,100,2,-70,-70,-70,0
26,LR,1,100,10,-67.3,-63,-70,7
26,LR,1,100,3,-68.6666666666667,-68,-69,1
26,LR,1,100,3,-66.6666666666667,-63,-69,6
26,LR,1,100,4,-66.5,-64,-68,4
26,LR,0,100,1,-68,-68,-68,0
26,LR,1,100,7,-65.7142857142857,-64,-67,3
26,LR,0,100,1,-65,-65,-65,0
26,LR,0,100,1,-67,-67,-67,0
26,LR,1,100,9,-65.1111111111111,-63,-68,5
26,LR,1,100,5,-64.2,-63,-66,3
26,LR,1,100,5,-64.8,-63,-67,4
26,LR,1,100,10,-66.3,-64,-69,5
26,LR,1,100,8,-66.625,-64,-69,5
26,LR,0,100,2,-66,-64,-68,4
26,LR,0,100,2,-67,-64,-70,6
26,LR,1,100,6,-67.1666666666667,-64,-71,7
26,LR,1,100,9,-68.1111111111111,-63,-72,9
26,LR,0,100,1,-70,-70,-70,0
26,LR,1,100,10,-68.6,-63,-72,9
26,LR,1,100,10,-68.1,-63,-72,9
26,LR,0,100,1,-71,-71,-71,0
26,LR,1,100,9,-67.2222222222222,-66,-68,2
26,LR,1,100,5,-66.8,-66,-68,2
26,LR,1,100,6,-67,-64,-70,6
26,LR,1,100,7,-67,-64,-71,7
26,LR,1,100,7,-72.7142857142857,-67,-93,26
26,LR,1,100,9,-69.4444444444444,-67,-73,6
26,LR,0,100,2,-70.5,-68,-73,5
26,LR,1,100,6,-69.3333333333333,-67,-73,6
26,LR,1,100,8,-68.75,-66,-73,7
26,LR,1,100,6,-67,-65,-70,5
26,LR,1,100,5,-67.8,-65,-70,5
26,LR,1,100,10,-66.3,-64,-69,5
26,LR,0,100,2,-68.5,-66,-71,5
26,LR,1,100,10,-67.5,-65,-71,6
26,LR,1,100,7,-66.5714285714286,-65,-68,3
26,LR,1,100,9,-68.1111111111111,-65,-72,7
26,LR,1,100,4,-65.75,-65,-66,1
26,LR,1,100,7,-68.8571428571429,-66,-72,6
26,LR,1,100,10,-68.1,-64,-84,20
26,LR,1,100,6,-70,-65,-72,7
26,LR,1,100,7,-68.7142857142857,-65,-72,7
31,RL,1,150,10,-74.2,-67,-81,14
31,RL,1,150,4,-75,-71,-81,10
31,RL,1,150,7,-77.1428571428571,-72,-81,9
31,RL,1,150,3,-77,-75,-79,4
31,RL,1,150,3,-76.6666666666667,-74,-81,7
31,RL,0,150,2,-93,-91,-95,4
31,RL,1,150,9,-78.2222222222222,-71,-90,19
31,RL,0,150,2,-71.5,-71,-72,1
31,RL,0,150,1,-89,-89,-89,0
31,RL,1,150,6,-75.3333333333333,-72,-81,9
31,RL,1,150,7,-75.7142857142857,-72,-81,9
31,RL,1,150,4,-74.25,-73,-76,3
31,RL,1,150,4,-75,-72,-81,9
31,RL,0,150,2,-77.5,-74,-81,7
31,RL,0,150,2,-76,-74,-78,4
31,RL,1,150,7,-79.2857142857143,-76,-85,9
31,RL,1,150,4,-80.25,-76,-85,9
31,RL,1,150,4,-82.5,-78,-86,8
31,RL,1,150,5,-80.2,-78,-84,6
31,RL,1,150,4,-80.75,-78,-84,6
31,RL,1,150,7,-79.1428571428571,-75,-87,12
31,RL,1,150,5,-79.4,-75,-87,12
31,RL,1,150,5,-78.6,-75,-84,9
31,RL,1,150,10,-83.3,-76,-96,20
31,RL,0,150,2,-86,-76,-96,20
31,RL,1,150,10,-80.7,-75,-90,15
31,RL,1,150,4,-82.25,-75,-90,15
31,RL,1,150,4,-79,-75,-83,8
31,RL,0,150,1,-75,-75,-75,0
31,RL,1,150,3,-83.6666666666667,-78,-87,9
31,RL,1,150,9,-79,-74,-87,13
31,RL,1,150,5,-79.4,-75,-96,21
31,RL,1,150,9,-82.8888888888889,-75,-91,16
31,RL,0,150,1,-90,-90,-90,0
31,RL,1,150,9,-80.1111111111111,-75,-91,16
31,RL,1,150,3,-80,-75,-87,12
31,RL,1,150,4,-83.5,-76,-95,19
31,RL,1,150,3,-78,-73,-81,8
31,RL,1,150,8,-77,-72,-81,9
31,RL,1,150,5,-78.2,-74,-81,7
31,RL,1,150,7,-81.8571428571429,-72,-93,21
31,RL,1,150,7,-76.7142857142857,-75,-78,3
31,RL,0,150,2,-77,-76,-78,2
31,RL,1,150,7,-74.8571428571429,-71,-78,7
31,RL,1,150,3,-70.3333333333333,-69,-73,4
31,RL,1,150,6,-72.8333333333333,-72,-75,3
31,RL,1,150,9,-72.8888888888889,-72,-75,3
31,RL,1,150,9,-73.1111111111111,-72,-75,3
31,RL,1,150,3,-73.3333333333333,-72,-74,2
31,RL,0,150,2,-72.5,-72,-73,1
31,RL,1,150,10,-74.7,-72,-81,9
31,RL,1,150,3,-73,-73,-73,0
31,RL,1,150,4,-74.25,-72,-79,7
31,RL,1,150,10,-75.3,-72,-80,8
31,RL,1,150,4,-75,-72,-76,4
31,RL,1,150,10,-76.4,-72,-81,9
31,RL,1,150,10,-79.8,-74,-87,13
31,RL,1,150,7,-79.5714285714286,-78,-83,5
31,RL,1,150,7,-75.8571428571429,-74,-78,4
31,RL,1,150,10,-74.4,-70,-80,10
31,RL,1,150,10,-74.5,-70,-80,10
31,RL,1,150,8,-79.875,-74,-86,12
31,RL,0,150,1,-84,-84,-84,0
31,RL,1,150,6,-81.3333333333333,-74,-86,12
31,RL,0,150,1,-74,-74,-74,0
31,RL,1,150,4,-77.25,-74,-80,6
31,RL,1,150,10,-76.5,-74,-80,6
31,RL,1,150,5,-76.2,-75,-78,3
31,RL,1,150,4,-76,-75,-78,3
31,RL,1,150,9,-73.7777777777778,-72,-75,3
31,RL,1,150,7,-73.7142857142857,-72,-75,3
31,RL,0,150,2,-75,-75,-75,0
31,RL,1,150,7,-76.4285714285714,-73,-81,8
31,RL,1,150,5,-74.8,-72,-78,6
31,RL,1,150,3,-74.6666666666667,-72,-78,6
31,RL,1,150,9,-75.2222222222222,-73,-82,9
31,RL,0,150,2,-75.5,-74,-77,3
31,RL,1,150,3,-77,-76,-78,2
31,RL,1,150,5,-76.6,-75,-78,3
31,RL,1,150,8,-74.875,-72,-78,6
31,RL,1,150,7,-75,-72,-79,7
31,RL,1,150,4,-76.5,-73,-80,7
31,RL,1,150,9,-76.7777777777778,-74,-82,8
31,RL,1,150,6,-75.8333333333333,-74,-80,6
31,RL,1,150,9,-76.7777777777778,-74,-82,8
31,RL,1,150,9,-76.8888888888889,-74,-82,8
31,RL,1,150,7,-77.2857142857143,-74,-82,8
31,RL,1,150,3,-76,-74,-78,4
31,RL,1,150,6,-73.8333333333333,-72,-76,4
31,RL,0,150,1,-79,-79,-79,0
31,RL,1,150,3,-76.3333333333333,-74,-81,7
31,RL,0,150,1,-74,-74,-74,0
31,RL,1,150,8,-74.625,-70,-80,10
31,RL,1,150,10,-74.5,-70,-80,10
31,RL,0,150,1,-72,-72,-72,0
31,RL,1,150,7,-73.8571428571429,-70,-77,7
31,RL,1,150,5,-74.2,-70,-77,7
31,RL,1,150,4,-75,-73,-77,4
31,RL,1,150,6,-81.8333333333333,-77,-88,11
31,RL,0,150,2,-71.5,-70,-73,3
31,RL,1,150,9,-75.8888888888889,-72,-92,20
31,RL,1,150,7,-71.4285714285714,-69,-75,6
31,RL,1,150,9,-79.7777777777778,-70,-95,25
31,RL,1,150,6,-73.8333333333333,-69,-79,10
31,RL,1,150,9,-76.3333333333333,-71,-79,8
31,RL,0,150,1,-75,-75,-75,0
31,RL,1,150,4,-75,-70,-78,8
31,RL,1,150,8,-72.5,-67,-78,11
31,RL,1,150,3,-70.6666666666667,-67,-78,11
31,RL,1,150,7,-70.8571428571429,-67,-72,5
31,RL,1,150,8,-72.375,-69,-77,8
31,RL,1,150,10,-71.5,-69,-76,7
31,RL,0,150,2,-69.5,-69,-70,1
31,RL,1,150,10,-72.7,-69,-78,9
31,RL,1,150,10,-73.7,-71,-78,7
31,RL,1,150,7,-73.7142857142857,-72,-78,6
31,RL,1,150,7,-73.1428571428571,-68,-78,10
31,RL,0,150,2,-75.5,-73,-78,5
31,RL,1,150,3,-70.6666666666667,-70,-71,1
31,RL,1,150,3,-70,-70,-70,0
31,RL,1,150,10,-71.8,-69,-83,14
31,RL,1,150,8,-70,-68,-72,4
31,RL,1,150,7,-69.2857142857143,-68,-71,3
31,RL,1,150,6,-69.3333333333333,-68,-71,3
31,RL,1,150,8,-70.25,-68,-76,8
31,RL,1,150,7,-73.4285714285714,-70,-76,6
31,RL,1,150,9,-70.6666666666667,-69,-73,4
31,RL,1,150,6,-72.8333333333333,-72,-75,3
31,RL,1,150,4,-73.25,-71,-75,4
31,RL,0,150,2,-73.5,-72,-75,3
31,RL,1,150,4,-71.75,-70,-73,3
31,RL,1,150,7,-76,-71,-84,13
31,RL,0,150,2,-72,-72,-72,0
31,RL,1,150,4,-72.75,-70,-79,9
31,RL,1,150,6,-76.8333333333333,-70,-88,18
31,RL,1,150,4,-75.75,-72,-79,7
31,RL,1,150,9,-74.3333333333333,-69,-81,12
31,RL,1,150,8,-74.375,-70,-79,9
31,RL,0,150,1,-76,-76,-76,0
31,RL,1,150,6,-75.6666666666667,-70,-80,10
31,RL,1,150,8,-74,-70,-80,10
31,RL,0,150,1,-74,-74,-74,0
31,RL,0,150,2,-72,-70,-74,4
31,RL,1,150,6,-76.1666666666667,-72,-82,10
31,RL,1,150,7,-75.4285714285714,-71,-82,11
31,RL,1,150,6,-75.1666666666667,-71,-82,11
31,RL,0,150,1,-82,-82,-82,0
31,RL,1,150,9,-79.3333333333333,-71,-85,14
31,RL,0,150,1,-85,-85,-85,0
31,RL,0,150,1,-84,-84,-84,0
31,RL,1,150,8,-77.375,-72,-82,10
31,RL,1,150,9,-77.4444444444444,-72,-95,23
31,RL,1,150,8,-76.875,-72,-95,23
31,RL,0,150,1,-75,-75,-75,0
31,RL,0,150,1,-72,-72,-72,0
31,RL,1,150,9,-73.3333333333333,-70,-79,9
31,RL,1,150,9,-73.2222222222222,-70,-77,7
31,RL,1,150,4,-74.75,-72,-77,5
31,RL,1,150,6,-75,-73,-79,6
31,RL,1,150,8,-74.75,-69,-82,13
31,RL,1,150,4,-72.25,-69,-75,6
31,RL,1,150,3,-73.3333333333333,-73,-74,1
31,RL,1,150,4,-75,-73,-81,8
31,RL,1,150,9,-78.4444444444444,-72,-87,15
31,RL,1,150,7,-77.2857142857143,-72,-87,15
31,RL,1,150,10,-73.5,-72,-77,5
31,RL,1,150,3,-73.6666666666667,-72,-77,5
31,RL,0,150,1,-74,-74,-74,0
31,RL,0,150,1,-73,-73,-73,0
31,RL,1,150,7,-73.1428571428571,-73,-74,1
31,RL,1,150,10,-77.8,-71,-86,15
31,RL,1,150,5,-80.4,-71,-86,15
31,RL,1,150,3,-76.6666666666667,-71,-82,11
31,RL,1,150,10,-78.6,-71,-85,14
31,RL,1,150,8,-78.625,-73,-85,12
31,RL,1,150,7,-78,-73,-85,12
31,RL,0,150,2,-78,-73,-83,10
31,RL,1,150,5,-80,-73,-85,12
31,RL,0,150,2,-73.5,-72,-75,3
31,RL,0,150,2,-72.5,-72,-73,1
31,RL,1,150,5,-74.6,-72,-77,5
31,RL,1,150,4,-73.75,-71,-76,5
31,RL,1,150,5,-75,-74,-77,3
31,RL,1,150,5,-78.2,-72,-89,17
31,RL,1,150,10,-79,-72,-89,17
31,RL,1,150,10,-78.7,-72,-87,15
31,RL,1,150,7,-76.5714285714286,-72,-81,9
31,RL,1,150,4,-77.5,-72,-81,9
31,RL,1,150,10,-81.2,-74,-96,22
31,RL,0,150,1,-73,-73,-73,0
31,RL,1,150,3,-75.6666666666667,-74,-77,3
31,LR,1,150,8,-76.25,-71,-86,15
31,LR,1,150,7,-73.5714285714286,-71,-75,4
31,LR,0,150,2,-73.5,-72,-75,3
31,LR,1,150,4,-74.75,-74,-76,2
31,LR,1,150,3,-74.6666666666667,-73,-76,3
31,LR,1,150,10,-76.7,-74,-85,11
31,LR,1,150,4,-78.25,-74,-81,7
31,LR,1,150,4,-76.5,-74,-79,5
31,LR,1,150,4,-77.5,-74,-79,5
31,LR,0,150,2,-76,-74,-78,4
31,LR,1,150,3,-78.6666666666667,-74,-81,7
31,LR,1,150,9,-78.8888888888889,-76,-85,9
31,LR,1,150,9,-77.8888888888889,-75,-85,10
31,LR,1,150,9,-77.5555555555556,-74,-85,11
31,LR,1,150,6,-76.1666666666667,-74,-79,5
31,LR,1,150,5,-76,-74,-79,5
31,LR,0,150,1,-75,-75,-75,0
31,LR,0,150,1,-73,-73,-73,0
31,LR,1,150,9,-76.5555555555556,-73,-82,9
31,LR,0,150,2,-74.5,-73,-76,3
31,LR,1,150,7,-77,-73,-84,11
31,LR,1,150,7,-77,-72,-84,12
31,LR,1,150,10,-74.4,-72,-81,9
31,LR,1,150,5,-73,-67,-77,10
31,LR,1,150,3,-72,-67,-75,8
31,LR,0,150,2,-72,-70,-74,4
31,LR,0,150,1,-69,-69,-69,0
31,LR,1,150,5,-70.6,-68,-74,6
31,LR,1,150,10,-71.3,-68,-74,6
31,LR,1,150,6,-71.3333333333333,-68,-74,6
31,LR,1,150,9,-73.1111111111111,-71,-76,5
31,LR,1,150,7,-73.1428571428571,-70,-76,6
31,LR,1,150,8,-72.75,-70,-76,6
31,LR,1,150,3,-73.6666666666667,-72,-75,3
31,LR,1,150,7,-72.4285714285714,-71,-74,3
31,LR,1,150,5,-72.2,-71,-74,3
31,LR,1,150,9,-71.2222222222222,-70,-72,2
31,LR,1,150,4,-71,-71,-71,0
31,LR,0,150,1,-75,-75,-75,0
31,LR,0,150,1,-70,-70,-70,0
31,LR,0,150,2,-69,-68,-70,2
31,LR,1,150,6,-74.3333333333333,-72,-79,7
31,LR,0,150,2,-71.5,-71,-72,1
31,LR,1,150,8,-74.625,-70,-80,10
31,LR,1,150,6,-74.3333333333333,-70,-79,9
31,LR,0,150,2,-74.5,-72,-77,5
31,LR,0,150,1,-73,-73,-73,0
31,LR,1,150,7,-74,-71,-78,7
31,LR,1,150,9,-73.2222222222222,-71,-77,6
31,LR,1,150,8,-74,-70,-77,7
31,LR,1,150,6,-73,-70,-75,5
31,LR,1,150,8,-75.25,-70,-92,22
31,LR,0,150,1,-72,-72,-72,0
31,LR,1,150,7,-74,-70,-80,10
31,LR,1,150,9,-73.4444444444444,-70,-79,9
31,LR,0,150,1,-79,-79,-79,0
31,LR,0,150,1,-79,-79,-79,0
31,LR,0,150,1,-74,-74,-74,0
31,LR,0,150,2,-79.5,-79,-80,1
31,LR,1,150,4,-70.25,-67,-76,9
31,LR,0,150,1,-70,-70,-70,0
31,LR,1,150,5,-73.2,-66,-91,25
31,LR,1,150,3,-69.3333333333333,-68,-70,2
31,LR,1,150,6,-70,-68,-72,4
31,LR,1,150,4,-72.5,-71,-75,4
31,LR,1,150,6,-71,-68,-72,4
31,LR,0,150,1,-72,-72,-72,0
31,LR,0,150,2,-71,-70,-72,2
31,LR,1,150,6,-70.5,-68,-73,5
31,LR,1,150,4,-70.25,-68,-74,6
31,LR,1,150,4,-72.75,-71,-75,4
31,LR,0,150,1,-70,-70,-70,0
31,LR,1,150,3,-83,-82,-85,3
31,LR,0,150,2,-78.5,-75,-82,7
31,LR,0,150,1,-75,-75,-75,0
31,LR,1,150,4,-77.75,-75,-84,9
31,LR,0,150,2,-75.5,-75,-76,1
31,LR,0,150,2,-79.5,-76,-83,7
31,LR,1,150,8,-75.5,-71,-83,12
31,LR,0,150,2,-72,-71,-73,2
31,LR,1,150,6,-75.8333333333333,-72,-78,6
31,LR,1,150,5,-76.6,-74,-78,4
31,LR,1,150,6,-75.6666666666667,-73,-78,5
31,LR,1,150,7,-74.2857142857143,-70,-82,12
31,LR,1,150,7,-75.2857142857143,-72,-82,10
31,LR,1,150,6,-74.5,-70,-82,12
31,LR,1,150,7,-75.4285714285714,-70,-82,12
31,LR,1,150,5,-75.6,-70,-83,13
26,RL,1,150,6,-71.3333333333333,-68,-75,7
26,RL,1,150,5,-76.8,-68,-93,25
26,RL,0,150,2,-75,-71,-79,8
26,RL,0,150,2,-77,-75,-79,4
26,RL,1,150,7,-78.8571428571429,-76,-86,10
26,RL,1,150,10,-78.7,-74,-86,12
26,RL,0,150,1,-75,-75,-75,0
26,RL,0,150,1,-82,-82,-82,0
26,RL,0,150,2,-82.5,-75,-90,15
26,RL,1,150,8,-80.875,-75,-90,15
26,RL,0,150,2,-83,-76,-90,14
26,RL,1,150,10,-78.7,-73,-95,22
26,RL,1,150,6,-80.1666666666667,-73,-95,22
26,RL,1,150,9,-79.3333333333333,-73,-95,22
26,RL,1,150,3,-81.3333333333333,-74,-95,21
26,RL,0,150,2,-79.5,-74,-85,11
26,RL,1,150,5,-82.8,-73,-92,19
26,RL,1,150,6,-73.6666666666667,-70,-80,10
26,RL,1,150,9,-73.1111111111111,-70,-80,10
26,RL,1,150,6,-71.5,-70,-73,3
26,RL,1,150,9,-72.8888888888889,-70,-76,6
26,RL,1,150,10,-72.9,-70,-76,6
26,RL,1,150,6,-73,-70,-76,6
26,RL,1,150,10,-72.6,-70,-76,6
26,RL,1,150,6,-72.6666666666667,-70,-76,6
26,RL,1,150,8,-72.75,-70,-74,4
26,RL,1,150,6,-72.3333333333333,-70,-74,4
26,RL,1,150,7,-73.8571428571429,-72,-80,8
26,RL,1,150,8,-79.5,-75,-85,10
26,RL,1,150,3,-77.3333333333333,-73,-84,11
26,RL,0,150,1,-84,-84,-84,0
26,RL,1,150,10,-75.5,-72,-78,6
26,RL,0,150,1,-77,-77,-77,0
26,RL,1,150,5,-76,-73,-78,5
26,RL,1,150,6,-74,-72,-76,4
26,RL,1,150,9,-74.1111111111111,-70,-79,9
26,RL,1,150,6,-75,-70,-79,9
26,RL,0,150,2,-74.5,-70,-79,9
26,RL,1,150,5,-75.6,-73,-79,6
26,RL,1,150,5,-74.8,-72,-77,5
26,RL,1,150,10,-75.3,-70,-80,10
26,RL,0,150,1,-70,-70,-70,0
26,RL,1,150,4,-75,-73,-79,6
26,RL,1,150,8,-76.875,-73,-80,7
26,RL,1,150,4,-72.75,-71,-74,3
26,RL,1,150,8,-73.875,-70,-78,8
26,RL,1,150,4,-73.5,-70,-78,8
26,RL,1,150,8,-75.625,-68,-82,14
26,RL,1,150,6,-72.5,-69,-75,6
26,RL,1,150,6,-74,-69,-79,10
26,RL,1,150,5,-81,-75,-92,17
26,RL,1,150,9,-73.5555555555556,-68,-84,16
26,RL,1,150,6,-72.5,-68,-77,9
26,RL,0,150,1,-75,-75,-75,0
26,RL,0,150,1,-75,-75,-75,0
26,RL,0,150,2,-71,-70,-72,2
26,RL,1,150,9,-70.1111111111111,-68,-75,7
26,RL,1,150,3,-68.6666666666667,-68,-70,2
26,RL,1,150,5,-72,-68,-79,11
26,RL,0,150,2,-74.5,-70,-79,9
26,RL,0,150,2,-71.5,-71,-72,1
26,RL,1,150,3,-71.6666666666667,-71,-72,1
26,RL,0,150,2,-72,-72,-72,0
26,RL,1,150,3,-70.6666666666667,-69,-73,4
26,RL,1,150,9,-76.4444444444444,-68,-85,17
26,RL,1,150,9,-76.4444444444444,-68,-87,19
26,RL,1,150,8,-76.75,-68,-87,19
26,RL,0,150,1,-80,-80,-80,0
26,RL,1,150,6,-77.6666666666667,-72,-87,15
26,RL,1,150,6,-75.8333333333333,-70,-84,14
26,RL,1,150,10,-73,-70,-76,6
26,RL,1,150,4,-77,-73,-80,7
26,RL,0,150,2,-73.5,-69,-78,9
26,RL,1,150,4,-73.5,-72,-75,3
26,RL,0,150,1,-75,-75,-75,0
26,RL,1,150,7,-73.8571428571429,-71,-83,12
26,RL,0,150,2,-72.5,-70,-75,5
26,RL,1,150,9,-75.4444444444444,-68,-80,12
26,RL,1,150,5,-75.6,-68,-80,12
26,RL,0,150,2,-77,-74,-80,6
26,RL,1,150,3,-72.6666666666667,-71,-74,3
26,RL,1,150,5,-74,-71,-79,8
26,RL,1,150,4,-74.5,-73,-77,4
26,RL,1,150,4,-76.25,-70,-81,11
26,RL,1,150,5,-74.4,-73,-76,3
26,RL,1,150,10,-72.1,-65,-76,11
26,RL,1,150,6,-72.6666666666667,-65,-75,10
26,RL,0,150,2,-74,-74,-74,0
26,RL,0,150,1,-74,-74,-74,0
26,RL,1,150,8,-73.375,-65,-76,11
26,RL,0,150,2,-70,-66,-74,8
26,RL,1,150,4,-68.25,-65,-74,9
26,LR,1,150,10,-72.2,-70,-76,6
26,LR,0,150,1,-72,-72,-72,0
26,LR,1,150,8,-73.5,-70,-79,9
26,LR,1,150,7,-75.5714285714286,-70,-87,17
26,LR,0,150,1,-74,-74,-74,0
26,LR,1,150,4,-77.75,-72,-87,15
26,LR,1,150,4,-78,-70,-87,17
26,LR,0,150,2,-78.5,-70,-87,17
26,LR,1,150,6,-74.1666666666667,-72,-79,7
26,LR,1,150,10,-77.1,-72,-81,9
26,LR,1,150,10,-75.2,-72,-78,6
26,LR,1,150,5,-74.6,-72,-78,6
26,LR,1,150,4,-73.75,-72,-77,5
26,LR,1,150,6,-76.6666666666667,-74,-81,7
26,LR,1,150,8,-75.25,-74,-77,3
26,LR,1,150,3,-75.6666666666667,-74,-77,3
26,LR,1,150,6,-76,-74,-81,7
26,LR,1,150,10,-75.3,-73,-80,7
26,LR,1,150,7,-75.8571428571429,-74,-80,6
26,LR,1,150,9,-75.1111111111111,-70,-85,15
26,LR,1,150,7,-75,-71,-85,14
26,LR,1,150,8,-73.875,-71,-80,9
26,LR,1,150,5,-73.8,-71,-80,9
26,LR,1,150,5,-74,-72,-79,7
26,LR,1,150,10,-76.7,-68,-84,16
26,LR,0,150,1,-80,-80,-80,0
26,LR,0,150,2,-78.5,-73,-84,11
26,LR,1,150,10,-72.9,-68,-85,17
26,LR,1,150,6,-72.3333333333333,-67,-85,18
26,LR,1,150,6,-74.1666666666667,-67,-85,18
26,LR,1,150,6,-71.5,-67,-77,10
26,LR,1,150,6,-71.5,-69,-77,8
26,LR,1,150,5,-70.2,-68,-73,5
26,LR,1,150,9,-70.4444444444444,-68,-73,5
26,LR,1,150,3,-71,-70,-73,3
26,LR,1,150,3,-70,-70,-70,0
26,LR,0,150,1,-70,-70,-70,0
26,LR,1,150,3,-70.3333333333333,-69,-72,3
26,LR,1,150,7,-71.8571428571429,-70,-75,5
26,LR,0,150,1,-73,-73,-73,0
26,LR,0,150,2,-72,-70,-74,4
26,LR,1,150,6,-71,-70,-72,2
26,LR,1,150,7,-72.4285714285714,-70,-74,4
26,LR,1,150,6,-72.1666666666667,-70,-73,3
26,LR,1,150,5,-71.2,-70,-73,3
26,LR,1,150,3,-73.3333333333333,-72,-74,2
26,LR,1,150,6,-71.5,-68,-76,8
26,LR,1,150,6,-70.6666666666667,-68,-76,8
26,LR,1,150,10,-71.5,-70,-75,5
26,LR,1,150,9,-72.4444444444444,-67,-82,15
26,LR,1,150,10,-75.1,-67,-89,22
26,LR,1,150,10,-74.9,-67,-89,22
26,LR,1,150,10,-74.9,-69,-89,20
26,LR,1,150,4,-73,-70,-79,9
26,LR,0,150,2,-76.5,-70,-83,13
26,LR,0,150,2,-75.5,-73,-78,5
26,LR,0,150,2,-77.5,-74,-81,7
26,LR,1,150,4,-73.5,-70,-77,7
26,LR,1,150,9,-74.1111111111111,-68,-82,14
26,LR,1,150,7,-72,-68,-82,14
26,LR,0,150,2,-74,-72,-76,4
26,LR,1,150,9,-70,-67,-76,9
26,LR,1,150,4,-68.25,-67,-71,4
26,LR,1,150,8,-69.375,-68,-71,3
26,LR,0,150,2,-69,-68,-70,2
26,LR,1,150,8,-69.875,-68,-76,8
26,LR,1,150,5,-71.4,-69,-76,7
26,LR,1,150,8,-74.25,-71,-84,13
26,LR,1,150,9,-73.3333333333333,-70,-84,14
26,LR,1,150,8,-70.375,-69,-72,3
26,LR,1,150,3,-70,-69,-71,2
26,LR,1,150,5,-69,-67,-72,5
26,LR,1,150,9,-72.3333333333333,-70,-78,8
26,LR,1,150,8,-71.375,-69,-75,6
26,LR,0,150,2,-69.5,-69,-70,1
26,LR,1,150,6,-69.6666666666667,-66,-73,7
26,LR,1,150,7,-72.2857142857143,-67,-81,14
26,LR,1,150,5,-76.6,-70,-84,14
26,LR,1,150,3,-77.6666666666667,-71,-85,14
26,LR,1,150,6,-73.1666666666667,-70,-79,9
26,LR,0,150,2,-70,-70,-70,0
26,LR,1,150,5,-78.2,-75,-82,7
26,LR,1,150,4,-78.75,-75,-82,7
26,LR,0,150,1,-80,-80,-80,0
26,LR,1,150,3,-74.6666666666667,-72,-77,5
26,LR,1,150,7,-73.5714285714286,-72,-77,5
26,LR,1,150,7,-75.1428571428571,-72,-78,6
31,RL,1,200,8,-80,-71,-86,15
31,RL,1,200,8,-78,-74,-94,20
31,RL,1,200,7,-73.5714285714286,-70,-80,10
31,RL,1,200,4,-74.5,-72,-80,8
31,RL,1,200,8,-73.375,-71,-76,5
31,RL,1,200,10,-74,-71,-76,5
31,RL,1,200,5,-74,-73,-76,3
31,RL,0,200,1,-76,-76,-76,0
31,RL,1,200,9,-77.5555555555556,-76,-80,4
31,RL,1,200,8,-82,-79,-92,13
31,RL,1,200,10,-82.6,-79,-92,13
31,RL,1,200,6,-81.1666666666667,-77,-85,8
31,RL,1,200,5,-84.6,-81,-86,5
31,RL,1,200,10,-83,-74,-92,18
31,RL,1,200,8,-85.25,-77,-94,17
31,RL,1,200,8,-84.375,-79,-94,15
31,RL,1,200,8,-82.875,-81,-86,5
31,RL,1,200,7,-82.7142857142857,-82,-85,3
31,RL,1,200,3,-83,-83,-83,0
31,RL,1,200,5,-83,-83,-83,0
31,RL,1,200,9,-82.7777777777778,-82,-84,2
31,RL,1,200,3,-82.6666666666667,-82,-83,1
31,RL,1,200,5,-83.4,-83,-84,1
31,RL,1,200,9,-82.5555555555556,-82,-83,1
31,RL,1,200,5,-82.6,-82,-83,1
31,RL,1,200,6,-82,-80,-84,4
31,RL,0,200,1,-80,-80,-80,0
31,RL,1,200,6,-82.5,-80,-85,5
31,RL,1,200,7,-82.8571428571429,-80,-85,5
31,RL,1,200,10,-80.9,-76,-84,8
31,RL,0,200,1,-80,-80,-80,0
31,RL,0,200,1,-71,-71,-71,0
31,RL,1,200,6,-71.8333333333333,-70,-76,6
31,RL,0,200,1,-71,-71,-71,0
31,RL,1,200,10,-73.9,-70,-79,9
31,RL,1,200,9,-73.1111111111111,-70,-81,11
31,RL,1,200,6,-74.5,-70,-81,11
31,RL,1,200,9,-72.2222222222222,-70,-75,5
31,RL,0,200,2,-72.5,-70,-75,5
31,RL,1,200,8,-72.25,-71,-76,5
31,RL,1,200,5,-71.8,-71,-72,1
31,RL,1,200,5,-71.8,-71,-72,1
31,RL,1,200,10,-70.4,-70,-72,2
31,RL,1,200,10,-70.4,-70,-72,2
31,RL,1,200,5,-70.4,-70,-71,1
31,RL,1,200,3,-70.6666666666667,-70,-71,1
31,RL,1,200,8,-71.5,-70,-73,3
31,RL,1,200,10,-71.9,-70,-77,7
31,RL,1,200,9,-71.8888888888889,-70,-77,7
31,RL,0,200,2,-71.5,-71,-72,1
31,RL,1,200,4,-73.25,-72,-75,3
31,RL,1,200,4,-71.25,-70,-72,2
31,RL,0,200,1,-74,-74,-74,0
31,RL,0,200,2,-72,-72,-72,0
31,RL,1,200,4,-72.25,-70,-75,5
31,RL,1,200,10,-72.3,-70,-75,5
31,RL,1,200,4,-72.25,-71,-73,2
31,RL,1,200,9,-72.8888888888889,-70,-77,7
31,RL,1,200,6,-72.8333333333333,-70,-77,7
31,RL,0,200,2,-74.5,-73,-76,3
31,RL,1,200,5,-73.4,-73,-75,2
31,RL,0,200,1,-73,-73,-73,0
31,RL,1,200,3,-74,-72,-75,3
31,RL,1,200,6,-73.6666666666667,-72,-75,3
31,RL,1,200,9,-73.2222222222222,-72,-75,3
31,RL,1,200,5,-73.4,-72,-75,3
31,RL,1,200,6,-73.5,-72,-75,3
31,RL,1,200,8,-72.75,-72,-74,2
31,RL,1,200,8,-73.875,-72,-77,5
31,RL,1,200,7,-74.4285714285714,-72,-77,5
31,RL,1,200,9,-74.4444444444444,-72,-79,7
31,RL,1,200,10,-74,-70,-79,9
31,RL,1,200,9,-73.7777777777778,-70,-79,9
31,RL,1,200,6,-72.5,-70,-78,8
31,RL,1,200,5,-71.4,-70,-73,3
31,RL,1,200,6,-76.8333333333333,-73,-78,5
31,RL,1,200,7,-79.1428571428571,-78,-81,3
31,RL,0,200,2,-78.5,-78,-79,1
31,RL,1,200,4,-79.25,-78,-80,2
31,RL,1,200,7,-78.1428571428571,-77,-80,3
31,RL,1,200,5,-78.4,-77,-80,3
31,RL,0,200,2,-76.5,-76,-77,1
31,RL,1,200,5,-74.2,-72,-76,4
31,RL,1,200,3,-73.6666666666667,-72,-75,3
31,RL,1,200,5,-77.8,-74,-86,12
31,RL,0,200,2,-75.5,-74,-77,3
31,RL,1,200,5,-77.2,-77,-78,1
31,RL,1,200,4,-78.25,-77,-79,2
31,RL,1,200,7,-77.7142857142857,-77,-78,1
31,RL,1,200,8,-78,-77,-80,3
31,RL,0,200,1,-77,-77,-77,0
31,RL,1,200,8,-76,-74,-78,4
31,RL,0,200,2,-76,-74,-78,4
31,RL,0,200,1,-76,-76,-76,0
31,RL,1,200,3,-75,-74,-76,2
31,RL,1,200,10,-75.2,-73,-79,6
31,RL,1,200,3,-73.6666666666667,-73,-75,2
31,RL,1,200,5,-76.4,-74,-78,4
31,RL,1,200,9,-75.5555555555556,-74,-79,5
31,RL,0,200,2,-74,-74,-74,0
31,RL,1,200,4,-75.75,-74,-79,5
31,RL,1,200,8,-75.25,-74,-79,5
31,RL,1,200,4,-78.5,-75,-80,5
31,RL,1,200,5,-77,-74,-80,6
31,RL,0,200,1,-80,-80,-80,0
31,RL,1,200,10,-75.7,-74,-80,6
31,RL,1,200,10,-75.6,-74,-80,6
31,RL,1,200,9,-77.3333333333333,-74,-80,6
31,RL,1,200,9,-78.1111111111111,-75,-80,5
31,RL,1,200,3,-76.6666666666667,-75,-80,5
31,RL,0,200,1,-76,-76,-76,0
31,RL,1,200,5,-77.4,-76,-80,4
31,RL,1,200,7,-77.8571428571429,-75,-80,5
31,RL,1,200,8,-77.125,-75,-80,5
31,RL,1,200,10,-76.4,-74,-79,5
31,RL,1,200,3,-75.3333333333333,-74,-78,4
31,RL,0,200,1,-75,-75,-75,0
31,RL,1,200,8,-76.5,-75,-79,4
31,RL,1,200,5,-76.6,-76,-79,3
31,RL,1,200,9,-76.4444444444444,-74,-80,6
31,RL,1,200,6,-75.5,-74,-80,6
31,RL,1,200,9,-75.7777777777778,-74,-80,6
31,RL,1,200,6,-76.5,-75,-80,5
31,RL,1,200,9,-76.4444444444444,-75,-80,5
31,RL,1,200,5,-76.8,-75,-80,5
31,RL,1,200,4,-76.5,-75,-78,3
31,RL,1,200,6,-75.1666666666667,-74,-76,2
31,RL,0,200,2,-76,-76,-76,0
31,RL,0,200,2,-75,-74,-76,2
31,RL,1,200,7,-75.7142857142857,-74,-79,5
31,RL,1,200,5,-77.8,-75,-80,5
31,RL,1,200,10,-76.4,-74,-79,5
31,RL,1,200,4,-76.75,-74,-79,5
31,RL,1,200,3,-77.3333333333333,-74,-79,5
31,RL,0,200,2,-80.5,-80,-81,1
31,RL,1,200,7,-76,-72,-78,6
31,RL,1,200,8,-76.125,-72,-78,6
31,RL,1,200,4,-75.75,-72,-78,6
31,RL,1,200,9,-75.6666666666667,-72,-78,6
31,RL,1,200,10,-76.5,-74,-81,7
31,RL,1,200,6,-77.6666666666667,-74,-81,7
31,RL,1,200,5,-78.2,-74,-81,7
31,RL,1,200,7,-78,-74,-80,6
31,RL,1,200,8,-76.625,-74,-79,5
31,RL,1,200,4,-78,-76,-79,3
31,RL,1,200,9,-78,-74,-80,6
31,RL,1,200,7,-77.4285714285714,-73,-81,8
31,RL,1,200,10,-77.2,-73,-81,8
31,RL,0,200,2,-76.5,-73,-80,7
31,RL,1,200,9,-75.7777777777778,-73,-80,7
31,RL,1,200,8,-76.75,-73,-79,6
31,RL,1,200,6,-76.3333333333333,-73,-79,6
31,RL,1,200,4,-78,-77,-79,2
31,RL,1,200,5,-75.4,-73,-79,6
31,RL,0,200,1,-79,-79,-79,0
31,RL,1,200,3,-77.3333333333333,-77,-78,1
31,RL,1,200,4,-76.75,-74,-78,4
31,RL,1,200,9,-77.4444444444444,-76,-80,4
31,RL,0,200,1,-79,-79,-79,0
31,RL,0,200,2,-77,-76,-78,2
31,RL,1,200,7,-76.7142857142857,-76,-77,1
31,RL,1,200,9,-73.5555555555556,-72,-76,4
31,RL,1,200,8,-76.125,-73,-78,5
31,RL,1,200,3,-74.6666666666667,-73,-77,4
31,RL,1,200,9,-75.4444444444444,-74,-77,3
31,RL,1,200,8,-76,-74,-78,4
31,RL,1,200,3,-90.6666666666667,-84,-94,10
31,LR,0,200,2,-78,-77,-79,2
31,LR,1,200,6,-77.8333333333333,-74,-82,8
31,LR,1,200,5,-77.2,-74,-82,8
31,LR,1,200,3,-76.3333333333333,-74,-78,4
31,LR,0,200,2,-77.5,-77,-78,1
31,LR,1,200,5,-73.8,-72,-78,6
31,LR,0,200,2,-73,-73,-73,0
31,LR,1,200,9,-73.3333333333333,-72,-76,4
31,LR,0,200,2,-78,-76,-80,4
31,LR,1,200,10,-74.3,-72,-76,4
31,LR,1,200,8,-74.25,-72,-75,3
31,LR,1,200,3,-74.3333333333333,-74,-75,1
31,LR,1,200,9,-74.6666666666667,-72,-76,4
31,LR,1,200,6,-73.8333333333333,-72,-75,3
31,LR,0,200,2,-74.5,-74,-75,1
31,LR,0,200,2,-74.5,-74,-75,1
31,LR,0,200,1,-81,-81,-81,0
31,LR,1,200,5,-78.8,-75,-81,6
31,LR,0,200,2,-77.5,-75,-80,5
31,LR,1,200,4,-80.75,-72,-92,20
31,LR,1,200,5,-79,-72,-93,21
31,LR,0,200,1,-72,-72,-72,0
31,LR,1,200,8,-72.375,-70,-77,7
31,LR,1,200,5,-73,-70,-77,7
31,LR,1,200,4,-73.75,-71,-77,6
31,LR,1,200,7,-72.7142857142857,-70,-76,6
31,LR,0,200,1,-72,-72,-72,0
31,LR,1,200,7,-72,-70,-73,3
31,LR,1,200,6,-71.6666666666667,-70,-73,3
31,LR,1,200,5,-72,-71,-73,2
31,LR,1,200,5,-71.6,-70,-73,3
31,LR,0,200,1,-73,-73,-73,0
31,LR,1,200,9,-72.2222222222222,-70,-75,5
31,LR,1,200,5,-73.2,-72,-75,3
31,LR,1,200,3,-73,-72,-74,2
31,LR,0,200,1,-74,-74,-74,0
31,LR,1,200,10,-72.9,-70,-75,5
31,LR,1,200,10,-72.3,-70,-75,5
31,LR,1,200,5,-71.8,-70,-73,3
31,LR,0,200,1,-73,-73,-73,0
31,LR,0,200,1,-73,-73,-73,0
31,LR,1,200,5,-72.4,-71,-74,3
31,LR,1,200,9,-72.1111111111111,-70,-73,3
31,LR,1,200,7,-72,-70,-73,3
31,LR,1,200,9,-72.4444444444444,-70,-74,4
31,LR,0,200,2,-71.5,-70,-73,3
31,LR,0,200,2,-70.5,-70,-71,1
31,LR,0,200,2,-72,-72,-72,0
31,LR,1,200,3,-72.6666666666667,-72,-73,1
31,LR,1,200,8,-73.625,-71,-76,5
31,LR,1,200,4,-71.75,-70,-74,4
31,LR,1,200,8,-73.375,-71,-79,8
31,LR,1,200,8,-72.5,-70,-79,9
31,LR,1,200,8,-72.25,-70,-77,7
31,LR,1,200,8,-73.375,-72,-77,5
31,LR,1,200,9,-73.7777777777778,-71,-77,6
31,LR,1,200,7,-73.1428571428571,-71,-77,6
31,LR,1,200,3,-72.3333333333333,-71,-73,2
31,LR,1,200,3,-72,-70,-73,3
31,LR,1,200,5,-71.8,-70,-73,3
31,LR,1,200,4,-72.75,-72,-73,1
31,LR,1,200,9,-72.2222222222222,-71,-74,3
31,LR,1,200,9,-72.2222222222222,-71,-75,4
31,LR,1,200,8,-73,-70,-76,6
31,LR,1,200,3,-77,-73,-82,9
31,LR,1,200,5,-77.4,-71,-82,11
31,LR,1,200,3,-80.3333333333333,-73,-92,19
31,LR,1,200,9,-77.2222222222222,-74,-92,18
31,LR,1,200,7,-78,-74,-92,18
26,RL,0,200,1,-70,-70,-70,0
26,RL,1,200,4,-71.75,-69,-76,7
26,RL,1,200,7,-78.2857142857143,-74,-83,9
26,RL,1,200,6,-82.6666666666667,-77,-99,22
26,RL,1,200,3,-82.3333333333333,-74,-89,15
26,RL,1,200,9,-82.5555555555556,-81,-85,4
26,RL,0,200,1,-85,-85,-85,0
26,RL,0,200,1,-82,-82,-82,0
26,RL,1,200,10,-81.8,-80,-83,3
26,RL,0,200,2,-81,-81,-81,0
26,RL,1,200,7,-82.2857142857143,-82,-83,1
26,RL,1,200,10,-82.3,-82,-83,1
26,RL,1,200,8,-82,-79,-84,5
26,RL,1,200,10,-81.3,-79,-84,5
26,RL,0,200,1,-80,-80,-80,0
26,RL,1,200,5,-81,-79,-84,5
26,RL,0,200,1,-79,-79,-79,0
26,RL,1,200,8,-73,-69,-78,9
26,RL,1,200,7,-72.8571428571429,-69,-78,9
26,RL,1,200,7,-70.5714285714286,-69,-74,5
26,RL,1,200,5,-72.8,-71,-74,3
26,RL,1,200,6,-71.5,-70,-73,3
26,RL,1,200,9,-71.3333333333333,-69,-75,6
26,RL,0,200,2,-71,-70,-72,2
26,RL,0,200,2,-72,-70,-74,4
26,RL,1,200,5,-73,-72,-74,2
26,RL,0,200,2,-73,-72,-74,2
26,RL,0,200,1,-71,-71,-71,0
26,RL,0,200,1,-72,-72,-72,0
26,RL,1,200,9,-72.2222222222222,-71,-74,3
26,RL,1,200,4,-72,-71,-73,2
26,RL,1,200,6,-71.8333333333333,-71,-73,2
26,RL,1,200,8,-73.375,-70,-77,7
26,RL,1,200,4,-74.75,-72,-77,5
26,RL,1,200,7,-77.1428571428571,-75,-80,5
26,RL,1,200,8,-75.75,-70,-85,15
26,RL,1,200,6,-76.8333333333333,-74,-85,11
26,RL,1,200,6,-77.6666666666667,-75,-85,10
26,RL,1,200,4,-75.25,-73,-77,4
26,RL,1,200,10,-75.6,-72,-78,6
26,RL,0,200,1,-75,-75,-75,0
26,RL,1,200,7,-75.5714285714286,-72,-78,6
26,RL,1,200,8,-75.625,-74,-78,4
26,RL,0,200,1,-78,-78,-78,0
26,RL,1,200,10,-75.2,-73,-79,6
26,RL,1,200,7,-75,-73,-79,6
26,RL,0,200,2,-74.5,-74,-75,1
26,RL,1,200,5,-76,-74,-79,5
26,RL,1,200,9,-76.2222222222222,-74,-79,5
26,RL,1,200,4,-76.5,-74,-79,5
26,RL,1,200,7,-76.1428571428571,-74,-79,5
26,RL,0,200,1,-74,-74,-74,0
26,RL,1,200,9,-75,-74,-79,5
26,RL,0,200,2,-74,-74,-74,0
26,RL,0,200,1,-74,-74,-74,0
26,RL,1,200,6,-74.5,-73,-79,6
26,RL,0,200,2,-73.5,-73,-74,1
26,RL,1,200,5,-76.4,-73,-79,6
26,RL,1,200,4,-76,-73,-79,6
26,RL,1,200,4,-76.75,-73,-80,7
26,RL,0,200,1,-80,-80,-80,0
26,RL,1,200,9,-74.8888888888889,-71,-79,8
26,RL,0,200,2,-73.5,-71,-76,5
26,RL,1,200,9,-74.3333333333333,-71,-78,7
26,RL,1,200,8,-73.875,-72,-77,5
26,RL,1,200,3,-75.3333333333333,-74,-76,2
26,RL,1,200,3,-76,-73,-78,5
26,RL,0,200,2,-78,-77,-79,2
26,RL,1,200,9,-74.3333333333333,-72,-78,6
26,RL,1,200,8,-74.75,-72,-80,8
26,RL,1,200,8,-75.75,-72,-80,8
26,RL,0,200,1,-77,-77,-77,0
26,RL,1,200,10,-74.9,-72,-78,6
26,RL,0,200,1,-75,-75,-75,0
26,RL,1,200,4,-77.5,-76,-79,3
26,RL,1,200,7,-74.4285714285714,-72,-77,5
26,RL,0,200,1,-76,-76,-76,0
26,RL,1,200,6,-74.8333333333333,-72,-79,7
26,RL,1,200,9,-75.3333333333333,-72,-78,6
26,RL,1,200,10,-74.6,-72,-77,5
26,RL,1,200,8,-75.5,-72,-84,12
26,LR,0,200,2,-77,-77,-77,0
26,LR,0,200,1,-91,-91,-91,0
26,LR,1,200,4,-79.75,-79,-81,2
26,LR,1,200,4,-78.75,-76,-82,6
26,LR,1,200,9,-78.3333333333333,-75,-84,9
26,LR,0,200,2,-79.5,-75,-84,9
26,LR,1,200,6,-77.3333333333333,-75,-81,6
26,LR,0,200,2,-74,-74,-74,0
26,LR,1,200,6,-74.6666666666667,-73,-77,4
26,LR,1,200,3,-74.6666666666667,-73,-76,3
26,LR,1,200,4,-71.25,-70,-72,2
26,LR,1,200,7,-71.7142857142857,-70,-74,4
26,LR,1,200,8,-72,-70,-76,6
26,LR,1,200,9,-71.6666666666667,-68,-74,6
26,LR,0,200,1,-70,-70,-70,0
26,LR,1,200,9,-72.5555555555556,-68,-76,8
26,LR,1,200,6,-72.6666666666667,-70,-76,6
26,LR,1,200,4,-73.75,-73,-74,1
26,LR,1,200,5,-72.4,-72,-73,1
26,LR,0,200,1,-73,-73,-73,0
26,LR,1,200,4,-80.5,-76,-90,14
26,LR,1,200,10,-70.6,-68,-74,6
26,LR,1,200,9,-71.6666666666667,-70,-74,4
26,LR,0,200,2,-72,-71,-73,2
26,LR,1,200,4,-71.75,-70,-74,4
26,LR,0,200,1,-70,-70,-70,0
26,LR,1,200,10,-70.8,-70,-73,3
26,LR,1,200,10,-70.8,-70,-74,4
26,LR,0,200,1,-70,-70,-70,0
26,LR,1,200,7,-73.2857142857143,-70,-77,7
26,LR,1,200,9,-71.6666666666667,-70,-74,4
26,LR,0,200,2,-72,-70,-74,4
26,LR,0,200,1,-71,-71,-71,0
26,LR,1,200,7,-70.8571428571429,-69,-73,4
26,LR,1,200,6,-71.1666666666667,-69,-73,4
26,LR,1,200,6,-70.8333333333333,-70,-73,3
26,LR,1,200,10,-71,-70,-73,3
26,LR,1,200,9,-71.3333333333333,-70,-74,4
26,LR,1,200,9,-71.2222222222222,-70,-74,4
26,LR,1,200,5,-71.2,-70,-73,3
26,LR,1,200,3,-72.3333333333333,-71,-74,3
26,LR,0,200,1,-72,-72,-72,0
26,LR,1,200,3,-70,-69,-71,2
26,LR,1,200,6,-69.8333333333333,-69,-71,2
26,LR,1,200,10,-70.5,-70,-72,2
26,LR,1,200,6,-70.5,-70,-72,2
26,LR,1,200,10,-70.8,-70,-72,2
26,LR,1,200,5,-71.6,-70,-75,5
26,LR,1,200,9,-71.2222222222222,-70,-73,3
26,LR,1,200,7,-72.1428571428571,-70,-75,5
26,LR,0,200,1,-73,-73,-73,0
26,LR,1,200,9,-71.2222222222222,-69,-73,4
26,LR,1,200,6,-71.3333333333333,-69,-73,4
26,LR,1,200,6,-71.3333333333333,-70,-73,3
26,LR,0,200,1,-70,-70,-70,0
26,LR,1,200,3,-72.3333333333333,-71,-74,3
26,LR,0,200,2,-72.5,-71,-74,3
26,LR,1,200,10,-71,-69,-73,4
26,LR,1,200,6,-70.5,-70,-72,2
26,LR,1,200,3,-70,-70,-70,0
26,LR,0,200,1,-72,-72,-72,0
26,LR,0,200,2,-70,-70,-70,0
26,LR,0,200,2,-84.5,-77,-92,15
26,LR,1,200,7,-75.2857142857143,-70,-88,18
26,LR,1,200,4,-77,-70,-88,18
26,LR,1,200,10,-77.2,-70,-92,22
31,RL,0,250,7,-75.8571428571429,-69,-80,11
31,RL,1,250,9,-79,-69,-90,21
31,RL,0,250,2,-73,-69,-77,8
31,RL,0,250,6,-80.1666666666667,-78,-85,7
31,RL,0,250,2,-78.5,-78,-79,1
31,RL,0,250,2,-77,-77,-77,0
31,RL,0,250,4,-77.5,-77,-78,1
31,RL,0,250,5,-80.2,-76,-86,10
31,RL,0,250,2,-80.5,-80,-81,1
31,RL,0,250,6,-78.1666666666667,-75,-83,8
31,RL,0,250,4,-78.5,-75,-83,8
31,RL,0,250,8,-78.125,-75,-81,6
31,RL,1,250,9,-82.4444444444444,-80,-86,6
31,RL,0,250,7,-82.7142857142857,-80,-86,6
31,RL,0,250,8,-80.5,-79,-83,4
31,RL,0,250,8,-80.5,-79,-83,4
31,RL,1,250,10,-81.5,-79,-86,7
31,RL,0,250,4,-80.25,-79,-83,4
31,RL,1,250,9,-83.8888888888889,-79,-89,10
31,RL,1,250,9,-83.8888888888889,-78,-89,11
31,RL,0,250,5,-85.6,-82,-89,7
31,RL,1,250,9,-80.3333333333333,-78,-83,5
31,RL,0,250,8,-80.375,-78,-83,5
31,RL,0,250,1,-78,-78,-78,0
31,RL,0,250,2,-80.5,-79,-82,3
31,RL,0,250,8,-80,-78,-83,5
31,RL,0,250,5,-80.2,-78,-83,5
31,RL,0,250,8,-82.5,-81,-87,6
31,RL,0,250,5,-82.2,-81,-87,6
31,RL,0,250,3,-82.3333333333333,-82,-83,1
31,RL,0,250,2,-82.5,-82,-83,1
31,RL,0,250,3,-83.6666666666667,-79,-92,13
31,RL,0,250,4,-82.25,-82,-83,1
31,RL,1,250,9,-82,-76,-87,11
31,RL,0,250,4,-78,-76,-83,7
31,RL,0,250,8,-80,-77,-82,5
31,RL,0,250,1,-78,-78,-78,0
31,RL,0,250,7,-81.4285714285714,-79,-82,3
31,RL,1,250,9,-81,-79,-82,3
31,RL,0,250,6,-81,-79,-82,3
31,RL,0,250,6,-82.6666666666667,-80,-88,8
31,RL,0,250,4,-82.25,-80,-88,8
31,RL,0,250,8,-81.375,-80,-83,3
31,RL,0,250,7,-81.7142857142857,-80,-83,3
31,RL,0,250,4,-86.75,-80,-93,13
31,RL,0,250,5,-81.8,-79,-92,13
31,RL,1,250,10,-80.8,-77,-84,7
31,RL,0,250,7,-80.1428571428571,-79,-83,4
31,RL,0,250,6,-79.6666666666667,-79,-82,3
31,RL,0,250,1,-95,-95,-95,0
31,RL,1,250,9,-82.5555555555556,-79,-88,9
31,RL,1,250,9,-82,-80,-84,4
31,RL,0,250,5,-81.2,-78,-85,7
31,RL,0,250,2,-82,-80,-84,4
31,RL,0,250,6,-83.3333333333333,-79,-85,6
31,RL,0,250,2,-80.5,-79,-82,3
31,RL,0,250,3,-83,-79,-85,6
31,RL,0,250,1,-87,-87,-87,0
31,RL,0,250,6,-83.6666666666667,-82,-87,5
31,RL,1,250,10,-82.9,-79,-90,11
31,RL,1,250,9,-81.4444444444444,-78,-86,8
31,RL,0,250,5,-79.8,-78,-82,4
31,RL,0,250,2,-84.5,-83,-86,3
31,RL,0,250,7,-81.8571428571429,-80,-83,3
31,RL,0,250,5,-80,-78,-82,4
31,RL,0,250,6,-81.1666666666667,-78,-87,9
31,RL,0,250,3,-80,-78,-82,4
31,RL,0,250,2,-87,-84,-90,6
31,RL,0,250,4,-82.75,-82,-85,3
31,RL,0,250,3,-81.3333333333333,-80,-82,2
31,RL,0,250,1,-85,-85,-85,0
31,RL,1,250,9,-82.3333333333333,-79,-86,7
31,RL,0,250,8,-82.75,-79,-88,9
31,RL,1,250,10,-84.2,-80,-88,8
31,RL,1,250,9,-84.4444444444444,-80,-88,8
31,RL,1,250,10,-84.1,-80,-88,8
31,RL,0,250,4,-83.75,-83,-86,3
31,RL,0,250,7,-85.8571428571429,-79,-98,19
31,RL,0,250,5,-85.4,-84,-86,2
31,RL,1,250,9,-84.2222222222222,-79,-90,11
31,RL,1,250,9,-83.5555555555556,-77,-90,13
31,RL,1,250,10,-84.7,-77,-90,13
31,RL,0,250,8,-84,-81,-88,7
31,RL,1,250,9,-84.3333333333333,-81,-90,9
31,RL,0,250,1,-83,-83,-83,0
31,RL,0,250,1,-84,-84,-84,0
31,RL,0,250,1,-84,-84,-84,0
31,RL,0,250,4,-81,-80,-82,2
31,RL,0,250,4,-84,-78,-86,8
31,RL,1,250,10,-85.5,-82,-88,6
31,RL,0,250,5,-84.8,-81,-87,6
31,RL,0,250,6,-84.8333333333333,-82,-87,5
31,RL,0,250,1,-87,-87,-87,0
31,RL,1,250,10,-86.2,-77,-94,17
31,RL,0,250,4,-88,-77,-94,17
31,RL,1,250,9,-81.1111111111111,-78,-84,6
31,RL,0,250,6,-85.6666666666667,-83,-90,7
31,RL,0,250,1,-90,-90,-90,0
31,RL,0,250,8,-86.375,-81,-90,9
31,RL,0,250,7,-85.2857142857143,-81,-90,9
31,RL,1,250,10,-84,-80,-89,9
31,RL,0,250,7,-85.8571428571429,-80,-90,10
31,RL,0,250,2,-87,-85,-89,4
31,RL,0,250,5,-82.4,-81,-84,3
31,RL,0,250,8,-82.5,-80,-86,6
31,RL,0,250,8,-83.125,-80,-86,6
31,RL,1,250,9,-83.7777777777778,-80,-86,6
31,RL,1,250,9,-83.4444444444444,-80,-88,8
31,RL,0,250,6,-83.6666666666667,-80,-88,8
31,RL,0,250,8,-84,-80,-90,10
31,RL,0,250,6,-84.3333333333333,-80,-90,10
31,RL,1,250,10,-84.8,-80,-95,15
31,RL,0,250,3,-85.3333333333333,-83,-90,7
31,RL,0,250,5,-84.4,-80,-95,15
31,RL,1,250,10,-85.2,-78,-95,17
31,RL,0,250,5,-86,-81,-95,14
31,RL,0,250,1,-81,-81,-81,0
31,RL,0,250,3,-82.6666666666667,-80,-84,4
31,RL,0,250,8,-82.625,-79,-93,14
31,RL,0,250,1,-93,-93,-93,0
31,RL,0,250,6,-86,-81,-92,11
31,RL,1,250,10,-84.7,-81,-89,8
31,RL,0,250,6,-83.6666666666667,-82,-86,4
31,RL,0,250,7,-84.5714285714286,-82,-89,7
31,RL,0,250,8,-83.5,-81,-89,8
31,RL,0,250,1,-87,-87,-87,0
31,RL,0,250,5,-85.6,-81,-96,15
31,RL,0,250,1,-83,-83,-83,0
31,RL,0,250,1,-84,-84,-84,0
31,RL,0,250,1,-81,-81,-81,0
31,RL,1,250,9,-82.2222222222222,-80,-93,13
31,RL,1,250,9,-83.7777777777778,-80,-92,12
31,RL,0,250,2,-82,-78,-86,8
31,RL,0,250,5,-82.4,-77,-88,11
31,RL,0,250,8,-82.75,-80,-88,8
31,RL,0,250,2,-87.5,-87,-88,1
31,RL,1,250,10,-83.1,-80,-90,10
31,RL,0,250,1,-82,-82,-82,0
31,RL,1,250,10,-85.9,-82,-90,8
31,RL,0,250,8,-85.5,-80,-90,10
31,RL,0,250,6,-84.3333333333333,-80,-88,8
31,RL,0,250,8,-84.375,-79,-92,13
31,RL,0,250,2,-94,-93,-95,2
31,RL,0,250,6,-88.3333333333333,-81,-95,14
31,RL,1,250,10,-83.2,-79,-92,13
31,RL,0,250,4,-81.5,-81,-82,1
31,RL,1,250,10,-81.5,-79,-84,5
31,RL,0,250,4,-80.75,-80,-81,1
31,RL,0,250,4,-80.75,-79,-83,4
31,RL,0,250,7,-81.8571428571429,-79,-84,5
31,RL,0,250,5,-82.8,-82,-84,2
31,RL,0,250,4,-83.25,-81,-85,4
31,RL,0,250,7,-83.1428571428571,-81,-87,6
31,RL,0,250,8,-79.125,-67,-87,20
31,RL,0,250,8,-80.375,-67,-92,25
31,LR,0,250,7,-71.1428571428571,-68,-76,8
31,LR,0,250,8,-72.5,-69,-76,7
31,LR,0,250,7,-72.8571428571429,-71,-76,5
31,LR,1,250,10,-72.1,-70,-76,6
31,LR,0,250,2,-73,-70,-76,6
31,LR,1,250,9,-80,-75,-92,17
31,LR,0,250,2,-81,-76,-86,10
31,LR,0,250,7,-78.5714285714286,-76,-81,5
31,LR,0,250,6,-73.6666666666667,-72,-75,3
31,LR,0,250,8,-73.25,-71,-76,5
31,LR,0,250,5,-72.6,-71,-75,4
31,LR,0,250,3,-73.6666666666667,-71,-75,4
31,LR,0,250,7,-82.4285714285714,-76,-93,17
31,LR,0,250,5,-86.2,-80,-93,13
31,LR,0,250,8,-84.625,-79,-92,13
31,LR,1,250,9,-85.1111111111111,-81,-90,9
31,LR,0,250,3,-83.6666666666667,-83,-84,1
31,LR,0,250,4,-81,-76,-86,10
31,LR,0,250,3,-82.3333333333333,-76,-86,10
31,LR,0,250,4,-84.5,-79,-92,13
31,LR,0,250,4,-81.5,-79,-84,5
31,LR,0,250,6,-79.5,-77,-84,7
31,LR,0,250,7,-79.7142857142857,-74,-86,12
31,LR,0,250,7,-79.8571428571429,-74,-86,12
31,LR,0,250,2,-77,-77,-77,0
31,LR,0,250,1,-74,-74,-74,0
31,LR,0,250,8,-78.125,-74,-82,8
31,LR,0,250,5,-79,-75,-82,7
31,LR,0,250,3,-81,-80,-82,2
31,LR,0,250,2,-81.5,-81,-82,1
31,LR,1,250,9,-79.3333333333333,-76,-84,8
31,LR,1,250,9,-78.2222222222222,-74,-83,9
31,LR,0,250,8,-77.25,-73,-86,13
31,LR,0,250,4,-76.25,-73,-78,5
31,LR,0,250,7,-77.2857142857143,-73,-86,13
31,LR,0,250,4,-76,-74,-79,5
31,LR,1,250,10,-79.6,-74,-85,11
31,LR,0,250,3,-81.3333333333333,-75,-85,10
31,LR,0,250,3,-81.3333333333333,-76,-89,13
31,LR,0,250,2,-80.5,-72,-89,17
31,LR,1,250,10,-78,-75,-86,11
31,LR,0,250,7,-78.1428571428571,-75,-81,6
31,LR,0,250,3,-78.3333333333333,-77,-80,3
31,LR,0,250,2,-76.5,-73,-80,7
31,LR,0,250,6,-79,-74,-82,8
31,LR,0,250,6,-80.8333333333333,-75,-86,11
31,LR,0,250,5,-75.8,-72,-81,9
31,LR,0,250,8,-81.25,-72,-87,15
31,LR,1,250,10,-80.9,-73,-89,16
31,LR,1,250,10,-78.4,-73,-83,10
31,LR,1,250,9,-78.4444444444444,-73,-86,13
31,LR,0,250,4,-80.25,-76,-86,10
31,LR,0,250,6,-79.1666666666667,-74,-89,15
31,LR,0,250,7,-78.1428571428571,-74,-84,10
31,LR,0,250,6,-74.5,-72,-80,8
31,LR,0,250,5,-78.4,-73,-83,10
31,LR,0,250,6,-80,-73,-86,13
31,LR,0,250,1,-73,-73,-73,0
31,LR,0,250,4,-78.25,-76,-83,7
31,LR,0,250,5,-78.6,-72,-85,13
31,LR,0,250,7,-75.8571428571429,-72,-79,7
31,LR,0,250,4,-76,-72,-79,7
31,LR,1,250,10,-76.4,-72,-83,11
31,LR,1,250,10,-79.1,-73,-88,15
31,LR,0,250,5,-77.6,-74,-86,12
31,LR,0,250,7,-77.7142857142857,-73,-80,7
31,LR,0,250,1,-80,-80,-80,0
31,LR,0,250,2,-82.5,-80,-85,5
31,LR,0,250,3,-77,-72,-81,9
31,LR,0,250,1,-74,-74,-74,0
31,LR,0,250,8,-79.625,-74,-88,14
31,LR,0,250,8,-82.125,-76,-88,12
31,LR,1,250,10,-80.3,-73,-88,15
31,LR,0,250,8,-80.125,-72,-88,16
31,LR,1,250,10,-81,-75,-87,12
31,LR,0,250,2,-79,-79,-79,0
31,LR,1,250,9,-78.8888888888889,-72,-98,26
31,LR,0,250,8,-77.875,-73,-83,10
31,LR,1,250,9,-77.4444444444444,-71,-84,13
31,LR,0,250,1,-73,-73,-73,0
31,LR,1,250,9,-80.5555555555556,-71,-93,22
31,LR,1,250,9,-81.5555555555556,-71,-93,22
26,RL,1,250,10,-73.9,-68,-81,13
26,RL,0,250,2,-76,-74,-78,4
26,RL,0,250,6,-79.1666666666667,-76,-83,7
26,RL,0,250,2,-78,-76,-80,4
26,RL,0,250,2,-75.5,-72,-79,7
26,RL,0,250,8,-76.375,-74,-79,5
26,RL,0,250,6,-77.1666666666667,-75,-79,4
26,RL,0,250,1,-79,-79,-79,0
26,RL,0,250,2,-83.5,-83,-84,1
26,RL,0,250,5,-80.6,-79,-82,3
26,RL,1,250,10,-80.6,-79,-83,4
26,RL,0,250,2,-80,-79,-81,2
26,RL,0,250,5,-80.4,-79,-83,4
26,RL,0,250,6,-79.1666666666667,-77,-82,5
26,RL,0,250,8,-81.5,-77,-90,13
26,RL,0,250,6,-81,-80,-82,2
26,RL,0,250,6,-79.8333333333333,-77,-82,5
26,RL,0,250,4,-80.25,-79,-82,3
26,RL,0,250,2,-79.5,-79,-80,1
26,RL,0,250,5,-78.6,-78,-80,2
26,RL,0,250,6,-81.1666666666667,-78,-84,6
26,RL,0,250,6,-79.6666666666667,-78,-82,4
26,RL,0,250,2,-80,-78,-82,4
26,RL,0,250,7,-80.5714285714286,-78,-88,10
26,RL,0,250,2,-83.5,-79,-88,9
26,RL,0,250,7,-82.7142857142857,-79,-94,15
26,RL,0,250,1,-81,-81,-81,0
26,RL,0,250,6,-82,-78,-88,10
26,RL,0,250,4,-80.75,-78,-84,6
26,RL,0,250,6,-84.8333333333333,-79,-90,11
26,RL,0,250,2,-88,-88,-88,0
26,RL,0,250,8,-83,-78,-94,16
26,RL,1,250,9,-83.2222222222222,-78,-94,16
26,RL,0,250,1,-81,-81,-81,0
26,RL,1,250,10,-81.6,-78,-84,6
26,RL,1,250,9,-81.6666666666667,-78,-84,6
26,RL,0,250,2,-83.5,-83,-84,1
26,RL,0,250,3,-84.6666666666667,-83,-86,3
26,RL,0,250,7,-79.2857142857143,-78,-81,3
26,RL,0,250,3,-79.6666666666667,-79,-81,2
26,RL,0,250,6,-81.3333333333333,-79,-86,7
26,RL,1,250,9,-81.3333333333333,-79,-85,6
26,RL,0,250,3,-80.3333333333333,-79,-81,2
26,RL,1,250,9,-81.3333333333333,-79,-85,6
26,RL,0,250,4,-83.75,-78,-91,13
26,RL,0,250,6,-82.5,-79,-85,6
26,RL,1,250,10,-83.9,-79,-88,9
26,RL,0,250,4,-84.5,-79,-88,9
26,RL,0,250,5,-82,-77,-86,9
26,RL,0,250,6,-80.8333333333333,-76,-84,8
26,RL,0,250,8,-82.875,-80,-86,6
26,RL,0,250,1,-83,-83,-83,0
26,RL,0,250,8,-82.75,-76,-93,17
26,RL,1,250,10,-82.2,-78,-93,15
26,RL,0,250,2,-80,-78,-82,4
26,RL,0,250,6,-81.3333333333333,-77,-88,11
26,RL,1,250,9,-81.8888888888889,-76,-88,12
26,RL,0,250,7,-84.4285714285714,-80,-89,9
26,RL,0,250,4,-83.75,-82,-85,3
26,RL,0,250,1,-80,-80,-80,0
26,RL,0,250,3,-81,-79,-83,4
26,RL,0,250,2,-80,-79,-81,2
26,RL,0,250,4,-83.5,-79,-87,8
26,RL,0,250,3,-86,-80,-91,11
26,RL,0,250,5,-83.8,-80,-90,10
26,RL,0,250,2,-83,-83,-83,0
26,RL,0,250,8,-85,-79,-92,13
26,RL,0,250,4,-85.75,-81,-97,16
26,RL,0,250,3,-80,-79,-81,2
26,RL,0,250,7,-82.5714285714286,-80,-90,10
26,RL,0,250,6,-82.8333333333333,-77,-98,21
26,RL,0,250,1,-82,-82,-82,0
26,RL,0,250,2,-85,-82,-88,6
26,RL,0,250,3,-81.3333333333333,-80,-82,2
26,RL,0,250,4,-80.25,-78,-83,5
26,RL,0,250,5,-82.8,-78,-94,16
26,RL,0,250,8,-82.625,-78,-94,16
26,RL,0,250,7,-81.8571428571429,-79,-84,5
26,RL,0,250,1,-82,-82,-82,0
26,RL,0,250,8,-81.125,-79,-84,5
26,RL,0,250,2,-72,-68,-76,8
26,RL,0,250,6,-76.5,-68,-82,14
26,LR,0,250,3,-82.3333333333333,-72,-93,21
26,LR,0,250,2,-74,-72,-76,4
26,LR,0,250,7,-76.7142857142857,-73,-87,14
26,LR,0,250,1,-73,-73,-73,0
26,LR,0,250,1,-74,-74,-74,0
26,LR,0,250,4,-77,-71,-83,12
26,LR,1,250,10,-77.6,-72,-86,14
26,LR,0,250,2,-77.5,-74,-81,7
26,LR,0,250,4,-72.5,-70,-77,7
26,LR,0,250,6,-74.6666666666667,-70,-78,8
26,LR,1,250,10,-78.7,-72,-86,14
26,LR,0,250,5,-82.8,-77,-86,9
26,LR,1,250,9,-85.5555555555556,-78,-96,18
26,LR,0,250,3,-89.3333333333333,-83,-96,13
26,LR,0,250,1,-96,-96,-96,0
26,LR,0,250,7,-85.4285714285714,-82,-91,9
26,LR,0,250,7,-84.4285714285714,-82,-91,9
26,LR,1,250,9,-84,-74,-94,20
26,LR,1,250,10,-82.2,-74,-94,20
26,LR,1,250,10,-82.3,-76,-94,18
26,LR,0,250,2,-78.5,-78,-79,1
26,LR,0,250,7,-81.1428571428571,-74,-86,12
26,LR,0,250,6,-80.3333333333333,-74,-86,12
26,LR,0,250,7,-77.4285714285714,-73,-82,9
26,LR,0,250,2,-74.5,-74,-75,1
26,LR,0,250,5,-75.6,-71,-83,12
26,LR,1,250,9,-77.6666666666667,-72,-83,11
26,LR,0,250,7,-83.4285714285714,-78,-94,16
26,LR,0,250,4,-83.75,-74,-94,20
26,LR,0,250,6,-79.3333333333333,-74,-84,10
26,LR,0,250,5,-74,-70,-77,7
26,LR,0,250,5,-75.6,-74,-77,3
26,LR,0,250,7,-76.8571428571429,-74,-82,8
26,LR,0,250,8,-81.75,-75,-96,21
26,LR,1,250,9,-79.3333333333333,-75,-86,11
26,LR,0,250,5,-79.4,-75,-86,11
26,LR,0,250,6,-79.1666666666667,-73,-86,13
26,LR,0,250,7,-79.2857142857143,-73,-89,16
26,LR,1,250,10,-76.9,-72,-86,14
26,LR,0,250,6,-75.6666666666667,-72,-80,8
26,LR,0,250,3,-73.3333333333333,-72,-76,4
26,LR,0,250,5,-73,-72,-74,2
26,LR,0,250,7,-75.5714285714286,-72,-88,16
26,LR,0,250,6,-75.8333333333333,-70,-88,18
26,LR,0,250,7,-79,-70,-93,23
26,LR,0,250,2,-79.5,-73,-86,13
26,LR,0,250,2,-81,-80,-82,2
26,LR,0,250,8,-78.875,-72,-87,15
26,LR,0,250,4,-76.5,-71,-81,10
26,LR,0,250,5,-79,-73,-81,8
26,LR,0,250,7,-75.2857142857143,-71,-88,17
26,LR,1,250,9,-76.2222222222222,-71,-88,17
26,LR,0,250,7,-75.8571428571429,-72,-82,10
26,LR,0,250,5,-76,-72,-82,10
26,LR,0,250,7,-78.4285714285714,-75,-82,7
26,LR,0,250,4,-81,-76,-92,16
26,LR,0,250,8,-74.625,-70,-79,9
26,LR,0,250,3,-73.6666666666667,-72,-77,5
26,LR,1,250,10,-79.6,-73,-89,16
26,LR,0,250,1,-81,-81,-81,0
26,LR,1,250,9,-78.7777777777778,-74,-86,12
26,LR,0,250,5,-78.8,-74,-86,12
26,LR,0,250,5,-79.4,-74,-86,12
26,LR,0,250,6,-76.5,-72,-82,10
26,LR,0,250,7,-78.5714285714286,-72,-86,14
26,LR,0,250,3,-83.3333333333333,-76,-92,16
31,RL,0,300,5,-77.4,-74,-86,12
31,RL,0,300,4,-75.25,-74,-78,4
31,RL,0,300,8,-82.25,-77,-87,10
31,RL,0,300,7,-81.7142857142857,-77,-87,10
31,RL,1,300,10,-80,-76,-83,7
31,RL,0,300,2,-83.5,-83,-84,1
31,RL,0,300,8,-80,-78,-84,6
31,RL,0,300,8,-79.625,-78,-82,4
31,RL,0,300,8,-79.5,-78,-82,4
31,RL,0,300,8,-80,-78,-83,5
31,RL,0,300,3,-80.3333333333333,-78,-82,4
31,RL,0,300,1,-82,-82,-82,0
31,RL,0,300,1,-80,-80,-80,0
31,RL,0,300,4,-80.5,-80,-81,1
31,RL,0,300,6,-79.6666666666667,-77,-82,5
31,RL,1,300,9,-79.4444444444444,-77,-82,5
31,RL,1,300,9,-80.3333333333333,-78,-83,5
31,RL,0,300,8,-80.25,-78,-83,5
31,RL,1,300,10,-81,-79,-83,4
31,RL,0,300,2,-81,-80,-82,2
31,RL,0,300,4,-81.25,-80,-83,3
31,RL,0,300,7,-81.5714285714286,-80,-83,3
31,RL,1,300,10,-80.7,-80,-82,2
31,RL,0,300,6,-82.6666666666667,-80,-86,6
31,RL,0,300,8,-83.25,-80,-86,6
31,RL,0,300,4,-83,-82,-84,2
31,RL,0,300,4,-85,-82,-87,5
31,RL,0,300,2,-83.5,-82,-85,3
31,RL,0,300,3,-82.3333333333333,-81,-85,4
31,RL,0,300,2,-81,-81,-81,0
31,RL,0,300,4,-85.5,-83,-90,7
31,RL,0,300,4,-83.5,-83,-84,1
31,RL,0,300,5,-84.8,-81,-87,6
31,RL,0,300,6,-83,-79,-85,6
31,RL,0,300,4,-83.5,-82,-86,4
31,RL,0,300,8,-83.5,-81,-90,9
31,RL,1,300,9,-83,-81,-90,9
31,RL,1,300,10,-82.9,-81,-90,9
31,RL,0,300,5,-83.2,-81,-90,9
31,RL,0,300,4,-81.5,-81,-82,1
31,RL,0,300,1,-86,-86,-86,0
31,RL,0,300,5,-85,-82,-91,9
31,RL,0,300,1,-91,-91,-91,0
31,RL,1,300,9,-87.3333333333333,-82,-94,12
31,RL,0,300,3,-90.6666666666667,-84,-94,10
31,RL,0,300,7,-82.7142857142857,-82,-84,2
31,RL,0,300,7,-84,-82,-94,12
31,RL,0,300,1,-83,-83,-83,0
31,RL,0,300,3,-82,-82,-82,0
31,RL,1,300,10,-81.2,-79,-84,5
31,RL,0,300,2,-81.5,-81,-82,1
31,RL,0,300,1,-81,-81,-81,0
31,RL,0,300,1,-81,-81,-81,0
31,RL,0,300,5,-82.8,-81,-84,3
31,RL,1,300,9,-81.1111111111111,-79,-83,4
31,RL,0,300,1,-79,-79,-79,0
31,RL,0,300,5,-81,-79,-82,3
31,RL,0,300,2,-81.5,-81,-82,1
31,RL,0,300,4,-82,-82,-82,0
31,RL,0,300,3,-81.6666666666667,-81,-82,1
31,RL,0,300,7,-80.8571428571429,-80,-82,2
31,RL,1,300,10,-81.9,-80,-84,4
31,RL,0,300,2,-83.5,-83,-84,1
31,RL,0,300,2,-81.5,-80,-83,3
31,RL,0,300,7,-83.8571428571429,-81,-88,7
31,RL,0,300,3,-84.6666666666667,-81,-88,7
31,RL,0,300,3,-82.6666666666667,-82,-83,1
31,RL,0,300,4,-85.5,-84,-86,2
31,RL,0,300,6,-85.6666666666667,-81,-91,10
31,RL,1,300,10,-85.7,-81,-91,10
31,RL,1,300,9,-86.2222222222222,-81,-91,10
31,RL,0,300,4,-86,-81,-90,9
31,RL,0,300,8,-86,-81,-90,9
31,RL,0,300,1,-83,-83,-83,0
31,RL,0,300,6,-83.6666666666667,-81,-87,6
31,RL,0,300,7,-84,-81,-88,7
31,RL,0,300,6,-84.8333333333333,-82,-88,6
31,RL,1,300,10,-81.3,-74,-88,14
31,RL,0,300,7,-79.4285714285714,-77,-83,6
31,RL,0,300,4,-81.75,-80,-83,3
31,RL,0,300,4,-79.75,-78,-82,4
31,RL,0,300,5,-84,-77,-94,17
31,RL,0,300,4,-80.75,-79,-82,3
31,RL,0,300,4,-80,-78,-82,4
31,RL,1,300,10,-80.8,-78,-84,6
31,RL,0,300,7,-82.1428571428571,-81,-84,3
31,RL,0,300,4,-82,-81,-83,2
31,RL,0,300,3,-82,-81,-83,2
31,RL,0,300,3,-82.3333333333333,-81,-84,3
31,RL,1,300,9,-82,-80,-84,4
31,RL,0,300,4,-81.5,-80,-84,4
31,RL,0,300,6,-82.3333333333333,-80,-84,4
31,RL,0,300,5,-82,-80,-84,4
31,RL,0,300,7,-81.8571428571429,-80,-85,5
31,RL,1,300,10,-81.5,-80,-84,4
31,RL,0,300,5,-81.4,-80,-83,3
31,RL,0,300,2,-81.5,-81,-82,1
31,RL,0,300,7,-80.5714285714286,-79,-84,5
31,RL,0,300,7,-80.8571428571429,-79,-84,5
31,RL,0,300,1,-86,-86,-86,0
31,RL,1,300,10,-83,-80,-88,8
31,RL,0,300,2,-81,-81,-81,0
31,RL,1,300,10,-81.5,-81,-85,4
31,RL,0,300,6,-81,-80,-82,2
31,RL,0,300,1,-82,-82,-82,0
31,RL,0,300,2,-80.5,-80,-81,1
31,RL,0,300,1,-80,-80,-80,0
31,RL,0,300,4,-81.5,-79,-84,5
31,RL,0,300,5,-83.4,-77,-89,12
31,RL,0,300,1,-86,-86,-86,0
31,RL,0,300,1,-89,-89,-89,0
31,RL,0,300,2,-85,-81,-89,8
31,RL,0,300,3,-83.6666666666667,-80,-89,9
31,RL,0,300,3,-84.3333333333333,-81,-88,7
31,RL,0,300,6,-85.3333333333333,-82,-89,7
31,RL,0,300,2,-85,-82,-88,6
31,RL,1,300,10,-85,-81,-89,8
31,RL,0,300,8,-83.125,-81,-90,9
31,RL,0,300,2,-82.5,-82,-83,1
31,RL,0,300,6,-82.6666666666667,-81,-84,3
31,RL,0,300,6,-83,-81,-84,3
31,RL,0,300,4,-78.25,-76,-79,3
31,RL,0,300,7,-82.4285714285714,-77,-100,23
31,RL,0,300,8,-79.25,-76,-81,5
31,RL,0,300,2,-81,-81,-81,0
31,RL,1,300,9,-81.6666666666667,-76,-88,12
31,RL,0,300,2,-79.5,-76,-83,7
31,RL,0,300,5,-84,-80,-88,8
31,RL,0,300,3,-84.6666666666667,-80,-88,8
31,RL,0,300,8,-81.25,-79,-86,7
31,RL,0,300,1,-81,-81,-81,0
31,RL,0,300,1,-85,-85,-85,0
31,RL,1,300,10,-87.6,-77,-99,22
31,RL,0,300,4,-80.75,-79,-83,4
31,RL,0,300,3,-80,-79,-82,3
31,RL,1,300,9,-80.3333333333333,-79,-83,4
31,RL,0,300,1,-83,-83,-83,0
31,RL,0,300,6,-80.3333333333333,-79,-81,2
31,RL,0,300,3,-80.3333333333333,-79,-81,2
31,RL,1,300,10,-80.7,-79,-83,4
31,RL,1,300,10,-80.5,-79,-83,4
31,RL,1,300,9,-80.4444444444444,-79,-83,4
31,RL,0,300,6,-80.5,-79,-82,3
31,RL,0,300,7,-78.2857142857143,-77,-82,5
31,RL,0,300,5,-78.8,-77,-82,5
31,RL,0,300,1,-82,-82,-82,0
31,RL,0,300,7,-79,-77,-81,4
31,RL,0,300,6,-81.6666666666667,-77,-85,8
31,RL,0,300,2,-78,-77,-79,2
31,RL,0,300,5,-79.4,-77,-83,6
31,RL,0,300,7,-80,-77,-83,6
31,RL,0,300,6,-80.6666666666667,-78,-83,5
31,RL,0,300,1,-81,-81,-81,0
31,RL,0,300,1,-84,-84,-84,0
31,RL,0,300,8,-86.125,-79,-90,11
31,RL,0,300,5,-85.2,-79,-90,11
31,RL,0,300,3,-83,-79,-90,11
31,RL,1,300,9,-83.6666666666667,-79,-90,11
31,RL,0,300,2,-81.5,-79,-84,5
31,RL,0,300,6,-81.5,-79,-85,6
31,RL,0,300,1,-79,-79,-79,0
31,RL,0,300,4,-79.25,-77,-82,5
31,RL,0,300,7,-78,-77,-79,2
31,RL,0,300,6,-78,-77,-80,3
31,RL,0,300,5,-78.2,-77,-80,3
31,RL,0,300,5,-83.6,-79,-97,18
31,RL,1,300,9,-81.6666666666667,-76,-88,12
31,RL,0,300,7,-81.8571428571429,-76,-88,12
31,RL,0,300,8,-80.25,-76,-86,10
31,RL,0,300,1,-76,-76,-76,0
31,RL,0,300,6,-80.6666666666667,-77,-83,6
31,RL,0,300,7,-81.1428571428571,-78,-84,6
31,RL,1,300,10,-81.5,-78,-86,8
31,RL,0,300,1,-77,-77,-77,0
31,RL,0,300,3,-78.6666666666667,-76,-80,4
31,RL,1,300,10,-78.5,-76,-81,5
31,RL,1,300,9,-82.1111111111111,-77,-91,14
31,RL,1,300,9,-82.8888888888889,-78,-91,13
31,RL,0,300,3,-81.6666666666667,-78,-89,11
31,RL,0,300,1,-77,-77,-77,0
31,RL,0,300,4,-80.25,-77,-83,6
31,RL,1,300,9,-81.6666666666667,-77,-88,11
31,RL,0,300,1,-86,-86,-86,0
31,RL,1,300,10,-81.2,-77,-91,14
31,RL,0,300,5,-83,-77,-91,14
31,RL,1,300,10,-81.9,-75,-91,16
31,LR,0,300,3,-85,-82,-89,7
31,LR,0,300,7,-83.2857142857143,-79,-96,17
31,LR,0,300,1,-84,-84,-84,0
31,LR,0,300,8,-78.375,-75,-83,8
31,LR,0,300,3,-89.6666666666667,-88,-92,4
31,LR,0,300,3,-85,-78,-89,11
31,LR,0,300,5,-79.8,-75,-89,14
31,LR,0,300,3,-78.3333333333333,-77,-80,3
31,LR,0,300,4,-85,-81,-88,7
31,LR,1,300,9,-83.1111111111111,-76,-93,17
31,LR,0,300,6,-84.1666666666667,-76,-93,17
31,LR,1,300,9,-86.5555555555556,-79,-94,15
31,LR,0,300,2,-95,-94,-96,2
31,LR,0,300,8,-86.625,-74,-96,22
31,LR,0,300,6,-82,-74,-88,14
31,LR,0,300,5,-80.8,-74,-84,10
31,LR,0,300,6,-79.6666666666667,-74,-88,14
31,LR,0,300,5,-78,-74,-82,8
31,LR,0,300,1,-77,-77,-77,0
31,LR,0,300,6,-80.1666666666667,-78,-83,5
31,LR,0,300,4,-79,-77,-80,3
31,LR,0,300,5,-78.8,-73,-81,8
31,LR,1,300,10,-79,-73,-90,17
31,LR,0,300,3,-77.3333333333333,-73,-80,7
31,LR,0,300,1,-80,-80,-80,0
31,LR,0,300,7,-83.1428571428571,-72,-96,24
31,LR,1,300,10,-84.7,-79,-96,17
31,LR,1,300,9,-82.2222222222222,-73,-96,23
31,LR,0,300,3,-82.3333333333333,-79,-86,7
31,LR,0,300,6,-79,-73,-86,13
31,LR,1,300,9,-80.5555555555556,-73,-88,15
31,LR,0,300,5,-80,-73,-88,15
31,LR,0,300,1,-87,-87,-87,0
31,LR,0,300,3,-79,-77,-81,4
31,LR,0,300,8,-77.375,-72,-94,22
31,LR,1,300,10,-81.9,-77,-92,15
31,LR,0,300,4,-81.75,-78,-87,9
31,LR,0,300,8,-80,-77,-86,9
31,LR,1,300,10,-82.5,-77,-93,16
31,LR,1,300,9,-81.1111111111111,-74,-93,19
31,LR,0,300,6,-82.3333333333333,-74,-93,19
31,LR,0,300,6,-81,-74,-94,20
31,LR,0,300,2,-81,-78,-84,6
31,LR,0,300,8,-84.125,-76,-92,16
31,LR,0,300,4,-82,-79,-89,10
31,LR,1,300,9,-82.4444444444444,-77,-90,13
31,LR,0,300,7,-83.5714285714286,-77,-90,13
31,LR,0,300,5,-82.6,-77,-88,11
31,LR,0,300,2,-85,-79,-91,12
31,LR,0,300,5,-81,-78,-86,8
31,LR,0,300,1,-79,-79,-79,0
31,LR,0,300,6,-81.6666666666667,-78,-90,12
31,LR,0,300,1,-81,-81,-81,0
31,LR,0,300,8,-78.875,-75,-90,15
31,LR,0,300,4,-78.75,-78,-80,2
31,LR,0,300,3,-80.6666666666667,-78,-84,6
31,LR,0,300,8,-80.75,-77,-93,16
31,LR,0,300,6,-77.8333333333333,-74,-80,6
31,LR,0,300,6,-82.1666666666667,-75,-88,13
31,LR,0,300,3,-84.6666666666667,-78,-88,10
31,LR,0,300,3,-80.3333333333333,-76,-88,12
31,LR,0,300,6,-81.1666666666667,-77,-84,7
31,LR,0,300,2,-82.5,-81,-84,3
31,LR,0,300,8,-79,-77,-82,5
31,LR,1,300,9,-78.4444444444444,-76,-80,4
31,LR,0,300,8,-79.5,-76,-82,6
31,LR,1,300,10,-80.5,-76,-85,9
31,LR,0,300,2,-81.5,-80,-83,3
31,LR,1,300,9,-83.6666666666667,-77,-91,14
31,LR,0,300,6,-85.1666666666667,-77,-91,14
31,LR,0,300,3,-87.6666666666667,-84,-91,7
31,LR,1,300,10,-83.8,-77,-92,15
31,LR,0,300,5,-86.8,-82,-91,9
26,RL,0,300,8,-77.875,-76,-80,4
26,RL,0,300,2,-77.5,-77,-78,1
26,RL,0,300,3,-77.3333333333333,-77,-78,1
26,RL,1,300,10,-78.9,-76,-83,7
26,RL,0,300,6,-78.6666666666667,-75,-82,7
26,RL,0,300,5,-79.2,-75,-82,7
26,RL,0,300,7,-79.7142857142857,-78,-81,3
26,RL,0,300,1,-81,-81,-81,0
26,RL,1,300,9,-80.2222222222222,-79,-82,3
26,RL,0,300,6,-80.8333333333333,-77,-83,6
26,RL,1,300,9,-80.1111111111111,-77,-84,7
26,RL,0,300,4,-79.25,-77,-82,5
26,RL,0,300,1,-78,-78,-78,0
26,RL,0,300,4,-85.5,-81,-94,13
26,RL,1,300,9,-83.3333333333333,-79,-87,8
26,RL,0,300,7,-83.8571428571429,-79,-87,8
26,RL,0,300,5,-83.6,-81,-87,6
26,RL,1,300,10,-84.9,-81,-90,9
26,RL,1,300,9,-84.5555555555556,-80,-90,10
26,RL,0,300,5,-81.8,-80,-87,7
26,RL,0,300,3,-85.6666666666667,-81,-95,14
26,RL,0,300,2,-88.5,-82,-95,13
26,RL,1,300,10,-79.4,-77,-82,5
26,RL,1,300,9,-79.5555555555556,-77,-82,5
26,RL,0,300,7,-81.7142857142857,-80,-83,3
26,RL,1,300,10,-81.9,-81,-83,2
26,RL,1,300,10,-82,-80,-83,3
26,RL,0,300,6,-82.8333333333333,-79,-86,7
26,RL,0,300,2,-83,-81,-85,4
26,RL,0,300,7,-83.1428571428571,-80,-85,5
26,RL,0,300,5,-79.8,-76,-83,7
26,RL,0,300,6,-80.1666666666667,-75,-82,7
26,RL,1,300,9,-79.4444444444444,-77,-83,6
26,RL,0,300,8,-80.625,-78,-83,5
26,RL,0,300,1,-83,-83,-83,0
26,RL,0,300,3,-81,-80,-83,3
26,RL,0,300,3,-79.6666666666667,-79,-80,1
26,RL,0,300,5,-80.4,-78,-84,6
26,RL,0,300,5,-81.6,-78,-84,6
26,RL,0,300,6,-82,-79,-84,5
26,RL,1,300,9,-81.4444444444444,-79,-84,5
26,RL,1,300,9,-80.8888888888889,-79,-84,5
26,RL,0,300,7,-80.2857142857143,-79,-84,5
26,RL,0,300,1,-79,-79,-79,0
26,RL,0,300,7,-82,-79,-88,9
26,RL,0,300,6,-82.5,-80,-88,8
26,RL,1,300,10,-81.9,-79,-88,9
26,RL,0,300,5,-80.8,-79,-84,5
26,RL,0,300,5,-80.8,-79,-84,5
26,RL,0,300,1,-82,-82,-82,0
26,RL,0,300,1,-79,-79,-79,0
26,RL,0,300,7,-81.8571428571429,-79,-86,7
26,RL,0,300,3,-81.6666666666667,-79,-86,7
26,RL,0,300,4,-85,-79,-90,11
26,RL,1,300,9,-83.3333333333333,-80,-90,10
26,RL,0,300,3,-76.6666666666667,-76,-78,2
26,RL,0,300,2,-77.5,-75,-80,5
26,RL,1,300,10,-80.9,-74,-92,18
26,RL,0,300,8,-79.25,-74,-83,9
26,RL,0,300,1,-78,-78,-78,0
26,RL,1,300,10,-79.6,-74,-83,9
26,RL,0,300,5,-80.8,-77,-86,9
26,RL,1,300,10,-78.5,-76,-81,5
26,RL,0,300,8,-78.75,-76,-81,5
26,RL,0,300,1,-82,-82,-82,0
26,RL,0,300,4,-80,-76,-82,6
26,RL,0,300,6,-80.3333333333333,-76,-83,7
26,RL,1,300,10,-81.7,-76,-86,10
26,RL,0,300,5,-81.6,-76,-87,11
26,RL,0,300,6,-85.5,-78,-98,20
26,RL,0,300,7,-78.5714285714286,-75,-83,8
26,RL,1,300,9,-78,-75,-83,8
26,RL,1,300,9,-77.4444444444444,-75,-82,7
26,RL,0,300,1,-75,-75,-75,0
26,RL,0,300,5,-77.6,-75,-80,5
26,RL,0,300,5,-78.2,-76,-80,4
26,RL,0,300,1,-80,-80,-80,0
26,RL,0,300,8,-83.75,-77,-94,17
26,LR,0,300,8,-79,-76,-86,10
26,LR,0,300,3,-84,-74,-94,20
26,LR,0,300,4,-82.5,-72,-94,22
26,LR,0,300,5,-74.6,-72,-76,4
26,LR,0,300,5,-81,-76,-88,12
26,LR,0,300,3,-79.3333333333333,-78,-80,2
26,LR,0,300,2,-82,-80,-84,4
26,LR,0,300,4,-79.25,-78,-80,2
26,LR,0,300,2,-80,-78,-82,4
26,LR,0,300,3,-78,-73,-83,10
26,LR,0,300,8,-77.25,-72,-81,9
26,LR,0,300,7,-77.1428571428571,-73,-81,8
26,LR,0,300,3,-78.6666666666667,-77,-80,3
26,LR,1,300,10,-79.1,-72,-86,14
26,LR,1,300,10,-78.1,-73,-86,13
26,LR,0,300,7,-76.5714285714286,-73,-83,10
26,LR,0,300,1,-76,-76,-76,0
26,LR,0,300,1,-76,-76,-76,0
26,LR,0,300,8,-78.875,-73,-86,13
26,LR,0,300,5,-79.4,-73,-82,9
26,LR,0,300,1,-73,-73,-73,0
26,LR,0,300,1,-77,-77,-77,0
26,LR,1,300,9,-80.5555555555556,-76,-85,9
26,LR,0,300,7,-79.7142857142857,-76,-86,10
26,LR,0,300,7,-83.1428571428571,-75,-91,16
26,LR,0,300,6,-80.8333333333333,-75,-87,12
26,LR,0,300,2,-81,-75,-87,12
26,LR,1,300,10,-77.3,-72,-87,15
26,LR,0,300,6,-77.6666666666667,-74,-79,5
26,LR,1,300,10,-81.2,-75,-89,14
26,LR,0,300,4,-82,-78,-89,11
26,LR,1,300,10,-80.7,-75,-90,15
26,LR,0,300,6,-80.1666666666667,-77,-90,13
26,LR,0,300,8,-81,-77,-90,13
26,LR,0,300,8,-79.5,-77,-89,12
26,LR,0,300,3,-78.3333333333333,-77,-80,3
26,LR,1,300,10,-80,-77,-89,12
26,LR,0,300,4,-78,-77,-79,2
26,LR,0,300,6,-80.5,-76,-85,9
26,LR,0,300,8,-79.25,-74,-87,13
26,LR,0,300,4,-80.75,-78,-88,10
26,LR,0,300,7,-84.2857142857143,-77,-96,19
26,LR,0,300,3,-87.6666666666667,-77,-96,19
26,LR,0,300,6,-80.8333333333333,-76,-92,16
26,LR,0,300,1,-81,-81,-81,0
26,LR,0,300,4,-77.5,-76,-79,3
26,LR,0,300,5,-76.8,-76,-77,1
26,LR,0,300,5,-77.8,-77,-79,2
26,LR,0,300,8,-78.125,-73,-88,15
26,LR,0,300,7,-80,-74,-88,14
26,LR,0,300,4,-79.5,-74,-86,12
26,LR,0,300,5,-78.8,-74,-82,8
26,LR,0,300,2,-78,-76,-80,4
26,LR,1,300,9,-78.2222222222222,-74,-82,8
26,LR,0,300,8,-78.375,-73,-86,13
26,LR,0,300,4,-79,-73,-86,13
26,LR,1,300,10,-78.4,-73,-86,13
31,RL,1,350,9,-82.1111111111111,-77,-85,8
31,RL,0,350,4,-84.75,-83,-89,6
31,RL,0,350,1,-78,-78,-78,0
31,RL,0,350,6,-81.5,-77,-86,9
31,RL,0,350,8,-83.75,-78,-89,11
31,RL,0,350,3,-86.3333333333333,-83,-89,6
31,RL,1,350,10,-83.5,-78,-91,13
31,RL,0,350,6,-85,-82,-91,9
31,RL,0,350,8,-86.125,-81,-91,10
31,RL,0,350,2,-89,-88,-90,2
31,RL,0,350,5,-87.4,-83,-95,12
31,RL,0,350,7,-86.2857142857143,-81,-97,16
31,RL,0,350,7,-79.2857142857143,-77,-82,5
31,RL,0,350,8,-77.125,-76,-79,3
31,RL,0,350,8,-77,-76,-78,2
31,RL,0,350,1,-76,-76,-76,0
31,RL,0,350,3,-77.6666666666667,-77,-78,1
31,RL,0,350,8,-80,-78,-82,4
31,RL,0,350,1,-84,-84,-84,0
31,RL,0,350,3,-82.3333333333333,-82,-83,1
31,RL,1,350,10,-79.9,-78,-82,4
31,RL,0,350,4,-80.5,-80,-82,2
31,RL,1,350,9,-78.8888888888889,-78,-81,3
31,RL,0,350,1,-83,-83,-83,0
31,RL,0,350,3,-80,-78,-81,3
31,RL,0,350,3,-79.3333333333333,-78,-80,2
31,RL,0,350,5,-78.6,-78,-80,2
31,RL,0,350,5,-80.8,-80,-82,2
31,RL,1,350,10,-80.4,-79,-83,4
31,RL,0,350,7,-80.7142857142857,-79,-83,4
31,RL,1,350,9,-80.6666666666667,-79,-83,4
31,RL,0,350,2,-81.5,-80,-83,3
31,RL,0,350,3,-80.3333333333333,-79,-83,4
31,RL,0,350,3,-83.6666666666667,-80,-89,9
31,RL,1,350,9,-84.2222222222222,-80,-88,8
31,RL,0,350,5,-85.2,-80,-92,12
31,RL,0,350,2,-87.5,-83,-92,9
31,RL,1,350,10,-83.2,-78,-88,10
31,RL,0,350,8,-83.5,-78,-88,10
31,RL,0,350,4,-86.5,-85,-88,3
31,RL,0,350,5,-80.6,-78,-88,10
31,RL,0,350,6,-83.3333333333333,-77,-90,13
31,RL,0,350,2,-89,-88,-90,2
31,RL,0,350,7,-82.4285714285714,-80,-85,5
31,RL,0,350,7,-81.4285714285714,-80,-85,5
31,RL,0,350,6,-80.6666666666667,-80,-81,1
31,RL,1,350,10,-82.2,-76,-88,12
31,RL,0,350,8,-79.5,-76,-82,6
31,RL,1,350,10,-78,-76,-82,6
31,RL,0,350,3,-79.3333333333333,-76,-86,10
31,RL,0,350,5,-79.6,-75,-86,11
31,RL,1,350,9,-83.7777777777778,-76,-92,16
31,RL,0,350,7,-78.5714285714286,-75,-83,8
31,RL,0,350,1,-75,-75,-75,0
31,RL,0,350,1,-83,-83,-83,0
31,RL,0,350,1,-76,-76,-76,0
31,RL,0,350,1,-88,-88,-88,0
31,RL,0,350,4,-78.5,-78,-79,1
31,RL,0,350,5,-79.8,-78,-86,8
31,RL,0,350,6,-80.5,-77,-86,9
31,RL,1,350,9,-79.1111111111111,-76,-86,10
31,RL,0,350,1,-77,-77,-77,0
31,RL,1,350,10,-77.1,-76,-80,4
31,RL,0,350,6,-77.6666666666667,-76,-80,4
31,RL,0,350,5,-85.4,-83,-88,5
31,RL,1,350,10,-81.4,-77,-86,9
31,RL,0,350,5,-80.6,-78,-85,7
31,RL,0,350,6,-80.1666666666667,-77,-83,6
31,RL,0,350,2,-81.5,-80,-83,3
31,RL,1,350,9,-82,-77,-87,10
31,RL,0,350,3,-83.6666666666667,-79,-90,11
31,RL,0,350,4,-81.5,-80,-83,3
31,RL,0,350,5,-79.6,-77,-82,5
31,RL,0,350,6,-82.1666666666667,-78,-86,8
31,RL,1,350,9,-82.1111111111111,-78,-86,8
31,RL,0,350,5,-84,-83,-86,3
31,RL,1,350,9,-83.5555555555556,-80,-86,6
31,RL,0,350,8,-83.25,-80,-86,6
31,RL,1,350,10,-83.9,-81,-86,5
31,RL,0,350,4,-81.75,-78,-84,6
31,RL,0,350,7,-80.2857142857143,-78,-90,12
31,RL,0,350,7,-82.5714285714286,-78,-94,16
31,RL,0,350,6,-83.8333333333333,-78,-94,16
31,RL,0,350,2,-79.5,-79,-80,1
31,RL,1,350,10,-83.2,-77,-94,17
31,RL,1,350,9,-83.5555555555556,-77,-94,17
31,RL,0,350,1,-78,-78,-78,0
31,RL,0,350,6,-80.8333333333333,-77,-89,12
31,RL,0,350,4,-79.75,-78,-85,7
31,RL,0,350,3,-77.3333333333333,-76,-78,2
31,RL,0,350,7,-87.4285714285714,-78,-100,22
31,RL,0,350,6,-85.3333333333333,-78,-100,22
31,RL,0,350,5,-81.8,-77,-96,19
31,RL,0,350,6,-82,-78,-98,20
31,RL,0,350,2,-80,-80,-80,0
31,RL,1,350,10,-82.9,-80,-91,11
31,RL,0,350,4,-80,-80,-80,0
31,RL,0,350,4,-77.75,-74,-84,10
31,RL,0,350,1,-76,-76,-76,0
31,RL,0,350,6,-77.5,-77,-78,1
31,RL,0,350,1,-78,-78,-78,0
31,RL,0,350,3,-77.6666666666667,-77,-78,1
31,RL,0,350,5,-76.8,-76,-78,2
31,RL,0,350,3,-79.3333333333333,-79,-80,1
31,RL,0,350,5,-79.2,-78,-80,2
31,RL,0,350,7,-78.8571428571429,-78,-80,2
31,RL,0,350,4,-79.25,-78,-82,4
31,RL,1,350,10,-78.5,-77,-84,7
31,RL,0,350,3,-77,-77,-77,0
31,RL,0,350,2,-76.5,-75,-78,3
31,RL,0,350,1,-76,-76,-76,0
31,RL,0,350,2,-79,-76,-82,6
31,RL,0,350,7,-82,-78,-87,9
31,RL,0,350,7,-79.2857142857143,-77,-83,6
31,RL,0,350,3,-79.6666666666667,-78,-82,4
31,RL,0,350,4,-78.25,-77,-81,4
31,RL,0,350,5,-80.6,-78,-85,7
31,RL,0,350,8,-81.625,-78,-85,7
31,RL,0,350,4,-82.5,-78,-85,7
31,RL,0,350,8,-81.75,-79,-85,6
31,RL,1,350,10,-82,-79,-87,8
31,RL,1,350,10,-82,-79,-87,8
31,RL,0,350,6,-82.3333333333333,-79,-87,8
31,RL,1,350,9,-82.4444444444444,-81,-87,6
31,RL,0,350,5,-86.6,-80,-91,11
31,RL,0,350,1,-78,-78,-78,0
31,RL,1,350,9,-82.3333333333333,-79,-85,6
31,RL,0,350,2,-82.5,-81,-84,3
31,RL,0,350,4,-82.25,-80,-84,4
31,RL,0,350,7,-85.1428571428571,-84,-88,4
31,RL,0,350,4,-83.25,-78,-91,13
31,RL,0,350,5,-81.8,-78,-86,8
31,RL,0,350,6,-80.1666666666667,-78,-84,6
31,RL,1,350,10,-78.4,-77,-81,4
31,RL,0,350,6,-78.6666666666667,-77,-81,4
31,RL,0,350,7,-79,-78,-81,3
31,RL,0,350,4,-78.75,-78,-81,3
31,RL,0,350,3,-80.3333333333333,-79,-81,2
31,RL,0,350,6,-79.8333333333333,-77,-83,6
31,RL,0,350,6,-79.8333333333333,-77,-83,6
31,RL,1,350,10,-79.8,-77,-83,6
31,RL,0,350,7,-80.8571428571429,-76,-85,9
31,RL,0,350,1,-76,-76,-76,0
31,RL,1,350,9,-80,-77,-85,8
31,RL,0,350,5,-79.2,-77,-85,8
31,RL,1,350,10,-79.3,-78,-84,6
31,RL,0,350,8,-79.25,-78,-84,6
31,RL,0,350,3,-80,-78,-84,6
31,RL,1,350,10,-79.2,-78,-81,3
31,RL,0,350,4,-78.25,-78,-79,1
31,RL,1,350,10,-79.5,-78,-82,4
31,RL,0,350,6,-79.1666666666667,-77,-82,5
31,RL,0,350,4,-78.75,-78,-80,2
31,RL,1,350,9,-79.3333333333333,-76,-84,8
31,RL,0,350,8,-79.375,-76,-84,8
31,RL,0,350,1,-92,-92,-92,0
31,RL,0,350,3,-86.6666666666667,-78,-92,14
31,LR,0,350,5,-88.4,-81,-92,11
31,LR,0,350,2,-86.5,-81,-92,11
31,LR,0,350,3,-86.3333333333333,-82,-92,10
31,LR,0,350,8,-80,-77,-90,13
31,LR,0,350,8,-80.125,-77,-90,13
31,LR,1,350,10,-80.9,-78,-90,12
31,LR,0,350,3,-79.3333333333333,-79,-80,1
31,LR,0,350,2,-81.5,-79,-84,5
31,LR,0,350,4,-79.5,-78,-83,5
31,LR,0,350,4,-79.75,-76,-84,8
31,LR,0,350,3,-76.3333333333333,-75,-78,3
31,LR,1,350,9,-80.2222222222222,-75,-87,12
31,LR,0,350,8,-76.875,-74,-82,8
31,LR,0,350,4,-77.5,-74,-81,7
31,LR,0,350,3,-78,-76,-81,5
31,LR,0,350,6,-82.8333333333333,-75,-87,12
31,LR,1,350,9,-82.5555555555556,-76,-87,11
31,LR,0,350,8,-79.5,-77,-84,7
31,LR,0,350,1,-77,-77,-77,0
31,LR,0,350,7,-78.7142857142857,-76,-81,5
31,LR,0,350,2,-79,-78,-80,2
31,LR,0,350,2,-79.5,-79,-80,1
31,LR,0,350,6,-80,-79,-83,4
31,LR,1,350,9,-79.3333333333333,-78,-83,5
31,LR,0,350,2,-79.5,-79,-80,1
31,LR,0,350,6,-81.1666666666667,-78,-86,8
31,LR,1,350,9,-81.2222222222222,-78,-86,8
31,LR,1,350,9,-80.2222222222222,-78,-87,9
31,LR,0,350,3,-78.6666666666667,-78,-79,1
31,LR,1,350,10,-80.3,-78,-88,10
31,LR,0,350,1,-81,-81,-81,0
31,LR,0,350,8,-81.5,-78,-92,14
31,LR,1,350,10,-81.7,-78,-92,14
31,LR,0,350,5,-81.6,-80,-83,3
31,LR,0,350,5,-81.8,-80,-83,3
31,LR,0,350,3,-77.6666666666667,-77,-78,1
31,LR,1,350,10,-82.8,-78,-91,13
31,LR,0,350,2,-79.5,-79,-80,1
31,LR,0,350,7,-83.7142857142857,-78,-91,13
31,LR,0,350,4,-81.75,-78,-91,13
31,LR,0,350,5,-81.2,-77,-87,10
31,LR,0,350,4,-80,-78,-83,5
31,LR,0,350,4,-82.5,-80,-86,6
31,LR,0,350,7,-83.4285714285714,-78,-93,15
31,LR,0,350,8,-78.875,-76,-82,6
31,LR,0,350,7,-76.7142857142857,-75,-83,8
31,LR,0,350,7,-76,-73,-83,10
31,LR,0,350,8,-78.875,-73,-86,13
31,LR,0,350,2,-74.5,-73,-76,3
31,LR,0,350,5,-82,-76,-86,10
31,LR,1,350,10,-82.7,-78,-88,10
31,LR,0,350,1,-87,-87,-87,0
31,LR,0,350,6,-81.1666666666667,-78,-86,8
31,LR,0,350,8,-78.625,-77,-82,5
31,LR,0,350,2,-80.5,-79,-82,3
31,LR,0,350,1,-82,-82,-82,0
31,LR,0,350,1,-77,-77,-77,0
31,LR,0,350,1,-82,-82,-82,0
31,LR,0,350,4,-78,-77,-79,2
31,LR,1,350,10,-82.1,-77,-89,12
31,LR,0,350,8,-83.375,-77,-89,12
31,LR,0,350,2,-84,-81,-87,6
31,LR,0,350,1,-87,-87,-87,0
31,LR,0,350,8,-83.25,-76,-88,12
31,LR,0,350,2,-82.5,-77,-88,11
31,LR,1,350,10,-81.7,-75,-87,12
31,LR,1,350,10,-81,-75,-87,12
31,LR,1,350,10,-81.8,-75,-90,15
31,LR,0,350,7,-83,-75,-90,15
31,LR,0,350,7,-80.4285714285714,-75,-88,13
31,LR,0,350,8,-80.125,-74,-88,14
31,LR,1,350,10,-79.5,-74,-88,14
31,LR,0,350,3,-78,-74,-81,7
31,LR,1,350,9,-77.4444444444444,-74,-81,7
31,LR,0,350,6,-77.5,-74,-80,6
31,LR,1,350,9,-77.5555555555556,-74,-83,9
31,LR,0,350,2,-79.5,-76,-83,7
31,LR,0,350,2,-76,-74,-78,4
31,LR,0,350,2,-78.5,-75,-82,7
31,LR,1,350,10,-81,-77,-87,10
31,LR,0,350,7,-79.2857142857143,-75,-88,13
31,LR,1,350,9,-79.5555555555556,-74,-83,9
31,LR,1,350,9,-79.7777777777778,-74,-86,12
31,LR,1,350,10,-77.1,-74,-83,9
31,LR,1,350,9,-77.4444444444444,-74,-83,9
31,LR,0,350,8,-77.375,-74,-81,7
31,LR,0,350,4,-76.5,-74,-79,5
31,LR,0,350,7,-77.7142857142857,-76,-80,4
31,LR,0,350,8,-77.125,-74,-80,6
31,LR,0,350,3,-76.6666666666667,-74,-80,6
31,LR,0,350,2,-76,-74,-78,4
31,LR,1,350,9,-78.6666666666667,-76,-90,14
31,LR,0,350,5,-77.4,-76,-79,3
31,LR,1,350,9,-79.3333333333333,-74,-90,16
31,LR,0,350,7,-79.5714285714286,-74,-87,13
26,RL,0,350,5,-82.4,-79,-87,8
26,RL,1,350,9,-80.8888888888889,-79,-87,8
26,RL,0,350,2,-80.5,-80,-81,1
26,RL,0,350,1,-80,-80,-80,0
26,RL,1,350,10,-83.8,-79,-92,13
26,RL,0,350,7,-83,-79,-86,7
26,RL,0,350,4,-83,-79,-86,7
26,RL,0,350,2,-82,-79,-85,6
26,RL,0,350,2,-82,-82,-82,0
26,RL,0,350,3,-82.6666666666667,-81,-85,4
26,RL,0,350,4,-78.25,-76,-82,6
26,RL,0,350,1,-76,-76,-76,0
26,RL,0,350,6,-79.1666666666667,-76,-81,5
26,RL,0,350,3,-78,-78,-78,0
26,RL,0,350,7,-78.2857142857143,-77,-80,3
26,RL,0,350,1,-80,-80,-80,0
26,RL,0,350,8,-78.5,-76,-80,4
26,RL,0,350,2,-79,-79,-79,0
26,RL,0,350,7,-78.5714285714286,-78,-80,2
26,RL,0,350,1,-80,-80,-80,0
26,RL,1,350,9,-77.4444444444444,-76,-79,3
26,RL,1,350,9,-78.6666666666667,-76,-81,5
26,RL,0,350,7,-84,-80,-88,8
26,RL,0,350,8,-84.5,-80,-88,8
26,RL,0,350,5,-83.4,-80,-88,8
26,RL,0,350,2,-88,-82,-94,12
26,RL,0,350,6,-81.1666666666667,-78,-88,10
26,RL,0,350,1,-80,-80,-80,0
26,RL,0,350,1,-77,-77,-77,0
26,RL,0,350,6,-82,-75,-90,15
26,RL,0,350,3,-78.3333333333333,-76,-80,4
26,RL,0,350,5,-83.8,-76,-90,14
26,RL,0,350,7,-77.2857142857143,-76,-78,2
26,RL,0,350,1,-77,-77,-77,0
26,RL,0,350,4,-78.75,-75,-82,7
26,RL,0,350,2,-83.5,-79,-88,9
26,RL,0,350,4,-81,-78,-84,6
26,RL,0,350,3,-81.6666666666667,-80,-84,4
26,RL,0,350,4,-83.75,-80,-88,8
26,RL,0,350,4,-79.25,-79,-80,1
26,RL,1,350,10,-81,-77,-86,9
26,RL,0,350,7,-80.5714285714286,-77,-86,9
26,RL,1,350,10,-80.6,-77,-86,9
26,RL,0,350,3,-82,-78,-90,12
26,RL,0,350,5,-81.2,-76,-87,11
26,RL,0,350,8,-82.625,-78,-93,15
26,RL,0,350,4,-82.25,-78,-92,14
26,RL,0,350,4,-83.5,-79,-90,11
26,RL,1,350,10,-81,-75,-88,13
26,RL,0,350,7,-81.1428571428571,-75,-88,13
26,RL,0,350,3,-84.3333333333333,-78,-88,10
26,RL,1,350,9,-76.1111111111111,-74,-80,6
26,RL,0,350,2,-76.5,-76,-77,1
26,RL,1,350,9,-78.5555555555556,-76,-81,5
26,RL,0,350,7,-77.2857142857143,-75,-80,5
26,RL,0,350,7,-78.2857142857143,-75,-82,7
26,RL,0,350,8,-81.5,-79,-87,8
26,RL,0,350,2,-79.5,-79,-80,1
26,RL,1,350,10,-83.5,-77,-92,15
26,RL,0,350,4,-87.25,-85,-92,7
26,RL,0,350,2,-82.5,-79,-86,7
26,RL,0,350,3,-84,-82,-86,4
26,RL,0,350,8,-82,-79,-87,8
26,RL,0,350,6,-82.6666666666667,-80,-87,7
26,RL,1,350,9,-81.3333333333333,-79,-83,4
26,RL,0,350,1,-79,-79,-79,0
26,RL,0,350,1,-86,-86,-86,0
26,RL,1,350,9,-78.1111111111111,-77,-80,3
26,RL,0,350,3,-77.3333333333333,-77,-78,1
26,RL,0,350,6,-78.3333333333333,-77,-82,5
26,RL,0,350,2,-78,-77,-79,2
26,RL,0,350,3,-78,-77,-79,2
26,RL,0,350,8,-78.875,-77,-81,4
26,RL,0,350,1,-80,-80,-80,0
26,RL,0,350,3,-79.3333333333333,-78,-81,3
26,RL,1,350,9,-80,-78,-83,5
26,RL,1,350,9,-78.7777777777778,-77,-81,4
26,RL,1,350,9,-78.8888888888889,-77,-81,4
26,LR,0,350,8,-86.75,-80,-94,14
26,LR,1,350,10,-86.4,-78,-95,17
26,LR,1,350,9,-85.5555555555556,-78,-95,17
26,LR,0,350,1,-82,-82,-82,0
26,LR,0,350,4,-78.75,-77,-84,7
26,LR,0,350,3,-84.3333333333333,-77,-92,15
26,LR,0,350,7,-83,-77,-92,15
26,LR,1,350,9,-77.7777777777778,-75,-84,9
26,LR,0,350,1,-75,-75,-75,0
26,LR,1,350,9,-80.7777777777778,-74,-87,13
26,LR,0,350,4,-83.25,-74,-87,13
26,LR,0,350,4,-78.5,-75,-86,11
26,LR,1,350,9,-75,-73,-77,4
26,LR,0,350,6,-74.8333333333333,-73,-77,4
26,LR,0,350,1,-74,-74,-74,0
26,LR,0,350,5,-78,-73,-85,12
26,LR,0,350,7,-81,-74,-88,14
26,LR,0,350,5,-80.8,-74,-88,14
26,LR,0,350,2,-79.5,-75,-84,9
26,LR,1,350,9,-79,-76,-82,6
26,LR,0,350,4,-77.25,-76,-79,3
26,LR,0,350,3,-77,-76,-79,3
26,LR,0,350,7,-78.2857142857143,-77,-80,3
26,LR,0,350,2,-79.5,-79,-80,1
26,LR,0,350,1,-81,-81,-81,0
26,LR,1,350,9,-77.8888888888889,-76,-81,5
26,LR,0,350,6,-77.8333333333333,-76,-81,5
26,LR,0,350,3,-78.6666666666667,-77,-81,4
26,LR,0,350,8,-78.75,-78,-81,3
26,LR,0,350,5,-79.8,-77,-89,12
26,LR,0,350,5,-80.6,-77,-89,12
26,LR,0,350,3,-82.6666666666667,-77,-89,12
26,LR,0,350,7,-79.8571428571429,-76,-85,9
26,LR,0,350,8,-79.875,-78,-82,4
26,LR,1,350,10,-80,-77,-87,10
26,LR,1,350,9,-81.4444444444444,-77,-93,16
26,LR,0,350,6,-81,-78,-90,12
26,LR,0,350,4,-83.25,-80,-90,10
26,LR,1,350,10,-79.9,-75,-87,12
26,LR,0,350,2,-78.5,-78,-79,1
26,LR,0,350,1,-79,-79,-79,0
26,LR,1,350,9,-78.8888888888889,-77,-84,7
26,LR,0,350,6,-79,-77,-84,7
26,LR,0,350,3,-78,-76,-79,3
26,LR,0,350,7,-79.7142857142857,-78,-82,4
26,LR,0,350,3,-80.3333333333333,-79,-82,3
26,LR,0,350,1,-82,-82,-82,0
26,LR,1,350,9,-81.1111111111111,-77,-93,16
26,LR,0,350,8,-81.25,-77,-93,16
26,LR,0,350,7,-81.8571428571429,-77,-93,16
26,LR,0,350,4,-80.75,-77,-89,12
26,LR,1,350,9,-80.3333333333333,-75,-93,18
26,LR,0,350,3,-74.3333333333333,-74,-75,1
26,LR,0,350,6,-77.6666666666667,-75,-83,8
26,LR,0,350,6,-77.6666666666667,-76,-83,7
26,LR,0,350,8,-79.25,-76,-86,10
26,LR,0,350,3,-77.6666666666667,-77,-79,2
26,LR,0,350,4,-77.75,-77,-78,1
26,LR,0,350,1,-78,-78,-78,0
26,LR,1,350,10,-80.7,-75,-89,14
26,LR,0,350,8,-81.875,-76,-89,13
26,LR,1,350,10,-80.7,-75,-86,11
26,LR,0,350,1,-77,-77,-77,0
26,LR,0,350,1,-84,-84,-84,0
26,LR,0,350,6,-81.3333333333333,-75,-86,11
26,LR,0,350,3,-78,-74,-80,6
26,LR,0,350,1,-86,-86,-86,0
26,LR,0,350,5,-77,-74,-84,10
26,LR,0,350,2,-93,-90,-96,6
26,LR,0,350,1,-91,-91,-91,0
26,LR,0,350,8,-77,-73,-83,10
26,LR,0,350,2,-76.5,-76,-77,1
26,LR,0,350,8,-77.125,-73,-86,13
26,LR,1,350,9,-77,-73,-86,13
26,LR,0,350,7,-76.8571428571429,-73,-81,8
26,LR,0,350,1,-77,-77,-77,0
26,LR,0,350,1,-74,-74,-74,0
26,LR,1,350,10,-79,-73,-87,14
26,LR,0,350,5,-79.4,-74,-84,10
26,LR,0,350,8,-78.5,-73,-84,11
26,LR,0,350,8,-77.875,-73,-83,10
26,LR,0,350,1,-77,-77,-77,0
26,LR,0,350,4,-82.5,-73,-88,15
26,LR,0,350,1,-88,-88,-88,0
26,LR,0,350,4,-79.5,-72,-86,14
26,LR,0,350,5,-76.6,-73,-80,7
26,LR,0,350,7,-78.5714285714286,-73,-86,13
26,LR,0,350,2,-76.5,-76,-77,1
26,LR,0,350,4,-75.25,-74,-77,3
26,LR,0,350,8,-75.25,-73,-79,6
26,LR,0,350,4,-75.75,-73,-79,6
26,LR,1,350,9,-79,-73,-88,15
26,LR,0,350,5,-79.2,-75,-88,13
26,LR,0,350,6,-77.6666666666667,-74,-86,12
26,LR,0,350,3,-75.3333333333333,-74,-77,3
26,LR,0,350,2,-77,-77,-77,0
26,LR,0,350,4,-75.5,-74,-77,3
26,LR,0,350,3,-79,-77,-80,3
31,RL,0,400,8,-78.875,-76,-87,11
31,RL,0,400,7,-79,-76,-87,11
31,RL,0,400,1,-79,-79,-79,0
31,RL,0,400,4,-81.5,-78,-88,10
31,RL,0,400,5,-81.6,-78,-86,8
31,RL,0,400,7,-83.2857142857143,-78,-86,8
31,RL,0,400,1,-85,-85,-85,0
31,RL,0,400,2,-83.5,-83,-84,1
31,RL,0,400,8,-85.5,-81,-92,11
31,RL,1,400,9,-86.2222222222222,-84,-92,8
31,RL,0,400,4,-86,-85,-87,2
31,RL,1,400,10,-85.7,-82,-90,8
31,RL,1,400,10,-84.7,-82,-88,6
31,RL,0,400,1,-84,-84,-84,0
31,RL,0,400,1,-83,-83,-83,0
31,RL,0,400,8,-84.125,-82,-87,5
31,RL,0,400,4,-85.25,-83,-87,4
31,RL,1,400,10,-83,-80,-86,6
31,RL,0,400,3,-83,-80,-86,6
31,RL,1,400,10,-81.7,-79,-83,4
31,RL,0,400,1,-82,-82,-82,0
31,RL,0,400,2,-83,-81,-85,4
31,RL,0,400,2,-83.5,-83,-84,1
31,RL,0,400,6,-82.1666666666667,-79,-83,4
31,RL,0,400,6,-82.6666666666667,-81,-85,4
31,RL,0,400,5,-81.6,-80,-84,4
31,RL,0,400,5,-81.4,-80,-84,4
31,RL,0,400,3,-81.6666666666667,-80,-84,4
31,RL,0,400,3,-85,-83,-86,3
31,RL,0,400,3,-83.6666666666667,-83,-84,1
31,RL,0,400,7,-82.5714285714286,-79,-84,5
31,RL,0,400,4,-83.25,-81,-86,5
31,RL,0,400,5,-82.2,-81,-84,3
31,RL,0,400,8,-82.875,-81,-86,5
31,RL,0,400,3,-81.6666666666667,-81,-83,2
31,RL,0,400,7,-83.7142857142857,-81,-86,5
31,RL,0,400,5,-83.2,-81,-85,4
31,RL,1,400,10,-82,-78,-84,6
31,RL,0,400,4,-82.75,-82,-83,1
31,RL,0,400,6,-79.8333333333333,-78,-81,3
31,RL,0,400,5,-80.6,-78,-83,5
31,RL,0,400,2,-81,-80,-82,2
31,RL,0,400,4,-80,-79,-82,3
31,RL,0,400,5,-81.2,-79,-83,4
31,RL,0,400,4,-82,-81,-83,2
31,RL,0,400,4,-83,-80,-84,4
31,RL,0,400,7,-82.4285714285714,-81,-84,3
31,RL,0,400,5,-82.2,-81,-84,3
31,RL,0,400,8,-81.625,-81,-83,2
31,RL,1,400,9,-82.7777777777778,-81,-85,4
31,RL,0,400,2,-83,-82,-84,2
31,RL,0,400,4,-81.5,-81,-82,1
31,RL,0,400,8,-83.125,-82,-86,4
31,RL,0,400,4,-83.25,-82,-84,2
31,RL,0,400,2,-83.5,-82,-85,3
31,RL,0,400,4,-85,-82,-89,7
31,RL,0,400,3,-85.3333333333333,-84,-88,4
31,RL,1,400,10,-85.5,-83,-90,7
31,RL,0,400,8,-85.75,-83,-90,7
31,RL,0,400,3,-86.3333333333333,-85,-89,4
31,RL,0,400,1,-90,-90,-90,0
31,RL,0,400,2,-83.5,-83,-84,1
31,RL,0,400,7,-85.1428571428571,-83,-87,4
31,RL,1,400,10,-87.2,-85,-92,7
31,RL,0,400,8,-88.875,-85,-96,11
31,RL,0,400,7,-87.4285714285714,-86,-89,3
31,RL,0,400,6,-88.3333333333333,-86,-93,7
31,RL,0,400,1,-92,-92,-92,0
31,RL,0,400,4,-87.25,-85,-92,7
31,RL,0,400,4,-86.75,-85,-90,5
31,RL,0,400,4,-88.25,-85,-90,5
31,RL,0,400,7,-86.8571428571429,-85,-93,8
31,RL,0,400,7,-87.7142857142857,-86,-90,4
31,RL,0,400,5,-85.2,-84,-86,2
31,RL,0,400,5,-86,-84,-90,6
31,RL,1,400,10,-86.1,-85,-90,5
31,RL,0,400,8,-85.75,-84,-87,3
31,RL,0,400,4,-85,-84,-86,2
31,RL,0,400,4,-85.25,-84,-86,2
31,RL,1,400,9,-86,-84,-88,4
31,RL,0,400,4,-86.75,-85,-88,3
31,RL,0,400,5,-86.2,-85,-88,3
31,RL,0,400,5,-87.8,-86,-90,4
31,RL,0,400,2,-87.5,-86,-89,3
31,RL,0,400,2,-87.5,-86,-89,3
31,RL,0,400,5,-84.6,-83,-86,3
31,RL,0,400,5,-83,-81,-87,6
31,RL,0,400,7,-83.8571428571429,-81,-90,9
31,RL,0,400,6,-84.6666666666667,-81,-90,9
31,RL,1,400,9,-85.4444444444444,-81,-90,9
31,RL,0,400,4,-86.5,-84,-90,6
31,RL,0,400,6,-87.5,-85,-93,8
31,RL,0,400,5,-90.6,-85,-97,12
31,RL,0,400,8,-90.5,-84,-100,16
31,RL,0,400,3,-89,-84,-98,14
31,RL,0,400,6,-89.1666666666667,-84,-95,11
31,RL,0,400,4,-84.75,-81,-87,6
31,RL,0,400,1,-81,-81,-81,0
31,RL,0,400,4,-86,-81,-89,8
31,RL,0,400,6,-85.5,-81,-92,11
31,RL,0,400,1,-82,-82,-82,0
31,RL,0,400,2,-88,-87,-89,2
31,RL,0,400,3,-84,-82,-88,6
31,RL,0,400,8,-88.125,-82,-92,10
31,RL,1,400,10,-87,-81,-92,11
31,RL,0,400,1,-85,-85,-85,0
31,RL,0,400,3,-85.6666666666667,-81,-90,9
31,RL,0,400,6,-86.1666666666667,-80,-92,12
31,RL,0,400,7,-86.5714285714286,-84,-89,5
31,RL,0,400,2,-85,-84,-86,2
31,RL,0,400,5,-85.4,-84,-86,2
31,RL,0,400,7,-86.1428571428571,-85,-87,2
31,RL,0,400,8,-85.625,-84,-87,3
31,RL,0,400,7,-87,-84,-95,11
31,RL,0,400,2,-92.5,-87,-98,11
31,RL,1,400,10,-86.6,-84,-90,6
31,RL,0,400,2,-87.5,-86,-89,3
31,RL,0,400,5,-87,-86,-89,3
31,RL,1,400,10,-89.3,-82,-95,13
31,RL,0,400,5,-86.6,-82,-90,8
31,RL,0,400,4,-87.25,-83,-90,7
31,RL,0,400,2,-89.5,-89,-90,1
31,RL,0,400,2,-83.5,-82,-85,3
31,RL,0,400,5,-82.2,-81,-84,3
31,RL,0,400,3,-87,-84,-90,6
31,RL,0,400,2,-85,-84,-86,2
31,RL,0,400,8,-81.75,-80,-84,4
31,RL,0,400,1,-83,-83,-83,0
31,RL,0,400,8,-81,-80,-83,3
31,RL,0,400,7,-81.2857142857143,-80,-84,4
31,RL,0,400,8,-82.375,-80,-84,4
31,RL,0,400,1,-83,-83,-83,0
31,RL,0,400,8,-82.625,-80,-87,7
31,RL,0,400,2,-83,-80,-86,6
31,RL,0,400,6,-82,-79,-85,6
31,RL,0,400,5,-83,-80,-85,5
31,RL,0,400,2,-87,-87,-87,0
31,RL,0,400,5,-88,-86,-91,5
31,RL,0,400,6,-91,-87,-94,7
31,RL,1,400,9,-88.8888888888889,-84,-94,10
31,RL,0,400,3,-90.3333333333333,-90,-91,1
31,RL,0,400,1,-90,-90,-90,0
31,RL,0,400,3,-81.3333333333333,-80,-82,2
31,RL,1,400,10,-85.4,-82,-89,7
31,RL,0,400,2,-86,-85,-87,2
31,RL,0,400,8,-84.375,-82,-89,7
31,RL,0,400,7,-85.2857142857143,-81,-92,11
31,RL,0,400,5,-83.8,-81,-88,7
31,RL,1,400,10,-83.3,-77,-88,11
31,RL,0,400,2,-85.5,-84,-87,3
31,RL,0,400,6,-79.8333333333333,-76,-85,9
31,RL,0,400,4,-78.75,-76,-84,8
31,RL,0,400,2,-83.5,-80,-87,7
31,RL,0,400,4,-81.5,-80,-86,6
31,RL,0,400,2,-83,-80,-86,6
31,RL,0,400,3,-76.3333333333333,-75,-77,2
31,RL,0,400,8,-79,-77,-82,5
31,RL,0,400,5,-82.8,-78,-92,14
31,RL,0,400,7,-83.5714285714286,-81,-92,11
31,RL,0,400,1,-92,-92,-92,0
31,RL,0,400,6,-81.6666666666667,-78,-84,6
31,RL,0,400,4,-80.5,-78,-82,4
31,RL,0,400,8,-82.5,-78,-86,8
31,RL,0,400,4,-79.25,-76,-86,10
31,RL,0,400,6,-80.1666666666667,-76,-86,10
31,RL,0,400,4,-76,-73,-78,5
31,RL,0,400,2,-83,-82,-84,2
31,RL,0,400,3,-83.6666666666667,-82,-85,3
31,LR,0,400,4,-92,-88,-95,7
31,LR,0,400,1,-89,-89,-89,0
31,LR,1,400,9,-75.6666666666667,-72,-89,17
31,LR,0,400,4,-74.5,-72,-81,9
31,LR,0,400,6,-75.1666666666667,-72,-80,8
31,LR,1,400,9,-76.3333333333333,-72,-80,8
31,LR,1,400,10,-75.9,-72,-80,8
31,LR,0,400,6,-74.6666666666667,-72,-78,6
31,LR,0,400,1,-74,-74,-74,0
31,LR,0,400,5,-77,-74,-79,5
31,LR,1,400,9,-76.5555555555556,-73,-79,6
31,LR,0,400,5,-78.4,-77,-79,2
31,LR,0,400,5,-77,-72,-79,7
31,LR,0,400,7,-77.5714285714286,-74,-79,5
31,LR,0,400,8,-78,-74,-81,7
31,LR,1,400,10,-77.2,-73,-81,8
31,LR,0,400,4,-78,-75,-81,6
31,LR,0,400,5,-76.2,-73,-81,8
31,LR,0,400,2,-77.5,-77,-78,1
31,LR,0,400,7,-78.5714285714286,-73,-86,13
31,LR,0,400,7,-78.2857142857143,-73,-86,13
31,LR,1,400,10,-77.6,-73,-86,13
31,LR,0,400,6,-77,-73,-85,12
31,LR,1,400,10,-77.7,-73,-85,12
31,LR,0,400,2,-78,-77,-79,2
31,LR,0,400,1,-86,-86,-86,0
31,LR,0,400,5,-78.8,-73,-88,15
31,LR,0,400,6,-79.6666666666667,-75,-84,9
31,LR,0,400,3,-77.3333333333333,-75,-79,4
31,LR,0,400,6,-74.8333333333333,-73,-82,9
31,LR,1,400,10,-75,-71,-82,11
31,LR,1,400,9,-77.5555555555556,-72,-84,12
31,LR,1,400,10,-75.9,-73,-84,11
31,LR,1,400,9,-75.5555555555556,-73,-86,13
31,LR,0,400,8,-76.5,-73,-86,13
31,LR,0,400,5,-76.8,-73,-86,13
31,LR,0,400,2,-75,-75,-75,0
31,LR,0,400,5,-75.8,-73,-78,5
31,LR,0,400,8,-75,-73,-78,5
31,LR,0,400,4,-74,-73,-76,3
31,LR,0,400,5,-72.6,-72,-74,2
31,LR,0,400,4,-75.5,-75,-76,1
31,LR,0,400,2,-74.5,-73,-76,3
31,LR,0,400,1,-78,-78,-78,0
31,LR,0,400,8,-75.625,-73,-80,7
31,LR,0,400,2,-77.5,-77,-78,1
31,LR,1,400,10,-76.1,-71,-84,13
31,LR,0,400,4,-74.25,-71,-78,7
31,LR,0,400,2,-73.5,-73,-74,1
31,LR,0,400,2,-74.5,-74,-75,1
31,LR,0,400,7,-76,-72,-86,14
31,LR,0,400,8,-75.5,-72,-80,8
31,LR,0,400,8,-75.75,-72,-80,8
31,LR,0,400,1,-77,-77,-77,0
31,LR,0,400,4,-76.5,-73,-83,10
31,LR,0,400,3,-77,-73,-83,10
31,LR,0,400,7,-76.8571428571429,-73,-84,11
31,LR,0,400,4,-83.25,-74,-88,14
31,LR,0,400,2,-87.5,-87,-88,1
31,LR,0,400,8,-76.75,-72,-85,13
31,LR,1,400,9,-78.8888888888889,-72,-87,15
31,LR,0,400,5,-79.8,-72,-87,15
31,LR,0,400,2,-77,-72,-82,10
31,LR,0,400,2,-79.5,-72,-87,15
31,LR,0,400,7,-78.1428571428571,-73,-84,11
31,LR,0,400,2,-77,-73,-81,8
31,LR,0,400,3,-82,-74,-92,18
31,LR,0,400,5,-79.8,-75,-86,11
31,LR,0,400,8,-80.75,-75,-92,17
31,LR,1,400,9,-81.7777777777778,-74,-96,22
31,LR,0,400,7,-81.8571428571429,-74,-96,22
31,LR,0,400,2,-74.5,-74,-75,1
31,LR,0,400,7,-82,-73,-96,23
31,LR,1,400,9,-78.4444444444444,-73,-90,17
31,LR,0,400,1,-73,-73,-73,0
31,LR,0,400,5,-82.2,-74,-95,21
31,LR,0,400,2,-74,-74,-74,0
31,LR,0,400,8,-82.125,-74,-95,21
31,LR,0,400,2,-79.5,-75,-84,9
31,LR,0,400,3,-77.3333333333333,-73,-85,12
31,LR,0,400,7,-79.2857142857143,-74,-94,20
31,LR,0,400,5,-80,-74,-94,20
31,LR,0,400,6,-78.6666666666667,-74,-94,20
31,LR,0,400,2,-84,-74,-94,20
31,LR,1,400,9,-77,-74,-82,8
31,LR,0,400,8,-77.375,-74,-81,7
31,LR,1,400,10,-77.6,-74,-81,7
31,LR,0,400,3,-78.3333333333333,-74,-81,7
31,LR,0,400,5,-77.2,-74,-81,7
31,LR,0,400,5,-77.2,-74,-81,7
31,LR,0,400,1,-76,-76,-76,0
31,LR,0,400,3,-91,-82,-98,16
31,LR,0,400,6,-89,-79,-98,19
26,RL,1,400,10,-83.5,-81,-91,10
26,RL,0,400,5,-84.8,-82,-91,9
26,RL,0,400,6,-84.8333333333333,-82,-91,9
26,RL,0,400,1,-86,-86,-86,0
26,RL,0,400,7,-84.4285714285714,-80,-86,6
26,RL,0,400,8,-83.125,-81,-86,5
26,RL,0,400,5,-83,-82,-85,3
26,RL,0,400,3,-83.3333333333333,-81,-86,5
26,RL,0,400,7,-84.2857142857143,-81,-89,8
26,RL,0,400,8,-83.125,-80,-89,9
26,RL,0,400,3,-83,-82,-84,2
26,RL,0,400,7,-82,-79,-85,6
26,RL,1,400,10,-82.9,-79,-86,7
26,RL,0,400,8,-83,-79,-86,7
26,RL,0,400,8,-82.5,-80,-85,5
26,RL,1,400,9,-81,-78,-84,6
26,RL,0,400,5,-81.8,-81,-84,3
26,RL,0,400,5,-81,-80,-83,3
26,RL,0,400,2,-81.5,-80,-83,3
26,RL,1,400,10,-82,-80,-84,4
26,RL,0,400,4,-82,-80,-84,4
26,RL,0,400,1,-84,-84,-84,0
26,RL,0,400,7,-81.5714285714286,-80,-83,3
26,RL,0,400,8,-84.75,-80,-88,8
26,RL,0,400,3,-87.3333333333333,-86,-88,2
26,RL,0,400,7,-86.1428571428571,-84,-89,5
26,RL,0,400,5,-85.8,-84,-89,5
26,RL,0,400,5,-83.2,-82,-85,3
26,RL,0,400,8,-85.625,-84,-88,4
26,RL,0,400,4,-87.25,-84,-92,8
26,RL,1,400,10,-87.5,-84,-92,8
26,RL,0,400,6,-88.5,-84,-92,8
26,RL,1,400,10,-86.8,-84,-92,8
26,RL,1,400,10,-86.8,-84,-92,8
26,RL,0,400,2,-87,-84,-90,6
26,RL,0,400,3,-84.6666666666667,-84,-86,2
26,RL,0,400,3,-84.6666666666667,-84,-86,2
26,RL,0,400,7,-84.4285714285714,-81,-87,6
26,RL,0,400,6,-83.8333333333333,-81,-87,6
26,RL,1,400,9,-82.8888888888889,-79,-92,13
26,RL,0,400,6,-86.6666666666667,-84,-89,5
26,RL,0,400,3,-86.3333333333333,-84,-88,4
26,RL,0,400,8,-89.75,-86,-98,12
26,RL,0,400,7,-90.4285714285714,-83,-98,15
26,RL,1,400,10,-86.7,-80,-92,12
26,RL,0,400,6,-84.5,-80,-91,11
26,RL,0,400,7,-85.4285714285714,-81,-91,10
26,RL,0,400,5,-86.2,-81,-89,8
26,RL,0,400,6,-85.1666666666667,-82,-91,9
26,RL,0,400,1,-84,-84,-84,0
26,RL,0,400,3,-86.6666666666667,-84,-90,6
26,RL,0,400,4,-85.25,-81,-87,6
26,RL,0,400,5,-85.8,-84,-90,6
26,RL,0,400,6,-86.8333333333333,-84,-90,6
26,RL,0,400,3,-80.6666666666667,-80,-82,2
26,RL,0,400,6,-80.1666666666667,-79,-82,3
26,RL,0,400,1,-80,-80,-80,0
26,RL,0,400,5,-80.2,-78,-82,4
26,RL,0,400,3,-80.6666666666667,-78,-82,4
26,RL,0,400,2,-82,-82,-82,0
26,RL,1,400,9,-84.6666666666667,-80,-90,10
26,RL,1,400,9,-85.1111111111111,-79,-91,12
26,RL,1,400,9,-83.4444444444444,-79,-86,7
26,RL,1,400,10,-85.4,-78,-93,15
26,RL,0,400,2,-87.5,-86,-89,3
26,RL,0,400,2,-85,-84,-86,2
26,RL,0,400,1,-84,-84,-84,0
26,RL,1,400,9,-82.1111111111111,-75,-93,18
26,RL,0,400,7,-81.5714285714286,-78,-88,10
26,RL,1,400,9,-80.2222222222222,-75,-91,16
26,RL,0,400,4,-78.25,-75,-85,10
26,LR,0,400,5,-84,-80,-94,14
26,LR,0,400,5,-89.2,-82,-94,12
26,LR,0,400,7,-89,-79,-98,19
26,LR,0,400,1,-88,-88,-88,0
26,LR,0,400,6,-86.1666666666667,-74,-98,24
26,LR,0,400,8,-80.625,-72,-98,26
26,LR,0,400,2,-79,-73,-85,12
26,LR,0,400,5,-74.2,-72,-77,5
26,LR,0,400,8,-76,-73,-80,7
26,LR,0,400,2,-75,-73,-77,4
26,LR,1,400,9,-75.3333333333333,-72,-80,8
26,LR,0,400,6,-75.3333333333333,-73,-78,5
26,LR,0,400,3,-76.3333333333333,-75,-78,3
26,LR,1,400,10,-74.9,-72,-78,6
26,LR,0,400,6,-74.1666666666667,-72,-77,5
26,LR,0,400,6,-74.6666666666667,-72,-77,5
26,LR,0,400,7,-74.8571428571429,-72,-77,5
26,LR,1,400,9,-75.8888888888889,-72,-79,7
26,LR,0,400,5,-76.6,-73,-79,6
26,LR,0,400,7,-74.8571428571429,-72,-83,11
26,LR,0,400,1,-72,-72,-72,0
26,LR,1,400,9,-74.6666666666667,-72,-81,9
26,LR,0,400,3,-74.6666666666667,-73,-78,5
26,LR,0,400,1,-78,-78,-78,0
26,LR,0,400,2,-78,-74,-82,8
26,LR,0,400,5,-76,-72,-82,10
26,LR,0,400,8,-76.75,-72,-86,14
26,LR,0,400,8,-76.5,-72,-82,10
26,LR,1,400,9,-76.2222222222222,-72,-82,10
26,LR,1,400,10,-77.5,-72,-84,12
26,LR,0,400,3,-76,-72,-79,7
26,LR,1,400,10,-76.6,-72,-82,10
26,LR,0,400,2,-80,-78,-82,4
26,LR,0,400,8,-75.75,-72,-79,7
26,LR,0,400,1,-80,-80,-80,0
26,LR,0,400,1,-79,-79,-79,0
26,LR,0,400,5,-77.2,-72,-82,10
26,LR,0,400,1,-72,-72,-72,0
26,LR,1,400,9,-74.1111111111111,-72,-77,5
26,LR,1,400,10,-73,-72,-76,4
26,LR,0,400,3,-74,-72,-75,3
26,LR,0,400,2,-73.5,-72,-75,3
26,LR,0,400,2,-72,-72,-72,0
26,LR,0,400,7,-73.2857142857143,-72,-75,3
26,LR,0,400,8,-73.125,-72,-75,3
26,LR,1,400,9,-75,-72,-84,12
26,LR,0,400,2,-73,-72,-74,2
26,LR,0,400,8,-75,-72,-80,8
26,LR,0,400,8,-74.75,-72,-80,8
26,LR,0,400,7,-75,-72,-82,10
26,LR,0,400,6,-80.6666666666667,-72,-94,22
26,LR,0,400,2,-88,-82,-94,12
26,LR,0,400,3,-76.3333333333333,-74,-78,4
26,LR,0,400,1,-81,-81,-81,0
26,LR,1,400,9,-75.2222222222222,-72,-80,8
26,LR,0,400,4,-76.5,-74,-80,6
26,LR,0,400,8,-75.875,-72,-86,14
26,LR,0,400,6,-74.8333333333333,-73,-79,6
26,LR,1,400,9,-76.5555555555556,-71,-84,13
26,LR,0,400,4,-74.75,-72,-79,7
26,LR,0,400,3,-75.3333333333333,-72,-82,10
26,LR,0,400,2,-77,-72,-82,10
26,LR,0,400,1,-82,-82,-82,0
26,LR,0,400,5,-79.4,-73,-84,11
26,LR,0,400,4,-77.75,-73,-80,7
26,LR,0,400,8,-76,-74,-79,5
26,LR,0,400,1,-76,-76,-76,0
26,LR,0,400,3,-77.3333333333333,-77,-78,1
26,LR,0,400,3,-77.3333333333333,-73,-86,13
26,LR,0,400,3,-75.6666666666667,-73,-80,7
26,LR,0,400,4,-73.25,-73,-74,1
26,LR,0,400,7,-76.2857142857143,-72,-86,14
26,LR,0,400,4,-78.5,-73,-86,13
26,LR,0,400,1,-74,-74,-74,0
26,LR,0,400,3,-82.6666666666667,-76,-89,13
26,LR,0,400,7,-78.7142857142857,-73,-94,21
26,LR,0,400,1,-80,-80,-80,0
26,LR,1,400,10,-76.6,-74,-81,7
26,LR,1,400,9,-76.5555555555556,-74,-81,7
26,LR,1,400,9,-75.1111111111111,-73,-80,7
26,LR,1,400,9,-75.1111111111111,-73,-80,7
26,LR,0,400,5,-74.8,-73,-80,7
26,LR,0,400,7,-76.4285714285714,-73,-80,7
26,LR,0,400,3,-78,-74,-80,6
26,LR,0,400,5,-76.4,-74,-80,6
26,LR,1,400,10,-76.9,-73,-80,7
31,RL,0,450,4,-73.75,-71,-78,7
31,RL,0,450,3,-75.6666666666667,-74,-78,4
31,RL,0,450,1,-75,-75,-75,0
31,RL,0,450,8,-77.25,-72,-88,16
31,RL,1,450,9,-78.6666666666667,-72,-88,16
31,RL,0,450,7,-80,-73,-85,12
31,RL,0,450,8,-79.125,-77,-85,8
31,RL,0,450,6,-79,-77,-85,8
31,RL,0,450,2,-82,-79,-85,6
31,RL,0,450,3,-77.6666666666667,-77,-79,2
31,RL,0,450,5,-78.4,-77,-81,4
31,RL,0,450,5,-79.2,-77,-84,7
31,RL,0,450,8,-79.875,-77,-84,7
31,RL,0,450,1,-80,-80,-80,0
31,RL,0,450,8,-79.875,-79,-82,3
31,RL,0,450,5,-80.4,-80,-82,2
31,RL,0,450,2,-79,-78,-80,2
31,RL,0,450,4,-80.25,-77,-82,5
31,RL,0,450,3,-79,-77,-80,3
31,RL,0,450,7,-80,-77,-84,7
31,RL,0,450,7,-80.8571428571429,-78,-84,6
31,RL,0,450,5,-78.8,-77,-84,7
31,RL,0,450,6,-80,-78,-85,7
31,RL,0,450,4,-78.75,-78,-80,2
31,RL,0,450,4,-79,-78,-80,2
31,RL,0,450,3,-81.3333333333333,-78,-86,8
31,RL,1,450,9,-81.4444444444444,-78,-88,10
31,RL,0,450,8,-81.625,-78,-88,10
31,RL,0,450,3,-79.3333333333333,-78,-80,2
31,RL,1,450,9,-81.6666666666667,-78,-88,10
31,RL,1,450,9,-81.4444444444444,-78,-88,10
31,RL,0,450,2,-83,-80,-86,6
31,RL,1,450,10,-78.5,-74,-82,8
31,RL,0,450,2,-78.5,-76,-81,5
31,RL,0,450,4,-75,-73,-77,4
31,RL,0,450,6,-77.6666666666667,-74,-79,5
31,RL,0,450,7,-77.8571428571429,-74,-81,7
31,RL,0,450,4,-76.5,-74,-78,4
31,RL,1,450,9,-78.2222222222222,-75,-81,6
31,RL,0,450,1,-81,-81,-81,0
31,RL,0,450,4,-76.25,-75,-80,5
31,RL,0,450,1,-80,-80,-80,0
31,RL,0,450,1,-79,-79,-79,0
31,RL,1,450,10,-78.2,-74,-81,7
31,RL,0,450,4,-78.5,-74,-81,7
31,RL,0,450,3,-78.6666666666667,-75,-81,6
31,RL,0,450,1,-82,-82,-82,0
31,RL,0,450,6,-78.6666666666667,-76,-84,8
31,RL,0,450,1,-76,-76,-76,0
31,RL,0,450,2,-81,-78,-84,6
31,RL,0,450,2,-79.5,-79,-80,1
31,RL,0,450,1,-78,-78,-78,0
31,RL,0,450,8,-77.125,-74,-80,6
31,RL,1,450,9,-77.7777777777778,-74,-81,7
31,RL,0,450,2,-74,-74,-74,0
31,RL,0,450,4,-78,-74,-81,7
31,RL,0,450,8,-79,-78,-80,2
31,RL,0,450,6,-77.3333333333333,-76,-78,2
31,RL,0,450,6,-78,-76,-79,3
31,RL,0,450,1,-78,-78,-78,0
31,RL,0,450,3,-75,-74,-77,3
31,RL,1,450,10,-78.2,-76,-80,4
31,RL,0,450,7,-78,-77,-80,3
31,RL,0,450,4,-78.25,-77,-80,3
31,RL,0,450,1,-80,-80,-80,0
31,RL,0,450,6,-78.1666666666667,-76,-80,4
31,RL,0,450,2,-78.5,-78,-79,1
31,RL,0,450,8,-77.25,-75,-81,6
31,RL,0,450,3,-77,-75,-78,3
31,RL,0,450,7,-78.7142857142857,-76,-84,8
31,RL,0,450,6,-77.8333333333333,-76,-80,4
31,RL,0,450,5,-78.8,-77,-81,4
31,RL,0,450,2,-79,-77,-81,4
31,RL,1,450,9,-78.6666666666667,-74,-83,9
31,RL,0,450,3,-78.6666666666667,-77,-81,4
31,RL,0,450,1,-74,-74,-74,0
31,RL,0,450,6,-78.8333333333333,-74,-88,14
31,RL,0,450,8,-81.125,-75,-88,13
31,RL,1,450,10,-79.3,-75,-88,13
31,RL,0,450,2,-75,-75,-75,0
31,RL,0,450,1,-75,-75,-75,0
31,RL,1,450,10,-82.4,-76,-85,9
31,RL,0,450,7,-80.7142857142857,-77,-85,8
31,RL,0,450,1,-77,-77,-77,0
31,RL,0,450,1,-83,-83,-83,0
31,RL,1,450,9,-81.2222222222222,-77,-84,7
31,RL,0,450,5,-81.2,-79,-84,5
31,RL,1,450,10,-81.7,-77,-84,7
31,RL,0,450,5,-81.4,-79,-83,4
31,RL,0,450,6,-81.8333333333333,-79,-88,9
31,RL,0,450,7,-82.5714285714286,-78,-86,8
31,RL,0,450,6,-80.5,-78,-83,5
31,RL,0,450,3,-80.6666666666667,-78,-83,5
31,RL,1,450,10,-78.3,-76,-83,7
31,RL,0,450,2,-76.5,-76,-77,1
31,RL,0,450,4,-80.5,-76,-83,7
31,RL,0,450,4,-77,-76,-78,2
31,RL,0,450,6,-78.3333333333333,-76,-80,4
31,RL,0,450,8,-79,-78,-80,2
31,RL,1,450,9,-79,-78,-80,2
31,RL,0,450,7,-78.7142857142857,-78,-80,2
31,RL,0,450,2,-79,-78,-80,2
31,RL,1,450,9,-77.8888888888889,-74,-81,7
31,RL,0,450,2,-80.5,-80,-81,1
31,RL,0,450,5,-78,-75,-80,5
31,RL,0,450,5,-76.8,-75,-80,5
31,RL,1,450,10,-77.9,-74,-82,8
31,RL,0,450,5,-77.8,-73,-80,7
31,RL,0,450,3,-77.3333333333333,-73,-80,7
31,RL,0,450,6,-79,-78,-80,2
31,RL,0,450,5,-74.8,-73,-79,6
31,RL,0,450,4,-76.75,-74,-80,6
31,RL,0,450,8,-76.375,-74,-81,7
31,RL,0,450,6,-80,-79,-81,2
31,RL,0,450,7,-79,-75,-81,6
31,RL,1,450,9,-78.5555555555556,-75,-83,8
31,RL,0,450,3,-79.3333333333333,-75,-83,8
31,RL,1,450,10,-79,-75,-83,8
31,RL,1,450,10,-77.4,-75,-83,8
31,RL,0,450,3,-79,-75,-83,8
31,RL,1,450,9,-79.2222222222222,-75,-84,9
31,RL,0,450,2,-77,-75,-79,4
31,RL,1,450,9,-78.8888888888889,-74,-86,12
31,RL,0,450,4,-76.75,-74,-79,5
31,RL,1,450,9,-79,-74,-86,12
31,RL,1,450,9,-80,-75,-86,11
31,RL,0,450,3,-83.3333333333333,-80,-86,6
31,RL,1,450,10,-80.6,-79,-83,4
31,RL,0,450,2,-81,-80,-82,2
31,RL,0,450,2,-82.5,-82,-83,1
31,RL,1,450,9,-77.1111111111111,-75,-80,5
31,RL,0,450,1,-75,-75,-75,0
31,RL,0,450,3,-77,-75,-80,5
31,RL,0,450,5,-77.4,-75,-79,4
31,RL,1,450,9,-78.3333333333333,-75,-84,9
31,RL,0,450,1,-80,-80,-80,0
31,RL,0,450,1,-75,-75,-75,0
31,RL,1,450,10,-79.4,-76,-84,8
31,RL,1,450,10,-78.9,-76,-83,7
31,RL,1,450,9,-79.1111111111111,-76,-83,7
31,RL,0,450,5,-80.8,-75,-86,11
31,RL,0,450,7,-78.8571428571429,-75,-86,11
31,RL,1,450,9,-78.5555555555556,-75,-86,11
31,RL,1,450,9,-79.6666666666667,-76,-89,13
31,RL,0,450,3,-85,-81,-87,6
31,RL,0,450,5,-81.6,-76,-87,11
31,RL,0,450,4,-82.75,-80,-87,7
31,RL,0,450,1,-76,-76,-76,0
31,RL,0,450,3,-81.6666666666667,-76,-85,9
31,RL,0,450,3,-83.3333333333333,-81,-85,4
31,RL,0,450,5,-82.8,-80,-85,5
31,RL,0,450,6,-79.1666666666667,-76,-87,11
31,RL,0,450,7,-77.7142857142857,-76,-87,11
31,RL,0,450,3,-79.6666666666667,-76,-87,11
31,RL,1,450,9,-78.5555555555556,-76,-86,10
31,RL,0,450,2,-78.5,-76,-81,5
31,RL,0,450,4,-80.25,-76,-82,6
31,RL,0,450,6,-78,-75,-85,10
31,RL,0,450,7,-81.1428571428571,-75,-85,10
31,RL,0,450,8,-82.625,-76,-86,10
31,RL,0,450,8,-83.875,-77,-86,9
31,RL,0,450,6,-83.3333333333333,-77,-86,9
31,RL,0,450,8,-79.25,-75,-85,10
31,RL,1,450,10,-79.7,-75,-85,10
31,RL,0,450,8,-80.125,-75,-85,10
31,RL,0,450,8,-82.5,-77,-91,14
31,RL,1,450,9,-81,-76,-92,16
31,RL,0,450,1,-76,-76,-76,0
31,RL,0,450,4,-84.5,-77,-90,13
31,RL,0,450,7,-80.7142857142857,-76,-88,12
31,RL,1,450,9,-77.1111111111111,-70,-81,11
31,RL,0,450,7,-77,-70,-81,11
31,RL,0,450,7,-76.7142857142857,-70,-81,11
31,RL,0,450,1,-76,-76,-76,0
31,RL,0,450,5,-87.6,-85,-92,7
31,LR,0,450,5,-89,-82,-94,12
31,LR,0,450,1,-98,-98,-98,0
31,LR,0,450,8,-83.5,-77,-92,15
31,LR,0,450,4,-84,-78,-92,14
31,LR,0,450,3,-81.3333333333333,-78,-83,5
31,LR,1,450,10,-82.5,-77,-88,11
31,LR,0,450,8,-81.75,-77,-87,10
31,LR,1,450,10,-86.1,-80,-93,13
31,LR,1,450,10,-85.3,-80,-91,11
31,LR,0,450,2,-84.5,-81,-88,7
31,LR,0,450,2,-89.5,-89,-90,1
31,LR,0,450,2,-84,-83,-85,2
31,LR,0,450,1,-86,-86,-86,0
31,LR,0,450,5,-86.2,-79,-90,11
31,LR,0,450,6,-85.3333333333333,-81,-90,9
31,LR,0,450,5,-86.4,-86,-87,1
31,LR,0,450,5,-88.4,-86,-97,11
31,LR,0,450,8,-86.875,-81,-97,16
31,LR,0,450,1,-81,-81,-81,0
31,LR,0,450,2,-88.5,-83,-94,11
31,LR,0,450,5,-90.2,-87,-96,9
31,LR,0,450,6,-89.5,-84,-96,12
31,LR,0,450,7,-90.7142857142857,-83,-96,13
31,LR,1,450,10,-88.8,-83,-96,13
31,LR,0,450,8,-89.875,-85,-96,11
31,LR,0,450,4,-90.75,-86,-96,10
31,LR,0,450,1,-96,-96,-96,0
31,LR,0,450,8,-89.625,-85,-95,10
31,LR,1,450,10,-91.2,-85,-95,10
31,LR,0,450,1,-85,-85,-85,0
31,LR,1,450,9,-91.1111111111111,-86,-100,14
31,LR,1,450,9,-90.2222222222222,-86,-100,14
31,LR,1,450,9,-90.2222222222222,-87,-99,12
31,LR,0,450,4,-87,-86,-88,2
31,LR,0,450,4,-85.75,-84,-88,4
31,LR,0,450,1,-87,-87,-87,0
31,LR,0,450,2,-81,-80,-82,2
31,LR,0,450,2,-82.5,-78,-87,9
31,LR,0,450,2,-90.5,-88,-93,5
31,LR,1,450,9,-79.6666666666667,-76,-83,7
31,LR,0,450,6,-80.5,-77,-83,6
31,LR,0,450,2,-80,-77,-83,6
31,LR,0,450,6,-81.3333333333333,-77,-83,6
31,LR,0,450,7,-83.4285714285714,-80,-86,6
31,LR,0,450,2,-83,-80,-86,6
31,LR,0,450,7,-84.4285714285714,-81,-88,7
31,LR,0,450,5,-83.8,-81,-88,7
31,LR,0,450,7,-86,-81,-90,9
31,LR,0,450,3,-87.3333333333333,-84,-89,5
31,LR,1,450,9,-83,-80,-88,8
31,LR,0,450,3,-80.6666666666667,-80,-82,2
31,LR,1,450,10,-81.5,-77,-89,12
31,LR,0,450,5,-82.6,-79,-89,10
31,LR,0,450,2,-83,-80,-86,6
31,LR,0,450,3,-80,-77,-85,8
31,LR,0,450,1,-76,-76,-76,0
31,LR,1,450,10,-84,-79,-91,12
31,LR,1,450,10,-84.1,-79,-91,12
31,LR,0,450,3,-85.3333333333333,-82,-90,8
31,LR,0,450,3,-83.3333333333333,-82,-84,2
31,LR,0,450,5,-84.8,-80,-91,11
31,LR,0,450,5,-82.2,-78,-85,7
31,LR,0,450,6,-83.1666666666667,-78,-88,10
31,LR,0,450,4,-83,-79,-88,9
31,LR,1,450,9,-82.7777777777778,-77,-94,17
31,LR,0,450,8,-86.125,-78,-93,15
31,LR,0,450,3,-82,-79,-87,8
31,LR,1,450,9,-86.5555555555556,-79,-95,16
31,LR,0,450,4,-88.25,-82,-95,13
31,LR,1,450,10,-83.5,-79,-90,11
31,LR,1,450,10,-83.9,-79,-90,11
31,LR,0,450,8,-84.75,-80,-90,10
31,LR,0,450,1,-80,-80,-80,0
31,LR,0,450,7,-83.1428571428571,-79,-90,11
31,LR,0,450,5,-80.2,-79,-82,3
31,LR,0,450,7,-85.4285714285714,-82,-88,6
31,LR,0,450,2,-87.5,-87,-88,1
31,LR,0,450,1,-80,-80,-80,0
31,LR,0,450,2,-89.5,-88,-91,3
31,LR,1,450,10,-87.7,-84,-90,6
31,LR,1,450,9,-88.2222222222222,-84,-92,8
31,LR,0,450,6,-88.1666666666667,-84,-92,8
31,LR,1,450,10,-87.2,-84,-92,8
31,LR,1,450,10,-87.2,-84,-92,8
31,LR,0,450,2,-87.5,-87,-88,1
31,LR,1,450,10,-87.2,-84,-92,8
26,RL,0,450,6,-79.8333333333333,-73,-85,12
26,RL,0,450,4,-77,-72,-84,12
26,RL,0,450,5,-75.6,-73,-79,6
26,RL,0,450,3,-76.6666666666667,-73,-79,6
26,RL,0,450,5,-78,-73,-83,10
26,RL,1,450,9,-78.8888888888889,-73,-84,11
26,RL,0,450,2,-78.5,-76,-81,5
26,RL,1,450,9,-77.8888888888889,-76,-84,8
26,RL,0,450,4,-79.25,-76,-84,8
26,RL,0,450,3,-81.3333333333333,-80,-82,2
26,RL,0,450,7,-80.7142857142857,-76,-84,8
26,RL,1,450,9,-80.6666666666667,-76,-84,8
26,RL,0,450,8,-80.25,-76,-84,8
26,RL,0,450,7,-78.8571428571429,-77,-84,7
26,RL,1,450,10,-76.5,-72,-85,13
26,RL,0,450,3,-76.3333333333333,-73,-78,5
26,RL,1,450,9,-77.1111111111111,-74,-79,5
26,RL,0,450,3,-75.6666666666667,-74,-78,4
26,RL,0,450,7,-75.5714285714286,-73,-78,5
26,RL,0,450,8,-76,-73,-79,6
26,RL,0,450,4,-76,-73,-78,5
26,RL,1,450,9,-76.5555555555556,-73,-79,6
26,RL,0,450,3,-77.3333333333333,-75,-79,4
26,RL,0,450,4,-78.75,-74,-83,9
26,RL,0,450,8,-76,-73,-79,6
26,RL,0,450,5,-75.4,-73,-78,5
26,RL,1,450,10,-76.7,-73,-79,6
26,RL,0,450,2,-76.5,-76,-77,1
26,RL,1,450,10,-77.7,-74,-80,6
26,RL,0,450,6,-77.6666666666667,-74,-80,6
26,RL,0,450,6,-77.3333333333333,-74,-80,6
26,RL,0,450,8,-77.625,-74,-80,6
26,RL,1,450,10,-78.3,-76,-80,4
26,RL,0,450,4,-78,-77,-79,2
26,RL,0,450,8,-78,-75,-80,5
26,RL,0,450,4,-79.5,-77,-83,6
26,RL,0,450,1,-77,-77,-77,0
26,RL,0,450,2,-79,-78,-80,2
26,RL,1,450,9,-79.4444444444444,-73,-86,13
26,RL,1,450,10,-79.9,-73,-88,15
26,RL,0,450,7,-80.7142857142857,-74,-88,14
26,RL,0,450,1,-82,-82,-82,0
26,RL,0,450,3,-80.6666666666667,-75,-84,9
26,RL,0,450,8,-76.75,-74,-83,9
26,RL,0,450,2,-77,-74,-80,6
26,RL,0,450,4,-75.5,-74,-79,5
26,RL,0,450,6,-78.5,-76,-80,4
26,RL,0,450,1,-77,-77,-77,0
26,RL,0,450,6,-77.1666666666667,-76,-78,2
26,RL,0,450,8,-77.125,-73,-79,6
26,RL,0,450,4,-77.25,-73,-79,6
26,RL,0,450,5,-75.2,-73,-79,6
26,RL,1,450,9,-77,-73,-80,7
26,RL,0,450,6,-77.5,-74,-81,7
26,RL,0,450,4,-78.5,-75,-81,6
26,RL,1,450,9,-77.7777777777778,-73,-81,8
26,RL,0,450,7,-75.7142857142857,-73,-79,6
26,RL,1,450,9,-78.2222222222222,-74,-82,8
26,RL,0,450,1,-75,-75,-75,0
26,RL,0,450,6,-78.8333333333333,-74,-82,8
26,RL,0,450,3,-79.3333333333333,-74,-82,8
26,RL,0,450,8,-79.375,-74,-83,9
26,RL,0,450,8,-77.625,-73,-83,10
26,RL,0,450,5,-78.6,-75,-83,8
26,RL,0,450,4,-76.75,-73,-81,8
26,RL,1,450,9,-77.8888888888889,-74,-82,8
26,RL,0,450,1,-79,-79,-79,0
26,RL,0,450,7,-77.2857142857143,-74,-81,7
26,RL,0,450,5,-77.2,-74,-79,5
26,RL,0,450,4,-81.25,-75,-86,11
26,RL,1,450,9,-77.8888888888889,-74,-88,14
26,RL,0,450,7,-77.4285714285714,-74,-83,9
26,RL,1,450,10,-77,-74,-83,9
26,RL,0,450,8,-76.875,-74,-83,9
26,RL,1,450,9,-78.1111111111111,-74,-86,12
26,RL,0,450,7,-79.1428571428571,-74,-86,12
26,RL,0,450,2,-77.5,-75,-80,5
26,RL,0,450,1,-84,-84,-84,0
26,RL,0,450,3,-78.3333333333333,-74,-81,7
26,RL,0,450,4,-77,-74,-85,11
26,RL,0,450,2,-83,-80,-86,6
26,RL,0,450,4,-79.75,-74,-84,10
26,RL,0,450,8,-80,-74,-89,15
26,RL,0,450,5,-77,-75,-80,5
26,RL,0,450,2,-80.5,-73,-88,15
26,LR,0,450,4,-81.25,-80,-82,2
26,LR,0,450,5,-83.8,-79,-93,14
26,LR,0,450,4,-84.75,-79,-93,14
26,LR,0,450,7,-87.1428571428571,-82,-92,10
26,LR,0,450,3,-87.6666666666667,-82,-92,10
26,LR,0,450,4,-88.5,-79,-96,17
26,LR,1,450,9,-82,-75,-87,12
26,LR,0,450,2,-80.5,-77,-84,7
26,LR,0,450,4,-79.25,-76,-84,8
26,LR,1,450,10,-84.8,-80,-90,10
26,LR,0,450,2,-83.5,-80,-87,7
26,LR,0,450,4,-87.75,-83,-95,12
26,LR,0,450,7,-85.1428571428571,-80,-94,14
26,LR,0,450,5,-83,-80,-92,12
26,LR,0,450,5,-87.2,-81,-92,11
26,LR,0,450,3,-89.3333333333333,-87,-91,4
26,LR,0,450,4,-87,-83,-90,7
26,LR,0,450,6,-87.5,-79,-97,18
26,LR,0,450,3,-90,-79,-97,18
26,LR,0,450,8,-87.375,-78,-97,19
26,LR,0,450,1,-85,-85,-85,0
26,LR,0,450,2,-84,-80,-88,8
26,LR,0,450,4,-85.25,-81,-95,14
26,LR,0,450,6,-85.8333333333333,-81,-92,11
26,LR,0,450,7,-86,-81,-94,13
26,LR,0,450,5,-93.2,-89,-100,11
26,LR,1,450,10,-89.1,-83,-100,17
26,LR,0,450,5,-86.6,-83,-94,11
26,LR,1,450,10,-88.1,-83,-94,11
26,LR,0,450,3,-91,-87,-94,7
26,LR,0,450,5,-86.6,-84,-91,7
26,LR,1,450,9,-88.2222222222222,-84,-94,10
26,LR,0,450,2,-87,-86,-88,2
26,LR,0,450,5,-88.6,-85,-92,7
26,LR,0,450,6,-89.1666666666667,-85,-94,9
26,LR,0,450,5,-88.4,-85,-96,11
26,LR,0,450,6,-88.8333333333333,-85,-96,11
26,LR,0,450,6,-87.6666666666667,-85,-90,5
26,LR,0,450,1,-88,-88,-88,0
26,LR,0,450,7,-89.8571428571429,-86,-99,13
26,LR,0,450,3,-91.6666666666667,-88,-99,11
26,LR,0,450,3,-87.6666666666667,-87,-88,1
26,LR,1,450,10,-85.3,-82,-93,11
26,LR,0,450,5,-85,-83,-88,5
26,LR,0,450,5,-84.6,-82,-88,6
26,LR,0,450,1,-88,-88,-88,0
26,LR,0,450,5,-84.2,-82,-88,6
26,LR,1,450,9,-83.3333333333333,-81,-88,7
26,LR,0,450,5,-83.6,-81,-88,7
26,LR,0,450,2,-83,-81,-85,4
26,LR,0,450,5,-88.8,-86,-92,6
26,LR,0,450,8,-79.625,-75,-83,8
26,LR,1,450,10,-82.4,-76,-90,14
26,LR,1,450,10,-82.5,-76,-90,14
26,LR,0,450,6,-84.1666666666667,-80,-88,8
26,LR,1,450,9,-88,-82,-94,12
26,LR,0,450,3,-89,-88,-90,2
26,LR,0,450,1,-80,-80,-80,0
26,LR,0,450,8,-79.625,-76,-86,10
26,LR,0,450,2,-80.5,-77,-84,7
26,LR,1,450,10,-81.1,-78,-86,8
26,LR,0,450,8,-81.5,-76,-87,11
26,LR,1,450,9,-86.8888888888889,-77,-98,21
26,LR,0,450,8,-82.875,-75,-94,19
26,LR,0,450,3,-89,-80,-94,14
26,LR,0,450,3,-84.3333333333333,-79,-94,15
26,LR,0,450,8,-88.125,-80,-104,24
26,LR,0,450,8,-90.125,-80,-97,17
26,LR,0,450,8,-88,-80,-96,16
26,LR,0,450,6,-86,-80,-94,14
26,LR,0,450,2,-82.5,-80,-85,5
26,LR,0,450,6,-83.8333333333333,-80,-88,8
26,LR,0,450,6,-83,-80,-86,6
26,LR,0,450,3,-82.3333333333333,-80,-84,4
26,LR,0,450,7,-81.2857142857143,-78,-86,8
26,LR,0,450,3,-80.6666666666667,-79,-84,5
26,LR,0,450,8,-85.125,-83,-87,4
26,LR,1,450,10,-84.4,-81,-86,5
26,LR,0,450,7,-83.4285714285714,-79,-86,7
26,LR,0,450,7,-83.7142857142857,-79,-88,9
26,LR,0,450,7,-85.1428571428571,-80,-88,8
26,LR,0,450,1,-80,-80,-80,0
26,LR,1,450,10,-86.4,-82,-92,10
26,LR,0,450,4,-87,-83,-90,7
26,LR,0,450,3,-84.3333333333333,-82,-88,6
26,LR,0,450,7,-85.5714285714286,-82,-90,8
26,LR,0,450,4,-86.5,-81,-91,10
26,LR,0,450,5,-82.8,-80,-87,7
31,RL,0,500,2,-77.5,-75,-80,5
31,RL,0,500,6,-77.3333333333333,-72,-82,10
31,RL,0,500,5,-77,-72,-82,10
31,RL,0,500,5,-79.2,-72,-89,17
31,RL,0,500,4,-88.5,-85,-90,5
31,RL,1,500,9,-89,-85,-91,6
31,RL,0,500,1,-90,-90,-90,0
31,RL,0,500,3,-88.3333333333333,-84,-91,7
31,RL,0,500,8,-88.75,-82,-99,17
31,RL,0,500,4,-86.5,-82,-91,9
31,RL,0,500,4,-82,-81,-83,2
31,RL,0,500,5,-82.6,-79,-86,7
31,RL,0,500,7,-82.7142857142857,-81,-86,5
31,RL,0,500,2,-81.5,-81,-82,1
31,RL,0,500,8,-81.5,-80,-84,4
31,RL,0,500,6,-82.3333333333333,-80,-84,4
31,RL,0,500,8,-82.25,-80,-84,4
31,RL,1,500,9,-82.4444444444444,-80,-86,6
31,RL,0,500,5,-82.2,-80,-86,6
31,RL,0,500,5,-82.8,-80,-86,6
31,RL,0,500,5,-82.2,-80,-84,4
31,RL,0,500,6,-81.1666666666667,-78,-83,5
31,RL,1,500,9,-81.5555555555556,-78,-87,9
31,RL,0,500,3,-81.6666666666667,-78,-86,8
31,RL,0,500,7,-83.1428571428571,-78,-87,9
31,RL,0,500,6,-84,-78,-87,9
31,RL,0,500,8,-83.5,-78,-92,14
31,RL,0,500,5,-87.6,-78,-92,14
31,RL,0,500,8,-88,-81,-93,12
31,RL,0,500,2,-86,-84,-88,4
31,RL,0,500,7,-85.1428571428571,-81,-90,9
31,RL,0,500,8,-82.5,-80,-87,7
31,RL,0,500,2,-81,-80,-82,2
31,RL,0,500,4,-86,-79,-92,13
31,RL,1,500,9,-85.4444444444444,-79,-92,13
31,RL,0,500,8,-82.375,-80,-86,6
31,RL,0,500,2,-81,-80,-82,2
31,RL,0,500,3,-84.6666666666667,-81,-88,7
31,RL,1,500,9,-85.5555555555556,-80,-90,10
31,RL,0,500,8,-84.125,-80,-88,8
31,RL,0,500,7,-84.2857142857143,-82,-86,4
31,RL,0,500,8,-85.375,-81,-94,13
31,RL,0,500,1,-82,-82,-82,0
31,RL,0,500,2,-84,-84,-84,0
31,RL,1,500,9,-82.5555555555556,-81,-85,4
31,RL,0,500,8,-81,-77,-92,15
31,RL,0,500,2,-81.5,-81,-82,1
31,RL,0,500,6,-79.5,-77,-83,6
31,RL,0,500,1,-83,-83,-83,0
31,RL,0,500,8,-89.75,-84,-97,13
31,RL,1,500,10,-90.1,-85,-97,12
31,RL,0,500,3,-93.6666666666667,-90,-97,7
31,RL,0,500,4,-92,-88,-97,9
31,RL,0,500,6,-83.1666666666667,-82,-86,4
31,RL,0,500,7,-83.4285714285714,-82,-85,3
31,RL,0,500,2,-83.5,-83,-84,1
31,RL,0,500,2,-84.5,-84,-85,1
31,RL,0,500,2,-83.5,-83,-84,1
31,RL,0,500,6,-83.3333333333333,-81,-85,4
31,RL,0,500,8,-84,-81,-86,5
31,RL,0,500,7,-84.4285714285714,-82,-86,4
31,RL,0,500,5,-84.2,-81,-87,6
31,RL,0,500,1,-81,-81,-81,0
31,RL,0,500,1,-92,-92,-92,0
31,RL,0,500,4,-88.5,-87,-90,3
31,RL,0,500,8,-89.5,-87,-92,5
31,RL,0,500,3,-90,-89,-92,3
31,RL,0,500,3,-95.6666666666667,-92,-100,8
31,RL,0,500,8,-89.875,-86,-100,14
31,RL,1,500,10,-89.3,-84,-100,16
31,RL,0,500,8,-87.875,-84,-90,6
31,RL,0,500,7,-88.1428571428571,-84,-90,6
31,RL,0,500,6,-89.1666666666667,-84,-96,12
31,RL,0,500,6,-88.5,-84,-96,12
31,RL,0,500,4,-87.75,-84,-90,6
31,RL,0,500,1,-88,-88,-88,0
31,RL,0,500,4,-87.25,-83,-92,9
31,RL,0,500,1,-90,-90,-90,0
31,RL,0,500,6,-83.3333333333333,-80,-88,8
31,RL,0,500,7,-81.7142857142857,-80,-84,4
31,RL,1,500,10,-88.2,-84,-92,8
31,RL,0,500,8,-89.875,-84,-92,8
31,RL,0,500,4,-90.75,-90,-92,2
31,RL,0,500,2,-92,-92,-92,0
31,RL,0,500,2,-84,-80,-88,8
31,RL,0,500,5,-82.4,-80,-86,6
31,RL,0,500,4,-83,-82,-86,4
31,RL,0,500,2,-82.5,-79,-86,7
31,RL,1,500,9,-82.6666666666667,-80,-86,6
31,RL,0,500,7,-83.2857142857143,-80,-86,6
31,RL,0,500,5,-83.2,-80,-86,6
31,RL,0,500,7,-82.8571428571429,-79,-87,8
31,RL,1,500,9,-83.6666666666667,-79,-88,9
31,RL,1,500,9,-81.8888888888889,-79,-87,8
31,RL,0,500,6,-82.5,-79,-86,7
31,RL,1,500,10,-83.2,-80,-86,6
31,RL,1,500,10,-83,-80,-86,6
31,RL,0,500,7,-83.1428571428571,-80,-86,6
31,RL,0,500,3,-82.6666666666667,-80,-84,4
31,RL,1,500,10,-82.8,-79,-87,8
31,RL,0,500,8,-82.875,-79,-87,8
31,RL,0,500,6,-82.8333333333333,-79,-87,8
31,RL,1,500,10,-83.8,-79,-89,10
31,RL,0,500,1,-79,-79,-79,0
31,RL,0,500,4,-84.5,-81,-90,9
31,RL,0,500,4,-81.75,-80,-83,3
31,RL,0,500,3,-80,-79,-81,2
31,RL,0,500,1,-79,-79,-79,0
31,RL,0,500,3,-83.6666666666667,-83,-84,1
31,RL,1,500,10,-82.6,-80,-84,4
31,RL,0,500,2,-82,-80,-84,4
31,RL,0,500,5,-82.8,-82,-83,1
31,RL,0,500,1,-83,-83,-83,0
31,RL,1,500,10,-82.2,-80,-86,6
31,RL,0,500,1,-87,-87,-87,0
31,RL,0,500,6,-87.1666666666667,-80,-96,16
31,RL,0,500,2,-84.5,-84,-85,1
31,RL,0,500,7,-83,-78,-90,12
31,RL,0,500,3,-81.3333333333333,-78,-86,8
31,RL,0,500,1,-80,-80,-80,0
31,RL,0,500,3,-82.6666666666667,-80,-86,6
31,RL,1,500,10,-82.6,-77,-92,15
31,RL,0,500,7,-81,-78,-92,14
31,RL,0,500,2,-85.5,-79,-92,13
31,RL,0,500,5,-81.6,-79,-89,10
31,RL,0,500,4,-84.75,-79,-90,11
31,RL,0,500,2,-85,-80,-90,10
31,RL,0,500,3,-79.6666666666667,-79,-81,2
31,RL,0,500,4,-81.25,-80,-82,2
31,RL,0,500,6,-84,-80,-95,15
31,RL,1,500,9,-84.6666666666667,-80,-95,15
31,RL,0,500,3,-89.6666666666667,-80,-95,15
31,RL,0,500,1,-82,-82,-82,0
31,RL,0,500,6,-82.6666666666667,-81,-84,3
31,RL,1,500,9,-85.1111111111111,-82,-95,13
31,RL,0,500,3,-83,-82,-84,2
31,RL,1,500,9,-83.6666666666667,-81,-86,5
31,RL,0,500,4,-84.5,-83,-86,3
31,RL,1,500,9,-83.4444444444444,-81,-86,5
31,RL,1,500,10,-84.5,-83,-86,3
31,RL,0,500,4,-84.75,-84,-86,2
31,RL,1,500,10,-85.2,-80,-100,20
31,RL,0,500,3,-82.6666666666667,-80,-84,4
31,RL,0,500,7,-87.8571428571429,-80,-98,18
31,RL,0,500,7,-87,-80,-96,16
31,RL,0,500,7,-85.4285714285714,-80,-96,16
31,RL,0,500,7,-85.4285714285714,-80,-96,16
31,RL,0,500,3,-86.6666666666667,-81,-96,15
31,RL,0,500,5,-83,-80,-86,6
31,RL,1,500,10,-84.3,-82,-86,4
31,RL,1,500,10,-85.2,-82,-90,8
31,RL,0,500,3,-83.6666666666667,-82,-86,4
31,RL,0,500,5,-85.2,-82,-90,8
31,RL,0,500,4,-84.5,-82,-90,8
31,RL,0,500,7,-84.4285714285714,-82,-90,8
31,RL,0,500,3,-86.3333333333333,-83,-93,10
31,RL,0,500,4,-84,-81,-91,10
31,RL,0,500,3,-85,-82,-91,9
31,RL,0,500,6,-81.5,-80,-83,3
31,RL,0,500,6,-87.6666666666667,-81,-94,13
31,RL,0,500,1,-94,-94,-94,0
31,RL,1,500,9,-82.4444444444444,-80,-92,12
31,RL,1,500,9,-82.1111111111111,-80,-92,12
31,RL,0,500,7,-82.5714285714286,-80,-92,12
31,RL,0,500,4,-80.5,-80,-81,1
31,RL,0,500,1,-81,-81,-81,0
31,RL,0,500,7,-82.4285714285714,-80,-92,12
31,LR,0,500,8,-89.5,-84,-95,11
31,LR,0,500,4,-90.75,-84,-95,11
31,LR,0,500,4,-87,-84,-91,7
31,LR,0,500,6,-87.6666666666667,-85,-92,7
31,LR,0,500,2,-88,-86,-90,4
31,LR,0,500,8,-82.25,-76,-86,10
31,LR,0,500,5,-83,-76,-91,15
31,LR,0,500,4,-86.25,-81,-91,10
31,LR,0,500,1,-94,-94,-94,0
31,LR,0,500,5,-91.2,-86,-98,12
31,LR,0,500,3,-92,-86,-98,12
31,LR,0,500,4,-91,-83,-98,15
31,LR,0,500,1,-98,-98,-98,0
31,LR,1,500,9,-88.7777777777778,-83,-99,16
31,LR,0,500,8,-88.5,-81,-99,18
31,LR,1,500,9,-89.3333333333333,-81,-102,21
31,LR,0,500,1,-87,-87,-87,0
31,LR,0,500,8,-90,-83,-99,16
31,LR,0,500,1,-99,-99,-99,0
31,LR,0,500,3,-87,-85,-89,4
31,LR,0,500,6,-90.1666666666667,-85,-94,9
31,LR,0,500,5,-86.2,-83,-90,7
31,LR,1,500,10,-91.1,-82,-97,15
31,LR,0,500,1,-94,-94,-94,0
31,LR,0,500,8,-92.25,-87,-101,14
31,LR,0,500,7,-91.5714285714286,-87,-101,14
31,LR,1,500,9,-91.6666666666667,-88,-101,13
31,LR,0,500,8,-89.875,-88,-93,5
31,LR,0,500,4,-88.75,-88,-90,2
31,LR,1,500,9,-89.1111111111111,-86,-96,10
31,LR,0,500,4,-92.25,-89,-97,8
31,LR,0,500,6,-90.5,-84,-98,14
31,LR,0,500,4,-89.25,-84,-94,10
31,LR,0,500,5,-91.8,-90,-94,4
31,LR,1,500,9,-88.4444444444444,-85,-92,7
31,LR,1,500,10,-88.9,-86,-94,8
31,LR,0,500,8,-88.5,-86,-94,8
31,LR,1,500,10,-88.4,-85,-94,9
31,LR,0,500,2,-91.5,-89,-94,5
31,LR,1,500,9,-91.6666666666667,-85,-100,15
31,LR,0,500,5,-92.8,-90,-99,9
31,LR,0,500,7,-90.7142857142857,-85,-94,9
31,LR,0,500,6,-90.1666666666667,-85,-94,9
31,LR,0,500,5,-90.2,-86,-95,9
31,LR,0,500,8,-90.375,-85,-98,13
31,LR,1,500,10,-90.3,-85,-98,13
31,LR,0,500,7,-89.8571428571429,-85,-98,13
31,LR,0,500,2,-87.5,-85,-90,5
31,LR,0,500,1,-90,-90,-90,0
31,LR,1,500,9,-91.5555555555556,-84,-99,15
31,LR,0,500,8,-89,-86,-96,10
31,LR,0,500,8,-88.5,-86,-96,10
31,LR,0,500,5,-87.6,-86,-92,6
31,LR,0,500,3,-88.6666666666667,-86,-92,6
31,LR,0,500,4,-87.75,-86,-90,4
31,LR,0,500,2,-87,-86,-88,2
31,LR,0,500,8,-89.875,-86,-95,9
31,LR,0,500,6,-91.6666666666667,-88,-96,8
31,LR,1,500,9,-90.4444444444444,-86,-96,10
31,LR,0,500,1,-95,-95,-95,0
26,RL,1,500,9,-83,-78,-88,10
26,RL,0,500,1,-78,-78,-78,0
26,RL,0,500,7,-80.4285714285714,-79,-82,3
26,RL,0,500,2,-81,-81,-81,0
26,RL,0,500,5,-81.2,-80,-83,3
26,RL,0,500,2,-81.5,-80,-83,3
26,RL,0,500,6,-82.1666666666667,-77,-88,11
26,RL,0,500,8,-83.5,-77,-90,13
26,RL,1,500,10,-85.2,-77,-99,22
26,RL,0,500,2,-88,-77,-99,22
26,RL,0,500,1,-82,-82,-82,0
26,RL,0,500,8,-84.75,-82,-87,5
26,RL,0,500,8,-83.625,-78,-88,10
26,RL,0,500,2,-83,-78,-88,10
26,RL,0,500,5,-81.8,-79,-86,7
26,RL,1,500,10,-82.2,-79,-86,7
26,RL,0,500,1,-80,-80,-80,0
26,RL,0,500,8,-83.375,-79,-86,7
26,RL,0,500,5,-82.6,-79,-86,7
26,RL,0,500,1,-79,-79,-79,0
26,RL,0,500,6,-84.1666666666667,-82,-89,7
26,RL,1,500,10,-81.3,-78,-85,7
26,RL,0,500,4,-82.5,-80,-85,5
26,RL,0,500,8,-80.75,-78,-85,7
26,RL,0,500,6,-79.8333333333333,-78,-82,4
26,RL,1,500,10,-79.8,-77,-83,6
26,RL,0,500,2,-78.5,-78,-79,1
26,RL,0,500,7,-80.2857142857143,-79,-83,4
26,RL,0,500,6,-79.6666666666667,-77,-83,6
26,RL,0,500,1,-79,-79,-79,0
26,RL,0,500,5,-85.4,-80,-92,12
26,RL,1,500,9,-87.4444444444444,-81,-99,18
26,RL,0,500,5,-90.2,-84,-99,15
26,RL,0,500,4,-89.75,-84,-99,15
26,RL,0,500,8,-82,-80,-83,3
26,RL,0,500,4,-82.25,-80,-83,3
26,RL,0,500,7,-83.8571428571429,-82,-86,4
26,RL,0,500,6,-83.8333333333333,-81,-86,5
26,RL,0,500,1,-84,-84,-84,0
26,RL,0,500,7,-82.5714285714286,-81,-86,5
26,RL,1,500,9,-87.4444444444444,-81,-92,11
26,RL,0,500,3,-91.3333333333333,-87,-98,11
26,RL,0,500,4,-91,-88,-95,7
26,RL,0,500,7,-91.4285714285714,-90,-95,5
26,RL,0,500,7,-89.2857142857143,-83,-94,11
26,RL,0,500,1,-90,-90,-90,0
26,RL,0,500,2,-85.5,-83,-88,5
26,RL,0,500,7,-84.4285714285714,-81,-89,8
26,RL,1,500,10,-84.7,-81,-90,9
26,RL,1,500,9,-84.5555555555556,-79,-90,11
26,RL,1,500,10,-81.5,-79,-86,7
26,RL,0,500,7,-81.1428571428571,-79,-86,7
26,RL,0,500,8,-82,-79,-86,7
26,RL,0,500,7,-82.7142857142857,-79,-86,7
26,RL,1,500,9,-82.6666666666667,-80,-84,4
26,RL,0,500,3,-82.3333333333333,-81,-84,3
26,RL,1,500,9,-82.7777777777778,-79,-86,7
26,RL,0,500,1,-82,-82,-82,0
26,RL,0,500,6,-83.3333333333333,-79,-86,7
26,RL,0,500,5,-83.6,-80,-86,6
26,RL,0,500,7,-82.7142857142857,-80,-87,7
26,RL,0,500,4,-83.5,-80,-87,7
26,RL,0,500,2,-81,-81,-81,0
26,RL,0,500,4,-81.25,-80,-82,2
26,RL,0,500,1,-83,-83,-83,0
26,RL,0,500,2,-82,-82,-82,0
26,RL,0,500,4,-82,-80,-83,3
26,RL,0,500,3,-82.3333333333333,-82,-83,1
26,RL,0,500,4,-83,-80,-86,6
26,RL,0,500,8,-82.25,-77,-86,9
26,RL,0,500,1,-86,-86,-86,0
26,RL,0,500,7,-81.2857142857143,-77,-87,10
26,RL,1,500,10,-80,-77,-84,7
26,RL,0,500,2,-78,-77,-79,2
26,RL,0,500,6,-81,-78,-84,6
26,RL,0,500,2,-86.5,-83,-90,7
26,RL,0,500,3,-78.6666666666667,-77,-80,3
26,RL,0,500,1,-79,-79,-79,0
26,RL,0,500,5,-82.6,-81,-84,3
26,RL,0,500,8,-85.625,-80,-99,19
26,RL,0,500,1,-83,-83,-83,0
26,RL,1,500,10,-81.4,-78,-87,9
26,RL,1,500,9,-83.7777777777778,-80,-90,10
26,RL,0,500,6,-85,-82,-90,8
26,RL,0,500,1,-82,-82,-82,0
26,RL,0,500,7,-86.1428571428571,-81,-91,10
26,RL,0,500,6,-86.5,-80,-94,14
26,RL,0,500,1,-82,-82,-82,0
26,RL,0,500,3,-78.6666666666667,-76,-81,5
26,RL,0,500,5,-80.6,-76,-84,8
26,RL,0,500,3,-80.3333333333333,-76,-84,8
26,RL,1,500,9,-86.2222222222222,-78,-91,13
26,RL,0,500,8,-86.5,-78,-91,13
26,RL,0,500,6,-83.8333333333333,-78,-88,10
26,RL,0,500,2,-81,-81,-81,0
26,RL,1,500,9,-80.7777777777778,-79,-83,4
26,RL,0,500,2,-81.5,-80,-83,3
26,RL,0,500,5,-80.4,-79,-81,2
26,RL,1,500,9,-80.1111111111111,-77,-82,5
26,RL,0,500,6,-81.6666666666667,-77,-85,8
26,RL,0,500,5,-83.4,-77,-90,13
26,RL,1,500,9,-84.6666666666667,-77,-99,22
26,RL,0,500,5,-86.6,-77,-99,22
26,RL,0,500,8,-88.25,-79,-99,20
26,RL,1,500,10,-84,-78,-88,10
26,RL,0,500,2,-83,-82,-84,2
26,RL,0,500,5,-82.4,-78,-86,8
26,RL,0,500,5,-82.6,-79,-86,7
26,RL,1,500,10,-82,-79,-86,7
26,RL,0,500,3,-81.6666666666667,-80,-83,3
26,RL,0,500,6,-83.6666666666667,-80,-89,9
26,RL,1,500,9,-85.1111111111111,-81,-89,8
26,RL,0,500,8,-85,-82,-89,7
26,RL,1,500,9,-79.6666666666667,-77,-83,6
26,RL,0,500,8,-80.375,-77,-83,6
26,RL,0,500,7,-88.8571428571429,-81,-99,18
26,RL,0,500,8,-83.125,-80,-90,10
26,RL,0,500,6,-82.5,-81,-86,5
26,RL,0,500,8,-81.75,-80,-83,3
26,RL,1,500,10,-82.2,-80,-84,4
26,RL,1,500,9,-83.5555555555556,-81,-86,5
26,RL,0,500,5,-83.4,-81,-86,5
26,RL,0,500,3,-85.3333333333333,-81,-90,9
26,RL,0,500,5,-89.4,-85,-92,7
26,RL,1,500,10,-89.8,-87,-98,11
26,RL,0,500,3,-87.6666666666667,-87,-89,2
26,RL,0,500,6,-90.1666666666667,-87,-98,11
26,RL,0,500,6,-91.6666666666667,-90,-95,5
26,RL,0,500,4,-92.25,-90,-95,5
26,RL,0,500,3,-85.3333333333333,-83,-89,6
26,RL,0,500,5,-84,-81,-89,8
26,RL,0,500,7,-85.4285714285714,-81,-90,9
26,RL,0,500,1,-82,-82,-82,0
26,RL,1,500,10,-81.2,-79,-86,7
26,RL,0,500,6,-81,-79,-86,7
26,RL,0,500,7,-81.4285714285714,-79,-86,7
26,RL,0,500,4,-83.5,-81,-86,5
26,RL,0,500,7,-82.8571428571429,-81,-84,3
26,RL,0,500,3,-82,-79,-84,5
26,RL,1,500,9,-82.5555555555556,-79,-86,7
26,RL,0,500,3,-81.3333333333333,-79,-83,4
26,RL,1,500,10,-82.6,-79,-86,7
26,RL,0,500,6,-82.8333333333333,-79,-86,7
26,RL,0,500,1,-83,-83,-83,0
26,RL,1,500,9,-82.1111111111111,-80,-87,7
26,RL,1,500,10,-81.6,-80,-87,7
26,RL,0,500,4,-81,-81,-81,0
26,RL,0,500,2,-80.5,-80,-81,1
26,RL,1,500,10,-81.1,-79,-83,4
26,RL,1,500,9,-80.8888888888889,-79,-83,4
26,RL,0,500,1,-82,-82,-82,0
26,RL,1,500,10,-81.1,-79,-83,4
26,RL,0,500,4,-81.25,-79,-83,4
26,RL,0,500,8,-81.625,-80,-84,4
26,RL,0,500,3,-81,-78,-83,5
26,RL,0,500,5,-85.2,-77,-97,20
26,RL,0,500,4,-79,-77,-81,4
26,RL,0,500,1,-78,-78,-78,0
26,RL,0,500,8,-81.75,-77,-90,13
26,RL,0,500,6,-82.3333333333333,-81,-84,3
26,RL,0,500,7,-84.7142857142857,-80,-99,19
26,RL,0,500,5,-83.4,-78,-93,15
26,RL,0,500,4,-83,-78,-93,15
26,RL,0,500,6,-85,-82,-90,8
26,RL,0,500,3,-86.6666666666667,-81,-90,9
26,RL,0,500,7,-87.1428571428571,-80,-94,14
26,RL,0,500,3,-84,-80,-92,12
26,RL,0,500,1,-81,-81,-81,0
26,LR,0,500,5,-86,-80,-93,13
26,LR,0,500,4,-82.5,-73,-93,20
26,LR,0,500,1,-93,-93,-93,0
26,LR,0,500,6,-82.5,-78,-87,9
26,LR,0,500,3,-85,-83,-88,5
26,LR,0,500,8,-89.875,-81,-95,14
26,LR,0,500,3,-89.3333333333333,-81,-95,14
26,LR,1,500,9,-86.1111111111111,-79,-95,16
26,LR,0,500,2,-90.5,-90,-91,1
26,LR,0,500,5,-87,-84,-92,8
26,LR,1,500,9,-87.2222222222222,-82,-93,11
26,LR,1,500,10,-86.1,-82,-93,11
26,LR,0,500,5,-85,-82,-88,6
26,LR,0,500,6,-84.6666666666667,-82,-87,5
26,LR,0,500,8,-84.75,-82,-89,7
26,LR,1,500,9,-90.2222222222222,-85,-97,12
26,LR,0,500,2,-91,-85,-97,12
26,LR,1,500,9,-91,-87,-98,11
26,LR,0,500,1,-95,-95,-95,0
26,LR,0,500,3,-89.3333333333333,-87,-94,7
26,LR,0,500,1,-90,-90,-90,0
26,LR,0,500,5,-85.4,-80,-96,16
26,LR,0,500,3,-82.3333333333333,-80,-86,6
26,LR,0,500,1,-86,-86,-86,0
26,LR,0,500,8,-89.25,-81,-95,14
26,LR,0,500,7,-89.5714285714286,-84,-98,14
26,LR,0,500,3,-90.3333333333333,-88,-93,5
26,LR,0,500,8,-87.25,-84,-91,7
26,LR,0,500,2,-87.5,-85,-90,5
26,LR,0,500,6,-86.1666666666667,-84,-91,7
26,LR,0,500,3,-90,-87,-95,8
26,LR,1,500,9,-90.2222222222222,-85,-100,15
26,LR,1,500,10,-89.7,-85,-100,15
26,LR,0,500,1,-86,-86,-86,0
26,LR,1,500,9,-87.4444444444444,-83,-92,9
26,LR,0,500,7,-87.5714285714286,-83,-92,9
26,LR,0,500,1,-92,-92,-92,0
26,LR,0,500,5,-89.4,-84,-98,14
26,LR,0,500,4,-90.25,-84,-98,14
26,LR,0,500,6,-89.5,-86,-92,6
26,LR,0,500,4,-88,-86,-92,6
26,LR,0,500,6,-89,-86,-92,6
26,LR,0,500,3,-88.3333333333333,-88,-89,1
26,LR,0,500,3,-86,-83,-89,6
26,LR,0,500,2,-87,-85,-89,4
26,LR,0,500,3,-93.3333333333333,-84,-98,14
26,LR,0,500,6,-90.3333333333333,-85,-98,13
26,LR,0,500,6,-90.1666666666667,-85,-97,12
26,LR,0,500,3,-92,-85,-97,12
26,LR,0,500,2,-94.5,-92,-97,5
26,LR,0,500,1,-94,-94,-94,0
26,LR,0,500,1,-92,-92,-92,0
26,LR,0,500,1,-93,-93,-93,0
26,LR,0,500,2,-88.5,-86,-91,5
26,LR,0,500,2,-87,-87,-87,0
26,LR,1,500,9,-89.7777777777778,-85,-98,13
26,LR,0,500,7,-90.4285714285714,-85,-98,13
26,LR,0,500,4,-90.5,-85,-98,13
26,LR,0,500,8,-88.75,-85,-92,7
26,LR,1,500,10,-89.6,-86,-92,6
26,LR,0,500,5,-88.8,-86,-91,5
26,LR,0,500,1,-90,-90,-90,0
26,LR,0,500,6,-88.3333333333333,-83,-94,11
26,LR,0,500,4,-86.5,-83,-89,6
26,LR,0,500,5,-88.6,-85,-93,8
26,LR,0,500,8,-90.25,-84,-99,15
26,LR,0,500,4,-91,-88,-96,8
26,LR,0,500,2,-89,-88,-90,2
26,LR,0,500,1,-88,-88,-88,0
26,LR,1,500,10,-86.2,-83,-91,8
26,LR,0,500,2,-87,-83,-91,8
26,LR,1,500,9,-88.2222222222222,-84,-95,11
26,LR,0,500,5,-89.8,-86,-95,9
26,LR,0,500,7,-89.5714285714286,-86,-95,9
26,LR,0,500,4,-88.75,-87,-92,5
26,LR,0,500,8,-80.25,-73,-93,20
26,LR,0,500,4,-76,-73,-80,7
26,LR,0,500,1,-73,-73,-73,0
26,LR,0,500,6,-82,-78,-87,9
26,LR,0,500,6,-83,-78,-87,9
26,LR,0,500,7,-83.4285714285714,-78,-88,10
26,LR,1,500,9,-89.1111111111111,-81,-95,14
26,LR,0,500,7,-86.2857142857143,-81,-95,14
26,LR,0,500,6,-87.6666666666667,-79,-92,13
26,LR,0,500,2,-85.5,-79,-92,13
26,LR,0,500,1,-84,-84,-84,0
26,LR,0,500,7,-89.7142857142857,-84,-100,16
26,LR,0,500,4,-86.75,-83,-93,10
26,LR,0,500,8,-86.375,-82,-97,15
26,LR,0,500,7,-90.1428571428571,-85,-97,12
26,LR,0,500,8,-90.625,-85,-95,10
26,LR,0,500,1,-87,-87,-87,0
26,LR,0,500,3,-88,-85,-90,5
26,LR,0,500,5,-89.2,-80,-98,18
26,LR,0,500,7,-85.5714285714286,-80,-96,16
26,LR,0,500,4,-85.75,-80,-96,16
26,LR,0,500,1,-80,-80,-80,0
26,LR,0,500,3,-83.6666666666667,-81,-86,5
26,LR,0,500,2,-92.5,-90,-95,5
26,LR,1,500,9,-89.4444444444444,-84,-98,14
26,LR,0,500,6,-88.5,-85,-91,6
26,LR,0,500,8,-87.25,-84,-91,7
26,LR,0,500,5,-93.6,-86,-100,14
26,LR,0,500,2,-94.5,-88,-101,13
26,LR,1,500,9,-89.4444444444444,-86,-100,14
26,LR,0,500,8,-89.125,-86,-100,14
26,LR,0,500,6,-89.3333333333333,-86,-100,14
26,LR,0,500,8,-90.375,-86,-100,14
26,LR,0,500,3,-88,-86,-91,5
26,LR,0,500,6,-88.3333333333333,-85,-92,7
26,LR,0,500,4,-88.25,-85,-91,6
26,LR,0,500,8,-89.875,-84,-98,14
26,LR,0,500,7,-91.4285714285714,-89,-96,7
26,LR,0,500,2,-90,-89,-91,2
26,LR,0,500,8,-90.25,-86,-96,10
26,LR,1,500,10,-89.9,-86,-92,6
26,LR,0,500,8,-87.875,-83,-93,10
26,LR,0,500,6,-87.3333333333333,-83,-93,10
26,LR,0,500,6,-87,-83,-93,10
26,LR,1,500,10,-88.1,-83,-98,15
26,LR,0,500,7,-89.8571428571429,-84,-98,14
26,LR,0,500,3,-91,-86,-95,9
26,LR,0,500,6,-90.6666666666667,-85,-97,12
26,LR,0,500,5,-91.6,-85,-97,12
26,LR,0,500,4,-95,-92,-97,5
26,LR,0,500,6,-90.6666666666667,-87,-93,6
26,LR,0,500,7,-89.4285714285714,-86,-93,7
26,LR,0,500,4,-88,-85,-91,6
26,LR,1,500,9,-89.7777777777778,-85,-98,13
26,LR,0,500,8,-88.375,-86,-90,4
26,LR,0,500,2,-85.5,-85,-86,1
26,LR,0,500,8,-89.125,-81,-94,13
26,LR,0,500,6,-88.8333333333333,-81,-94,13
26,LR,0,500,3,-89.6666666666667,-84,-99,15
26,LR,1,500,9,-89.3333333333333,-86,-94,8
26,LR,1,500,10,-89,-86,-94,8
26,LR,0,500,2,-91,-90,-92,2
26,LR,0,500,4,-90,-86,-92,6
26,LR,0,500,4,-89.25,-86,-94,8
26,LR,0,500,6,-87.6666666666667,-86,-94,8
26,LR,0,500,8,-89.375,-86,-95,9
26,LR,0,500,8,-88.375,-86,-94,8
26,LR,1,500,9,-88.2222222222222,-86,-94,8
26,LR,0,500,4,-89.25,-87,-94,7
26,LR,0,500,4,-88.75,-87,-92,5
