watch,combination,risk,dist,samples,meanRSS,maxRSS,minRSS,rangeRSS
31,RR,1,50,9,-62.6666666666667,-58,-67,9
31,RR,0,50,1,-61,-61,-61,0
31,RR,1,50,8,-63.375,-57,-70,13
31,RR,0,50,2,-60.5,-57,-64,7
31,RR,1,50,5,-72.4,-70,-74,4
31,RR,1,50,8,-69.625,-68,-73,5
31,RR,1,50,3,-69.3333333333333,-68,-72,4
31,RR,1,50,7,-70.4285714285714,-68,-73,5
31,RR,1,50,4,-70.5,-68,-73,5
31,RR,1,50,9,-74,-72,-78,6
31,RR,1,50,5,-73.6,-72,-76,4
31,RR,1,50,10,-75.4,-73,-81,8
31,RR,0,50,1,-76,-76,-76,0
31,RR,1,50,8,-74.5,-73,-76,3
31,RR,1,50,10,-74.3,-73,-76,3
31,RR,1,50,6,-74,-73,-76,3
31,RR,0,50,2,-73.5,-73,-74,1
31,RR,1,50,8,-73.5,-72,-74,2
31,RR,1,50,10,-73.5,-71,-75,4
31,RR,1,50,10,-76.3,-75,-78,3
31,RR,1,50,4,-75.75,-75,-76,1
31,RR,0,50,1,-76,-76,-76,0
31,RR,1,50,8,-75.875,-74,-82,8
31,RR,1,50,9,-75.1111111111111,-70,-82,12
31,RR,1,50,4,-69.5,-69,-70,1
31,RR,1,50,5,-70.4,-70,-72,2
31,RR,1,50,5,-70,-68,-72,4
31,RR,0,50,1,-70,-70,-70,0
31,RR,1,50,3,-70,-68,-72,4
31,RR,1,50,9,-71,-68,-74,6
31,RR,1,50,8,-70.875,-68,-74,6
31,RR,1,50,8,-71.5,-70,-73,3
31,RR,1,50,3,-71.3333333333333,-70,-72,2
31,RR,1,50,6,-71.8333333333333,-71,-73,2
31,RR,1,50,8,-72.375,-71,-73,2
31,RR,1,50,10,-71.6,-70,-73,3
31,RR,0,50,2,-71.5,-71,-72,1
31,RR,0,50,1,-70,-70,-70,0
31,RR,1,50,5,-72.4,-72,-73,1
31,RR,1,50,8,-72.75,-70,-74,4
31,RR,1,50,10,-73,-72,-74,2
31,RR,1,50,4,-72.75,-72,-74,2
31,RR,0,50,1,-73,-73,-73,0
31,RR,1,50,8,-71,-70,-72,2
31,RR,1,50,8,-71.875,-70,-75,5
31,RR,1,50,6,-72.5,-70,-75,5
31,RR,1,50,7,-72.8571428571429,-71,-75,4
31,RR,1,50,6,-72,-71,-74,3
31,RR,0,50,1,-71,-71,-71,0
31,RR,1,50,3,-70.6666666666667,-70,-72,2
31,RR,1,50,8,-73.125,-70,-79,9
31,RR,1,50,5,-73,-70,-79,9
31,RR,1,50,7,-74.7142857142857,-72,-79,7
31,RR,1,50,10,-73,-70,-78,8
31,RR,1,50,10,-72.3,-70,-76,6
31,RR,1,50,6,-72.6666666666667,-71,-75,4
31,RR,1,50,8,-71.875,-70,-74,4
31,RR,1,50,4,-72.25,-67,-75,8
31,RR,1,50,4,-69,-67,-72,5
31,RR,0,50,1,-70,-70,-70,0
31,RR,1,50,6,-71.1666666666667,-67,-74,7
31,RR,1,50,7,-69.5714285714286,-67,-73,6
31,RR,1,50,7,-70.7142857142857,-69,-73,4
31,RR,1,50,3,-76,-73,-79,6
31,RR,1,50,7,-74,-66,-79,13
31,RR,1,50,5,-69,-62,-79,17
31,RR,1,50,5,-67.2,-62,-79,17
31,RR,1,50,3,-69.3333333333333,-66,-72,6
31,RR,1,50,6,-67.5,-66,-70,4
31,RR,0,50,1,-69,-69,-69,0
31,RR,0,50,2,-71,-67,-75,8
31,RR,1,50,8,-67.5,-63,-72,9
31,RR,1,50,7,-67.8571428571429,-63,-72,9
31,RR,1,50,10,-61.9,-61,-63,2
31,RR,1,50,5,-61.8,-61,-62,1
31,RR,0,50,1,-62,-62,-62,0
31,LL,1,50,5,-76.8,-64,-87,23
31,LL,0,50,1,-75,-75,-75,0
31,LL,1,50,10,-73.9,-71,-79,8
31,LL,1,50,3,-73.6666666666667,-72,-75,3
31,LL,1,50,9,-75,-71,-78,7
31,LL,1,50,4,-75,-73,-77,4
31,LL,1,50,5,-76.2,-73,-78,5
31,LL,1,50,4,-75.25,-72,-77,5
31,LL,0,50,1,-76,-76,-76,0
31,LL,1,50,7,-73.5714285714286,-71,-78,7
31,LL,0,50,1,-78,-78,-78,0
31,LL,1,50,6,-73.5,-71,-78,7
31,LL,0,50,1,-73,-73,-73,0
31,LL,1,50,4,-74,-72,-80,8
31,LL,1,50,10,-72.3,-70,-79,9
31,LL,1,50,3,-70,-70,-70,0
31,LL,1,50,5,-71,-68,-75,7
31,LL,1,50,8,-73.25,-72,-75,3
31,LL,1,50,6,-73.6666666666667,-71,-80,9
31,LL,1,50,6,-72.5,-66,-80,14
31,LL,1,50,7,-69.5714285714286,-68,-71,3
31,LL,0,50,2,-70,-69,-71,2
31,LL,1,50,4,-69,-67,-72,5
31,LL,0,50,1,-73,-73,-73,0
31,LL,1,50,9,-74.4444444444444,-70,-79,9
31,LL,1,50,6,-72.6666666666667,-70,-77,7
31,LL,1,50,4,-71.75,-70,-74,4
31,LL,1,50,7,-69.2857142857143,-65,-73,8
31,LL,1,50,6,-68.3333333333333,-65,-71,6
31,LL,1,50,6,-66.3333333333333,-64,-70,6
31,LL,1,50,8,-67.125,-64,-69,5
31,LL,1,50,3,-68.3333333333333,-68,-69,1
31,LL,1,50,4,-67,-64,-68,4
31,LL,1,50,5,-66.2,-64,-68,4
31,LL,1,50,3,-66.3333333333333,-66,-67,1
31,LL,1,50,7,-67.1428571428571,-63,-71,8
31,LL,1,50,7,-66.4285714285714,-63,-71,8
31,LL,1,50,3,-69.6666666666667,-68,-71,3
31,LL,1,50,5,-65,-63,-68,5
31,LL,1,50,4,-65,-64,-68,4
31,LL,1,50,4,-66.5,-64,-68,4
31,LL,1,50,6,-63.8333333333333,-62,-66,4
31,LL,1,50,10,-63.9,-62,-67,5
31,LL,1,50,7,-64.1428571428571,-61,-66,5
31,LL,1,50,3,-62.6666666666667,-61,-64,3
31,LL,1,50,5,-65.4,-65,-66,1
31,LL,1,50,7,-65,-62,-68,6
31,LL,1,50,8,-65.125,-62,-68,6
31,LL,0,50,2,-65.5,-64,-67,3
31,LL,1,50,3,-67,-66,-68,2
31,LL,1,50,7,-66.8571428571429,-64,-70,6
31,LL,1,50,6,-68.6666666666667,-64,-78,14
31,LL,1,50,4,-63.5,-62,-66,4
31,LL,1,50,4,-68.25,-68,-69,1
31,LL,1,50,8,-71.5,-68,-77,9
31,LL,1,50,8,-72,-68,-77,9
31,LL,1,50,5,-74.2,-71,-78,7
31,LL,1,50,3,-73.6666666666667,-71,-78,7
31,LL,1,50,3,-76,-72,-84,12
31,LL,1,50,6,-73.8333333333333,-72,-80,8
31,LL,0,50,2,-72.5,-72,-73,1
31,LL,1,50,10,-75.6,-72,-80,8
31,LL,1,50,6,-75.8333333333333,-72,-79,7
31,LL,1,50,8,-79.875,-76,-82,6
31,LL,1,50,4,-77.75,-76,-81,5
31,LL,1,50,3,-78,-77,-80,3
31,LL,1,50,9,-82.7777777777778,-78,-95,17
31,LL,1,50,5,-85,-78,-95,17
31,LL,1,50,9,-80.5555555555556,-76,-86,10
31,LL,1,50,7,-80.7142857142857,-78,-86,8
31,LL,1,50,5,-81.2,-78,-86,8
31,LL,1,50,9,-77.6666666666667,-73,-82,9
31,LL,0,50,1,-76,-76,-76,0
31,LL,1,50,7,-76.5714285714286,-73,-80,7
31,LL,1,50,7,-80.1428571428571,-77,-85,8
31,LL,1,50,5,-78.4,-75,-81,6
31,LL,1,50,6,-76.3333333333333,-74,-81,7
31,LL,0,50,2,-75.5,-75,-76,1
31,LL,1,50,4,-76,-72,-79,7
31,LL,1,50,10,-72.1,-70,-77,7
31,LL,1,50,4,-72.25,-72,-73,1
31,LL,1,50,8,-72.75,-70,-76,6
31,LL,1,50,6,-73,-70,-76,6
31,LL,1,50,8,-73.75,-72,-77,5
31,LL,1,50,7,-73.8571428571429,-72,-77,5
31,LL,1,50,7,-75.4285714285714,-72,-79,7
31,LL,1,50,7,-74.8571428571429,-72,-79,7
31,LL,1,50,3,-77,-75,-81,6
31,LL,1,50,5,-77.6,-74,-86,12
31,LL,1,50,6,-82.1666666666667,-76,-91,15
31,LL,1,50,4,-82.75,-78,-91,13
31,LL,1,50,10,-80.7,-72,-91,19
31,LL,1,50,9,-73.7777777777778,-68,-79,11
31,LL,0,50,2,-73.5,-73,-74,1
31,LL,0,50,2,-64.5,-63,-66,3
26,RR,0,50,1,-63,-63,-63,0
26,RR,0,50,2,-64,-62,-66,4
26,RR,1,50,3,-61,-57,-64,7
26,RR,1,50,5,-70.8,-69,-72,3
26,RR,1,50,7,-70.5714285714286,-68,-72,4
26,RR,1,50,8,-68.875,-66,-74,8
26,RR,0,50,2,-67,-67,-67,0
26,RR,1,50,9,-70.4444444444444,-68,-74,6
26,RR,1,50,6,-69.6666666666667,-68,-72,4
26,RR,1,50,6,-70.6666666666667,-68,-74,6
26,RR,0,50,2,-73.5,-71,-76,5
26,RR,0,50,1,-73,-73,-73,0
26,RR,1,50,3,-72.6666666666667,-72,-74,2
26,RR,1,50,10,-73.1,-71,-78,7
26,RR,0,50,1,-72,-72,-72,0
26,RR,1,50,7,-72.2857142857143,-71,-73,2
26,RR,1,50,10,-73.9,-72,-77,5
26,RR,1,50,9,-75,-73,-78,5
26,RR,0,50,1,-76,-76,-76,0
26,RR,1,50,9,-75.3333333333333,-73,-78,5
26,RR,1,50,3,-75.6666666666667,-73,-78,5
26,RR,1,50,3,-74,-73,-75,2
26,RR,1,50,5,-74.8,-74,-76,2
26,RR,1,50,10,-72.9,-68,-76,8
26,RR,1,50,3,-70,-68,-72,4
26,RR,1,50,3,-69.3333333333333,-66,-72,6
26,RR,1,50,6,-69,-67,-70,3
26,RR,1,50,5,-68.6,-67,-70,3
26,RR,0,50,1,-69,-69,-69,0
26,RR,1,50,10,-68.5,-68,-70,2
26,RR,1,50,7,-69,-67,-72,5
26,RR,0,50,2,-69.5,-67,-72,5
26,RR,1,50,8,-69.75,-67,-72,5
26,RR,1,50,4,-69.75,-68,-72,4
26,RR,1,50,9,-71.3333333333333,-70,-72,2
26,RR,1,50,7,-71.1428571428571,-70,-72,2
26,RR,0,50,1,-71,-71,-71,0
26,RR,1,50,10,-70.7,-67,-73,6
26,RR,1,50,3,-70.6666666666667,-69,-73,4
26,RR,1,50,7,-69.4285714285714,-67,-73,6
26,RR,1,50,7,-70.1428571428571,-67,-72,5
26,RR,0,50,2,-70.5,-70,-71,1
26,RR,1,50,6,-71,-70,-72,2
26,RR,1,50,4,-71,-70,-72,2
26,RR,1,50,5,-72,-70,-74,4
26,RR,1,50,6,-71.5,-70,-73,3
26,RR,1,50,7,-71.2857142857143,-70,-73,3
26,RR,1,50,6,-71.3333333333333,-70,-73,3
26,RR,1,50,6,-70.3333333333333,-70,-72,2
26,RR,1,50,3,-71.3333333333333,-70,-74,4
26,RR,0,50,2,-71.5,-70,-73,3
26,RR,1,50,7,-70,-68,-72,4
26,RR,1,50,8,-72.75,-69,-78,9
26,RR,1,50,7,-76,-72,-80,8
26,RR,1,50,4,-72.5,-71,-76,5
26,RR,1,50,5,-72.2,-71,-76,5
26,RR,1,50,9,-73.1111111111111,-70,-79,9
26,RR,1,50,10,-73,-70,-79,9
26,RR,0,50,2,-73.5,-72,-75,3
26,RR,1,50,4,-72.25,-70,-74,4
26,RR,1,50,10,-73.3,-69,-80,11
26,RR,1,50,10,-73.3,-69,-80,11
26,RR,1,50,6,-74.5,-69,-80,11
26,RR,0,50,1,-74,-74,-74,0
26,RR,1,50,4,-70.75,-68,-73,5
26,RR,0,50,2,-69,-68,-70,2
26,RR,0,50,2,-68,-67,-69,2
26,RR,0,50,2,-69.5,-68,-71,3
26,RR,1,50,5,-70,-68,-73,5
26,RR,1,50,9,-69.5555555555556,-66,-76,10
26,RR,1,50,4,-68.75,-66,-72,6
26,RR,1,50,8,-73.75,-72,-76,4
26,RR,1,50,3,-74,-73,-75,2
26,RR,1,50,5,-72.8,-72,-74,2
26,RR,1,50,9,-65.1111111111111,-60,-72,12
26,RR,1,50,9,-63.7777777777778,-61,-66,5
26,RR,1,50,4,-62.5,-62,-64,2
26,RR,0,50,1,-64,-64,-64,0
26,RR,0,50,1,-70,-70,-70,0
26,RR,1,50,10,-73.2,-66,-95,29
26,RR,1,50,6,-67.3333333333333,-66,-70,4
26,RR,0,50,2,-69,-68,-70,2
26,RR,0,50,2,-66,-66,-66,0
26,RR,1,50,4,-65.75,-64,-67,3
26,RR,1,50,10,-65.5,-61,-68,7
26,RR,0,50,2,-65.5,-64,-67,3
26,RR,1,50,5,-64.6,-61,-67,6
26,RR,1,50,4,-67.75,-67,-69,2
26,RR,1,50,7,-60.2857142857143,-56,-62,6
26,RR,1,50,6,-61.1666666666667,-61,-62,1
26,RR,1,50,7,-60,-58,-61,3
26,RR,1,50,6,-59.5,-58,-61,3
26,LL,0,50,1,-72,-72,-72,0
26,LL,1,50,3,-75.3333333333333,-73,-77,4
26,LL,1,50,3,-71.3333333333333,-70,-73,3
26,LL,0,50,2,-72,-72,-72,0
26,LL,1,50,4,-73.5,-70,-76,6
26,LL,1,50,8,-74.25,-70,-79,9
26,LL,0,50,1,-78,-78,-78,0
26,LL,1,50,7,-75.4285714285714,-70,-79,9
26,LL,1,50,9,-74.3333333333333,-70,-79,9
26,LL,1,50,9,-74.2222222222222,-70,-79,9
26,LL,1,50,7,-75,-70,-79,9
26,LL,1,50,3,-73.6666666666667,-71,-78,7
26,LL,1,50,3,-75.3333333333333,-71,-78,7
26,LL,0,50,2,-71.5,-71,-72,1
26,LL,1,50,5,-71.2,-68,-74,6
26,LL,0,50,1,-68,-68,-68,0
26,LL,1,50,8,-73.875,-71,-78,7
26,LL,0,50,2,-76,-75,-77,2
26,LL,1,50,7,-68.8571428571429,-66,-73,7
26,LL,0,50,2,-71.5,-70,-73,3
26,LL,1,50,4,-67,-66,-70,4
26,LL,1,50,8,-67.25,-66,-68,2
26,LL,1,50,6,-70.8333333333333,-67,-73,6
26,LL,1,50,6,-71.8333333333333,-68,-73,5
26,LL,1,50,3,-72.6666666666667,-72,-73,1
26,LL,1,50,10,-73.1,-71,-76,5
26,LL,0,50,2,-73,-73,-73,0
26,LL,1,50,3,-73.6666666666667,-71,-76,5
26,LL,1,50,3,-72.6666666666667,-70,-75,5
26,LL,0,50,1,-73,-73,-73,0
26,LL,1,50,6,-74.6666666666667,-70,-78,8
26,LL,1,50,10,-70.8,-65,-79,14
26,LL,1,50,3,-72.3333333333333,-69,-78,9
26,LL,1,50,10,-66,-64,-68,4
26,LL,0,50,1,-67,-67,-67,0
26,LL,1,50,5,-65.6,-64,-68,4
26,LL,1,50,9,-65.4444444444444,-63,-68,5
26,LL,1,50,8,-63.875,-62,-66,4
26,LL,1,50,4,-63.25,-62,-66,4
26,LL,1,50,6,-63.6666666666667,-62,-66,4
26,LL,1,50,9,-64.2222222222222,-62,-66,4
26,LL,1,50,3,-67,-66,-68,2
26,LL,1,50,6,-63.6666666666667,-62,-66,4
26,LL,1,50,8,-63.75,-62,-66,4
26,LL,0,50,2,-64,-63,-65,2
26,LL,1,50,10,-62.3,-60,-65,5
26,LL,1,50,6,-63.6666666666667,-62,-65,3
26,LL,1,50,4,-63.5,-62,-65,3
26,LL,1,50,6,-67.1666666666667,-66,-69,3
26,LL,1,50,5,-67.4,-66,-69,3
26,LL,1,50,4,-68.25,-66,-70,4
26,LL,0,50,2,-65.5,-65,-66,1
26,LL,1,50,5,-69.8,-67,-73,6
26,LL,1,50,4,-72,-68,-75,7
26,LL,1,50,3,-72,-68,-75,7
26,LL,1,50,10,-71.5,-70,-78,8
26,LL,1,50,9,-74.8888888888889,-72,-78,6
26,LL,1,50,8,-74.625,-72,-78,6
26,LL,1,50,9,-75.1111111111111,-72,-78,6
26,LL,1,50,7,-74.4285714285714,-72,-78,6
26,LL,1,50,7,-76.8571428571429,-75,-79,4
26,LL,1,50,9,-79.6666666666667,-78,-84,6
26,LL,1,50,10,-78.6,-76,-83,7
26,LL,1,50,10,-78.5,-76,-83,7
26,LL,1,50,6,-77.6666666666667,-76,-83,7
26,LL,1,50,10,-78.9,-76,-83,7
26,LL,1,50,3,-80.6666666666667,-77,-83,6
26,LL,1,50,4,-78.5,-77,-82,5
26,LL,1,50,6,-78,-74,-81,7
26,LL,1,50,5,-74.2,-72,-77,5
26,LL,0,50,2,-74,-72,-76,4
26,LL,1,50,3,-72.6666666666667,-72,-73,1
26,LL,1,50,3,-74.3333333333333,-73,-76,3
26,LL,1,50,10,-78,-73,-85,12
26,LL,0,50,1,-73,-73,-73,0
26,LL,1,50,8,-73.5,-68,-78,10
26,LL,1,50,9,-76.5555555555556,-72,-82,10
26,LL,1,50,8,-74.25,-72,-80,8
26,LL,1,50,9,-71.3333333333333,-66,-75,9
31,RR,1,100,5,-65.6,-64,-67,3
31,RR,1,100,6,-71.1666666666667,-67,-84,17
31,RR,1,100,10,-78.7,-67,-95,28
31,RR,1,100,3,-81.3333333333333,-78,-86,8
31,RR,0,100,1,-84,-84,-84,0
31,RR,1,100,7,-83.8571428571429,-81,-89,8
31,RR,1,100,10,-83.9,-78,-89,11
31,RR,1,100,6,-81.8333333333333,-74,-88,14
31,RR,1,100,6,-81.6666666666667,-78,-86,8
31,RR,0,100,2,-80,-80,-80,0
31,RR,1,100,10,-81.2,-77,-86,9
31,RR,0,100,2,-79.5,-77,-82,5
31,RR,1,100,9,-81.5555555555556,-77,-86,9
31,RR,0,100,2,-80,-77,-83,6
31,RR,1,100,3,-76.3333333333333,-76,-77,1
31,RR,1,100,5,-82,-76,-86,10
31,RR,1,100,8,-79.625,-78,-83,5
31,RR,1,100,9,-79.5555555555556,-76,-82,6
31,RR,1,100,9,-79.3333333333333,-77,-83,6
31,RR,0,100,1,-80,-80,-80,0
31,RR,1,100,5,-81,-79,-82,3
31,RR,1,100,8,-77.625,-75,-80,5
31,RR,0,100,2,-78,-76,-80,4
31,RR,1,100,3,-77.6666666666667,-76,-80,4
31,RR,1,100,4,-79,-77,-81,4
31,RR,1,100,8,-78.125,-75,-84,9
31,RR,0,100,1,-80,-80,-80,0
31,RR,1,100,6,-76.6666666666667,-73,-80,7
31,RR,0,100,1,-80,-80,-80,0
31,RR,1,100,5,-76.2,-74,-77,3
31,RR,1,100,9,-75.4444444444444,-73,-77,4
31,RR,1,100,3,-76.6666666666667,-76,-77,1
31,RR,1,100,6,-75.3333333333333,-73,-77,4
31,RR,1,100,7,-75.1428571428571,-73,-76,3
31,RR,0,100,1,-76,-76,-76,0
31,RR,1,100,6,-76.1666666666667,-74,-78,4
31,RR,1,100,3,-75.6666666666667,-71,-78,7
31,RR,1,100,5,-76.8,-71,-80,9
31,RR,1,100,5,-81.6,-76,-92,16
31,RR,1,100,8,-82.875,-74,-93,19
31,RR,0,100,2,-82.5,-81,-84,3
31,RR,1,100,6,-78.3333333333333,-75,-82,7
31,RR,0,100,2,-78,-75,-81,6
31,RR,1,100,6,-79,-75,-83,8
31,RR,1,100,9,-79.7777777777778,-76,-83,7
31,RR,1,100,7,-80,-79,-81,2
31,RR,1,100,4,-80.5,-79,-81,2
31,RR,1,100,4,-79.75,-78,-82,4
31,RR,0,100,1,-79,-79,-79,0
31,RR,1,100,9,-77.1111111111111,-70,-89,19
31,RR,1,100,9,-75.1111111111111,-70,-84,14
31,RR,1,100,8,-73,-70,-81,11
31,RR,0,100,1,-74,-74,-74,0
31,RR,1,100,6,-74.8333333333333,-73,-78,5
31,RR,1,100,8,-73.375,-70,-75,5
31,RR,1,100,8,-73.125,-70,-75,5
31,RR,1,100,3,-72,-69,-74,5
31,RR,1,100,7,-72,-71,-73,2
31,RR,0,100,2,-71.5,-71,-72,1
31,RR,0,100,1,-71,-71,-71,0
31,RR,1,100,3,-71.3333333333333,-70,-73,3
31,RR,1,100,9,-71,-68,-73,5
31,RR,1,100,7,-70.8571428571429,-68,-73,5
31,RR,1,100,8,-68.375,-66,-72,6
31,RR,1,100,5,-67.6,-66,-70,4
31,RR,0,100,1,-67,-67,-67,0
31,RR,0,100,2,-67.5,-67,-68,1
31,RR,1,100,4,-68.5,-67,-71,4
31,RR,1,100,3,-68.6666666666667,-67,-71,4
31,RR,1,100,3,-68.6666666666667,-67,-71,4
31,RR,1,100,6,-69.5,-68,-72,4
31,RR,1,100,5,-72.4,-67,-76,9
31,RR,1,100,7,-69.5714285714286,-67,-74,7
31,RR,1,100,6,-71.8333333333333,-67,-81,14
31,RR,1,100,7,-75.2857142857143,-68,-91,23
31,RR,0,100,1,-74,-74,-74,0
31,RR,1,100,9,-79.4444444444444,-74,-90,16
31,RR,1,100,7,-80.7142857142857,-74,-90,16
31,RR,1,100,9,-80.6666666666667,-72,-90,18
31,RR,1,100,8,-68.75,-65,-72,7
31,RR,1,100,5,-68.4,-67,-70,3
31,RR,1,100,10,-70.7,-67,-76,9
31,RR,1,100,6,-70.6666666666667,-67,-76,9
31,RR,0,100,1,-70,-70,-70,0
31,RR,1,100,4,-69.75,-67,-74,7
31,RR,1,100,10,-70.1,-67,-74,7
31,RR,1,100,4,-69.5,-68,-72,4
31,RR,1,100,7,-72.2857142857143,-70,-74,4
31,RR,1,100,7,-72.2857142857143,-70,-74,4
31,RR,1,100,6,-76.8333333333333,-61,-95,34
31,LL,1,100,8,-77.25,-75,-82,7
31,LL,0,100,2,-80,-78,-82,4
31,LL,1,100,7,-75.1428571428571,-72,-81,9
31,LL,0,100,1,-72,-72,-72,0
31,LL,1,100,3,-76.6666666666667,-75,-79,4
31,LL,1,100,3,-75.3333333333333,-72,-79,7
31,LL,1,100,8,-74,-72,-76,4
31,LL,1,100,8,-74.625,-73,-76,3
31,LL,1,100,5,-74,-73,-75,2
31,LL,1,100,7,-73.2857142857143,-72,-77,5
31,LL,1,100,5,-72,-71,-73,2
31,LL,0,100,2,-72.5,-71,-74,3
31,LL,0,100,1,-71,-71,-71,0
31,LL,1,100,4,-73,-71,-76,5
31,LL,1,100,6,-71.5,-71,-72,1
31,LL,1,100,10,-71.9,-70,-75,5
31,LL,1,100,6,-72.3333333333333,-70,-75,5
31,LL,1,100,8,-72.125,-70,-74,4
31,LL,1,100,10,-72.4,-71,-74,3
31,LL,1,100,10,-70.8,-70,-72,2
31,LL,1,100,6,-71.6666666666667,-71,-72,1
31,LL,1,100,5,-75,-73,-77,4
31,LL,1,100,4,-72.5,-70,-77,7
31,LL,1,100,4,-73.5,-70,-77,7
31,LL,1,100,5,-71.8,-71,-75,4
31,LL,1,100,7,-72.1428571428571,-71,-75,4
31,LL,1,100,8,-72.375,-71,-75,4
31,LL,1,100,7,-72.1428571428571,-71,-75,4
31,LL,0,100,2,-73,-71,-75,4
31,LL,1,100,7,-71.8571428571429,-71,-73,2
31,LL,1,100,7,-72,-71,-73,2
31,LL,1,100,5,-71.8,-71,-72,1
31,LL,1,100,6,-71.6666666666667,-71,-72,1
31,LL,1,100,7,-71,-70,-72,2
31,LL,1,100,5,-71.2,-70,-74,4
31,LL,1,100,6,-71.5,-71,-73,2
31,LL,1,100,5,-71.8,-71,-73,2
31,LL,1,100,9,-70.5555555555556,-70,-73,3
31,LL,1,100,7,-70.5714285714286,-70,-73,3
31,LL,1,100,6,-70,-70,-70,0
31,LL,1,100,7,-70.5714285714286,-70,-73,3
31,LL,1,100,3,-71,-70,-73,3
31,LL,1,100,5,-71,-70,-72,2
31,LL,1,100,4,-75.5,-72,-83,11
31,LL,1,100,7,-76.4285714285714,-72,-88,16
31,LL,1,100,9,-77.8888888888889,-72,-83,11
31,LL,1,100,4,-79.25,-72,-83,11
31,LL,1,100,8,-78.25,-72,-85,13
31,LL,1,100,3,-79.3333333333333,-73,-84,11
31,LL,0,100,1,-88,-88,-88,0
31,LL,1,100,6,-78.8333333333333,-73,-84,11
31,LL,1,100,6,-75.8333333333333,-73,-81,8
31,LL,1,100,8,-77.25,-71,-84,13
31,LL,0,100,1,-81,-81,-81,0
31,LL,1,100,5,-77,-72,-82,10
31,LL,1,100,8,-73.875,-71,-82,11
31,LL,1,100,4,-72,-71,-73,2
31,LL,1,100,8,-72.125,-70,-75,5
31,LL,1,100,10,-72.3,-70,-75,5
31,LL,1,100,4,-73,-72,-75,3
31,LL,1,100,9,-71.8888888888889,-70,-74,4
31,LL,1,100,5,-71.6,-70,-74,4
31,LL,1,100,6,-72.1666666666667,-70,-76,6
26,RR,1,100,9,-72.6666666666667,-66,-81,15
26,RR,1,100,3,-75.6666666666667,-72,-81,9
26,RR,1,100,3,-78.3333333333333,-74,-84,10
26,RR,1,100,7,-81,-73,-88,15
26,RR,1,100,7,-80.2857142857143,-74,-85,11
26,RR,1,100,4,-80.75,-74,-84,10
26,RR,0,100,2,-83.5,-83,-84,1
26,RR,1,100,6,-84.6666666666667,-79,-88,9
26,RR,0,100,2,-84.5,-81,-88,7
26,RR,1,100,8,-82.5,-75,-94,19
26,RR,1,100,4,-85.25,-75,-94,19
26,RR,0,100,2,-77.5,-76,-79,3
26,RR,1,100,7,-77.4285714285714,-74,-81,7
26,RR,1,100,3,-78.3333333333333,-77,-79,2
26,RR,1,100,4,-78.5,-77,-80,3
26,RR,1,100,5,-78.4,-76,-81,5
26,RR,1,100,4,-79,-78,-81,3
26,RR,1,100,4,-78,-75,-81,6
26,RR,1,100,4,-79.5,-75,-81,6
26,RR,0,100,1,-81,-81,-81,0
26,RR,1,100,9,-77.5555555555556,-74,-81,7
26,RR,1,100,8,-77.25,-74,-81,7
26,RR,1,100,6,-76.1666666666667,-73,-81,8
26,RR,0,100,2,-75.5,-74,-77,3
26,RR,1,100,6,-78.5,-76,-80,4
26,RR,1,100,6,-77,-74,-80,6
26,RR,0,100,2,-79,-78,-80,2
26,RR,1,100,6,-75.3333333333333,-73,-78,5
26,RR,1,100,6,-77,-74,-81,7
26,RR,0,100,1,-75,-75,-75,0
26,RR,1,100,8,-77.375,-73,-80,7
26,RR,1,100,10,-73.6,-68,-77,9
26,RR,1,100,7,-75,-72,-79,7
26,RR,0,100,1,-76,-76,-76,0
26,RR,1,100,3,-75.3333333333333,-75,-76,1
26,RR,1,100,8,-75.25,-71,-79,8
26,RR,0,100,1,-76,-76,-76,0
26,RR,1,100,4,-76.25,-74,-79,5
26,RR,0,100,2,-72.5,-72,-73,1
26,RR,0,100,1,-77,-77,-77,0
26,RR,0,100,1,-75,-75,-75,0
26,RR,1,100,3,-79,-76,-83,7
26,RR,1,100,5,-78.2,-75,-80,5
26,RR,1,100,7,-78.7142857142857,-76,-80,4
26,RR,1,100,8,-78.5,-76,-80,4
26,RR,1,100,7,-78.8571428571429,-76,-82,6
26,RR,1,100,8,-81.625,-77,-94,17
26,RR,1,100,5,-83.2,-77,-94,17
26,RR,0,100,1,-80,-80,-80,0
26,RR,0,100,2,-81.5,-81,-82,1
26,RR,0,100,1,-68,-68,-68,0
26,RR,0,100,2,-70.5,-70,-71,1
26,RR,1,100,3,-70,-70,-70,0
26,RR,1,100,10,-68.8,-66,-71,5
26,RR,0,100,2,-70,-70,-70,0
26,RR,1,100,7,-66.4285714285714,-64,-68,4
26,RR,0,100,2,-68,-67,-69,2
26,RR,1,100,7,-68.4285714285714,-67,-70,3
26,RR,0,100,2,-68.5,-67,-70,3
26,RR,1,100,8,-73,-70,-77,7
26,RR,1,100,6,-70.8333333333333,-66,-83,17
26,RR,1,100,3,-67.3333333333333,-66,-70,4
26,RR,1,100,10,-75.4,-66,-83,17
26,RR,1,100,3,-75.6666666666667,-70,-83,13
26,RR,1,100,5,-76.4,-72,-82,10
26,RR,1,100,5,-68.2,-66,-70,4
26,RR,1,100,7,-67.2857142857143,-63,-70,7
26,RR,1,100,8,-68,-63,-70,7
26,RR,1,100,5,-71.4,-68,-74,6
26,RR,0,100,1,-71,-71,-71,0
26,RR,1,100,10,-69,-66,-72,6
26,RR,0,100,1,-66,-66,-66,0
26,RR,1,100,4,-69.75,-68,-72,4
26,RR,0,100,1,-70,-70,-70,0
26,RR,1,100,4,-73.25,-59,-86,27
26,RR,1,100,6,-76.6666666666667,-59,-89,30
26,RR,1,100,5,-79.4,-73,-89,16
26,LL,1,100,8,-76.125,-74,-79,5
26,LL,1,100,7,-76.5714285714286,-73,-79,6
26,LL,1,100,8,-76,-73,-79,6
26,LL,0,100,2,-78.5,-78,-79,1
26,LL,1,100,10,-74.6,-71,-78,7
26,LL,0,100,1,-75,-75,-75,0
26,LL,1,100,7,-72.5714285714286,-71,-74,3
26,LL,0,100,1,-74,-74,-74,0
26,LL,0,100,1,-72,-72,-72,0
26,LL,1,100,3,-72.3333333333333,-72,-73,1
26,LL,1,100,6,-72.5,-72,-74,2
26,LL,1,100,7,-73.2857142857143,-71,-76,5
26,LL,1,100,7,-73.4285714285714,-69,-77,8
26,LL,1,100,3,-73.6666666666667,-69,-77,8
26,LL,1,100,10,-70.2,-69,-71,2
26,LL,1,100,9,-70.3333333333333,-69,-72,3
26,LL,1,100,8,-70.375,-69,-72,3
26,LL,1,100,5,-71,-70,-73,3
26,LL,1,100,7,-70.5714285714286,-70,-71,1
26,LL,1,100,5,-70.2,-70,-71,1
26,LL,1,100,7,-70.1428571428571,-69,-71,2
26,LL,1,100,9,-70.6666666666667,-70,-73,3
26,LL,1,100,9,-70.6666666666667,-70,-73,3
26,LL,1,100,3,-71.6666666666667,-71,-73,2
26,LL,0,100,2,-69.5,-69,-70,1
26,LL,1,100,5,-70.2,-70,-71,1
26,LL,1,100,5,-70.4,-70,-71,1
26,LL,0,100,2,-73.5,-73,-74,1
26,LL,1,100,8,-72.375,-71,-74,3
26,LL,1,100,10,-72.5,-71,-76,5
26,LL,1,100,4,-71.5,-71,-72,1
26,LL,1,100,10,-72.5,-70,-77,7
26,LL,0,100,2,-76.5,-76,-77,1
26,LL,1,100,9,-71.2222222222222,-70,-76,6
26,LL,1,100,5,-70.8,-70,-74,4
26,LL,1,100,10,-70.9,-70,-74,4
26,LL,1,100,3,-71.3333333333333,-70,-74,4
26,LL,1,100,10,-70.6,-70,-72,2
26,LL,1,100,7,-70.8571428571429,-70,-73,3
26,LL,1,100,3,-71.6666666666667,-70,-73,3
26,LL,1,100,3,-71,-70,-73,3
26,LL,0,100,2,-70,-70,-70,0
26,LL,1,100,3,-70,-70,-70,0
26,LL,1,100,4,-69.5,-69,-70,1
26,LL,1,100,6,-69.8333333333333,-68,-73,5
26,LL,0,100,1,-68,-68,-68,0
26,LL,1,100,7,-73,-70,-76,6
26,LL,0,100,2,-72,-72,-72,0
26,LL,1,100,8,-73.875,-71,-78,7
26,LL,1,100,8,-74.25,-72,-82,10
26,LL,1,100,4,-76.25,-72,-82,10
26,LL,0,100,1,-72,-72,-72,0
26,LL,1,100,6,-74.5,-72,-80,8
26,LL,1,100,3,-77,-72,-80,8
26,LL,0,100,2,-76,-72,-80,8
26,LL,1,100,10,-75.4,-72,-80,8
26,LL,0,100,1,-72,-72,-72,0
26,LL,1,100,8,-74.25,-70,-80,10
26,LL,0,100,2,-70.5,-70,-71,1
26,LL,1,100,6,-71.5,-70,-73,3
26,LL,1,100,6,-71.1666666666667,-70,-73,3
26,LL,1,100,9,-70.7777777777778,-69,-74,5
26,LL,1,100,10,-70.5,-69,-74,5
26,LL,1,100,4,-72,-70,-74,4
26,LL,1,100,10,-70.2,-69,-73,4
26,LL,1,100,9,-70.5555555555556,-69,-73,4
26,LL,1,100,3,-71,-70,-72,2
26,LL,1,100,9,-70.5555555555556,-69,-73,4
26,LL,1,100,3,-72.6666666666667,-71,-74,3
26,LL,1,100,9,-71.5555555555556,-67,-75,8
31,RR,1,150,8,-76.875,-71,-86,15
31,RR,1,150,7,-80.4285714285714,-77,-88,11
31,RR,1,150,5,-79.8,-77,-88,11
31,RR,1,150,10,-81.9,-75,-90,15
31,RR,1,150,3,-79.6666666666667,-75,-84,9
31,RR,1,150,9,-81.8888888888889,-76,-90,14
31,RR,1,150,5,-78.2,-76,-82,6
31,RR,1,150,5,-85,-77,-91,14
31,RR,1,150,3,-83.6666666666667,-78,-87,9
31,RR,0,150,1,-80,-80,-80,0
31,RR,1,150,7,-85.8571428571429,-78,-89,11
31,RR,1,150,3,-88.3333333333333,-88,-89,1
31,RR,1,150,3,-86.6666666666667,-85,-88,3
31,RR,1,150,10,-86.7,-79,-92,13
31,RR,1,150,9,-85.6666666666667,-80,-92,12
31,RR,0,150,2,-85.5,-84,-87,3
31,RR,0,150,1,-85,-85,-85,0
31,RR,1,150,8,-86,-82,-94,12
31,RR,1,150,10,-87.3,-78,-99,21
31,RR,1,150,6,-88.8333333333333,-82,-93,11
31,RR,0,150,1,-93,-93,-93,0
31,RR,1,150,7,-86,-82,-94,12
31,RR,1,150,5,-86.4,-82,-94,12
31,RR,1,150,9,-88.3333333333333,-84,-92,8
31,RR,0,150,2,-87,-85,-89,4
31,RR,1,150,8,-84.5,-79,-89,10
31,RR,1,150,5,-80.8,-79,-84,5
31,RR,1,150,3,-80,-79,-82,3
31,RR,1,150,8,-85,-80,-92,12
31,RR,1,150,4,-88.25,-84,-92,8
31,RR,1,150,9,-84.2222222222222,-78,-90,12
31,RR,1,150,6,-84.3333333333333,-78,-90,12
31,RR,1,150,6,-82.6666666666667,-78,-87,9
31,RR,1,150,5,-83.8,-81,-87,6
31,RR,0,150,1,-87,-87,-87,0
31,RR,1,150,9,-81.5555555555556,-76,-91,15
31,RR,1,150,6,-80.6666666666667,-76,-91,15
31,RR,1,150,5,-84.2,-80,-91,11
31,RR,0,150,2,-86,-84,-88,4
31,RR,1,150,4,-82.25,-80,-86,6
31,RR,1,150,3,-86.6666666666667,-83,-93,10
31,RR,1,150,8,-80,-78,-84,6
31,RR,1,150,8,-82.75,-78,-93,15
31,RR,1,150,3,-81.6666666666667,-79,-87,8
31,RR,0,150,1,-79,-79,-79,0
31,RR,0,150,2,-83.5,-83,-84,1
31,RR,1,150,8,-81.125,-74,-93,19
31,RR,1,150,8,-80.625,-74,-93,19
31,RR,1,150,9,-83.6666666666667,-74,-99,25
31,RR,1,150,10,-82.9,-74,-99,25
31,RR,1,150,6,-86,-80,-93,13
31,RR,1,150,6,-82.3333333333333,-80,-87,7
31,RR,1,150,9,-81.5555555555556,-78,-87,9
31,RR,1,150,3,-80,-79,-81,2
31,RR,1,150,3,-84,-79,-93,14
31,RR,0,150,1,-99,-99,-99,0
31,RR,1,150,4,-85,-79,-88,9
31,RR,1,150,5,-80.6,-78,-90,12
31,RR,1,150,5,-80,-77,-87,10
31,RR,1,150,8,-80.5,-77,-90,13
31,RR,1,150,3,-88.6666666666667,-86,-93,7
31,RR,1,150,10,-82.7,-78,-92,14
31,RR,1,150,8,-82.625,-78,-92,14
31,RR,1,150,4,-83.5,-80,-88,8
31,RR,1,150,8,-80.25,-78,-82,4
31,RR,0,150,1,-79,-79,-79,0
31,RR,1,150,6,-79.1666666666667,-74,-82,8
31,LL,1,150,3,-77.6666666666667,-76,-79,3
31,LL,0,150,1,-79,-79,-79,0
31,LL,0,150,2,-79,-75,-83,8
31,LL,0,150,1,-75,-75,-75,0
31,LL,1,150,8,-82.875,-79,-88,9
31,LL,1,150,10,-83.3,-80,-88,8
31,LL,1,150,7,-81.5714285714286,-80,-83,3
31,LL,0,150,2,-85.5,-82,-89,7
31,LL,1,150,7,-84,-81,-89,8
31,LL,1,150,3,-83.3333333333333,-82,-84,2
31,LL,1,150,6,-90,-83,-92,9
31,LL,1,150,5,-92,-90,-95,5
31,LL,0,150,1,-94,-94,-94,0
31,LL,1,150,7,-89.5714285714286,-86,-101,15
31,LL,1,150,4,-87.5,-86,-89,3
31,LL,1,150,3,-88.6666666666667,-86,-93,7
31,LL,0,150,1,-93,-93,-93,0
31,LL,0,150,1,-90,-90,-90,0
31,LL,1,150,7,-90.2857142857143,-86,-94,8
31,LL,1,150,8,-85.625,-80,-93,13
31,LL,1,150,5,-85.6,-82,-90,8
31,LL,1,150,10,-82.7,-80,-88,8
31,LL,1,150,6,-82.6666666666667,-80,-86,6
31,LL,1,150,9,-80.7777777777778,-77,-86,9
31,LL,0,150,1,-76,-76,-76,0
31,LL,1,150,10,-75.7,-74,-77,3
31,LL,1,150,9,-76.1111111111111,-74,-77,3
31,LL,1,150,6,-76.5,-76,-77,1
31,LL,1,150,7,-87.1428571428571,-82,-90,8
31,LL,1,150,4,-88.75,-87,-90,3
31,LL,1,150,8,-84.625,-80,-90,10
31,LL,1,150,4,-81.25,-79,-84,5
31,LL,1,150,5,-76.4,-74,-78,4
31,LL,1,150,10,-75.3,-74,-79,5
31,LL,0,150,2,-75.5,-74,-77,3
31,LL,1,150,5,-76.4,-74,-79,5
31,LL,1,150,7,-74.1428571428571,-66,-78,12
31,LL,1,150,5,-73.6,-66,-78,12
31,LL,1,150,4,-72.5,-66,-77,11
31,LL,1,150,6,-69.6666666666667,-65,-76,11
31,LL,1,150,6,-75.1666666666667,-69,-78,9
31,LL,1,150,5,-74,-72,-78,6
31,LL,1,150,6,-75.1666666666667,-74,-76,2
31,LL,1,150,5,-75.8,-74,-77,3
31,LL,1,150,3,-76,-76,-76,0
31,LL,0,150,2,-76.5,-76,-77,1
31,LL,1,150,10,-78.7,-77,-80,3
31,LL,1,150,10,-79,-78,-80,2
31,LL,1,150,10,-79.1,-78,-80,2
31,LL,1,150,8,-79.75,-79,-81,2
31,LL,0,150,1,-79,-79,-79,0
31,LL,1,150,5,-79.4,-79,-81,2
31,LL,1,150,8,-79.25,-78,-81,3
31,LL,0,150,1,-78,-78,-78,0
31,LL,1,150,10,-76.3,-73,-82,9
31,LL,1,150,7,-76.5714285714286,-73,-82,9
31,LL,0,150,2,-75.5,-75,-76,1
31,LL,1,150,10,-74.4,-71,-76,5
31,LL,1,150,8,-74.125,-72,-77,5
31,LL,1,150,5,-73.6,-72,-77,5
31,LL,1,150,7,-74.5714285714286,-72,-77,5
31,LL,1,150,5,-73.6,-72,-76,4
31,LL,0,150,2,-72,-72,-72,0
31,LL,1,150,10,-73.8,-71,-77,6
31,LL,1,150,9,-73.5555555555556,-71,-77,6
31,LL,1,150,4,-72.75,-72,-73,1
31,LL,0,150,2,-72.5,-72,-73,1
31,LL,1,150,10,-73.9,-71,-77,6
31,LL,1,150,4,-73.5,-71,-76,5
31,LL,1,150,7,-74.1428571428571,-71,-77,6
31,LL,1,150,9,-73.2222222222222,-71,-77,6
31,LL,1,150,4,-70.25,-67,-77,10
26,RR,0,150,1,-70,-70,-70,0
26,RR,0,150,1,-76,-76,-76,0
26,RR,1,150,4,-76,-74,-77,3
26,RR,1,150,7,-79.7142857142857,-75,-87,12
26,RR,1,150,7,-80.5714285714286,-75,-88,13
26,RR,0,150,1,-82,-82,-82,0
26,RR,0,150,2,-80,-75,-85,10
26,RR,1,150,6,-84.8333333333333,-83,-87,4
26,RR,0,150,1,-85,-85,-85,0
26,RR,1,150,9,-84.5555555555556,-79,-88,9
26,RR,1,150,9,-83.8888888888889,-77,-88,11
26,RR,0,150,2,-84.5,-84,-85,1
26,RR,0,150,1,-86,-86,-86,0
26,RR,0,150,2,-88.5,-87,-90,3
26,RR,1,150,6,-87.8333333333333,-81,-95,14
26,RR,1,150,3,-79,-77,-83,6
26,RR,1,150,7,-86.7142857142857,-78,-91,13
26,RR,0,150,2,-89,-88,-90,2
26,RR,1,150,4,-82.75,-80,-86,6
26,RR,1,150,10,-83.1,-75,-93,18
26,RR,1,150,7,-85.4285714285714,-81,-91,10
26,RR,1,150,4,-82.75,-78,-90,12
26,RR,1,150,6,-79.1666666666667,-76,-83,7
26,RR,0,150,2,-79,-77,-81,4
26,RR,1,150,6,-87,-81,-93,12
26,RR,1,150,5,-83,-77,-93,16
26,RR,1,150,10,-85.8,-77,-95,18
26,RR,1,150,4,-81.75,-77,-92,15
26,RR,1,150,6,-85.5,-80,-91,11
26,RR,1,150,5,-84.2,-80,-91,11
26,RR,1,150,6,-84.6666666666667,-80,-91,11
26,RR,1,150,7,-86.7142857142857,-80,-91,11
26,RR,1,150,7,-86.1428571428571,-80,-88,8
26,RR,1,150,7,-86.4285714285714,-80,-90,10
26,RR,1,150,10,-87.5,-84,-90,6
26,RR,1,150,6,-88.3333333333333,-87,-90,3
26,RR,1,150,3,-82.3333333333333,-76,-87,11
26,RR,1,150,7,-81.8571428571429,-76,-88,12
26,RR,1,150,4,-78.75,-76,-83,7
26,RR,1,150,5,-83.2,-81,-87,6
26,RR,1,150,7,-82.7142857142857,-80,-87,7
26,RR,1,150,9,-82.4444444444444,-78,-91,13
26,RR,1,150,4,-80.25,-75,-86,11
26,RR,1,150,9,-82.3333333333333,-78,-88,10
26,RR,0,150,1,-82,-82,-82,0
26,RR,1,150,7,-82.8571428571429,-78,-88,10
26,RR,1,150,10,-81.3,-78,-84,6
26,RR,0,150,1,-79,-79,-79,0
26,RR,1,150,10,-82.6,-78,-88,10
26,RR,0,150,1,-78,-78,-78,0
26,RR,1,150,5,-82.4,-80,-87,7
26,RR,1,150,8,-79.75,-76,-86,10
26,RR,1,150,8,-79.25,-75,-86,11
26,RR,1,150,6,-78.1666666666667,-75,-83,8
26,RR,1,150,6,-79.3333333333333,-75,-83,8
26,RR,1,150,8,-80.5,-75,-86,11
26,RR,1,150,5,-82.8,-80,-86,6
26,RR,1,150,8,-80.875,-78,-86,8
26,RR,1,150,7,-79.5714285714286,-76,-86,10
26,RR,1,150,8,-80.75,-76,-87,11
26,RR,0,150,2,-82,-78,-86,8
26,RR,0,150,2,-83.5,-81,-86,5
26,RR,1,150,10,-80.5,-76,-87,11
26,RR,1,150,6,-81.5,-79,-87,8
26,RR,1,150,5,-82,-79,-89,10
26,RR,1,150,9,-80.3333333333333,-76,-87,11
26,RR,0,150,1,-87,-87,-87,0
26,RR,1,150,4,-80.5,-77,-83,6
26,RR,1,150,8,-81,-73,-90,17
26,RR,1,150,7,-83.4285714285714,-78,-93,15
26,RR,1,150,3,-88.3333333333333,-80,-93,13
26,RR,1,150,8,-81.5,-77,-93,16
26,RR,1,150,5,-80.8,-79,-84,5
26,RR,1,150,3,-84,-80,-91,11
26,RR,1,150,5,-86.2,-75,-99,24
26,RR,1,150,9,-82.6666666666667,-75,-95,20
26,RR,1,150,9,-82.7777777777778,-75,-95,20
26,RR,1,150,8,-82.75,-76,-90,14
26,RR,0,150,1,-76,-76,-76,0
26,LL,1,150,8,-80.75,-74,-88,14
26,LL,1,150,3,-79,-74,-82,8
26,LL,1,150,9,-81.3333333333333,-76,-85,9
26,LL,1,150,8,-82.25,-73,-90,17
26,LL,1,150,10,-76.2,-73,-83,10
26,LL,0,150,1,-76,-76,-76,0
26,LL,1,150,9,-80.2222222222222,-74,-86,12
26,LL,0,150,2,-82.5,-79,-86,7
26,LL,1,150,4,-82.75,-80,-86,6
26,LL,0,150,1,-83,-83,-83,0
26,LL,1,150,7,-82.5714285714286,-79,-91,12
26,LL,1,150,8,-83.75,-79,-91,12
26,LL,1,150,7,-83.2857142857143,-80,-89,9
26,LL,1,150,4,-82.75,-81,-84,3
26,LL,1,150,6,-87.6666666666667,-82,-91,9
26,LL,1,150,5,-89.6,-85,-92,7
26,LL,1,150,8,-89.125,-86,-92,6
26,LL,1,150,7,-88.4285714285714,-86,-92,6
26,LL,1,150,7,-87,-84,-96,12
26,LL,1,150,7,-88.7142857142857,-84,-98,14
26,LL,0,150,1,-96,-96,-96,0
26,LL,1,150,3,-91.3333333333333,-85,-95,10
26,LL,1,150,4,-88,-86,-94,8
26,LL,1,150,3,-86.6666666666667,-83,-92,9
26,LL,1,150,8,-88.5,-85,-92,7
26,LL,0,150,2,-90.5,-90,-91,1
26,LL,1,150,4,-88.5,-85,-91,6
26,LL,1,150,7,-81.7142857142857,-79,-84,5
26,LL,1,150,9,-81.6666666666667,-80,-84,4
26,LL,1,150,4,-81,-80,-83,3
26,LL,1,150,8,-82.125,-80,-87,7
26,LL,1,150,7,-82,-81,-87,6
26,LL,1,150,10,-82.3,-78,-88,10
26,LL,0,150,2,-80.5,-80,-81,1
26,LL,1,150,8,-82.375,-77,-87,10
26,LL,1,150,3,-83,-79,-87,8
26,LL,1,150,6,-79.3333333333333,-75,-83,8
26,LL,1,150,6,-75,-74,-76,2
26,LL,1,150,8,-74.125,-73,-76,3
26,LL,1,150,5,-74.8,-74,-75,1
26,LL,1,150,5,-76,-75,-77,2
26,LL,1,150,3,-76.6666666666667,-75,-79,4
26,LL,1,150,10,-84.4,-78,-92,14
26,LL,0,150,1,-83,-83,-83,0
26,LL,0,150,1,-86,-86,-86,0
26,LL,0,150,1,-92,-92,-92,0
26,LL,1,150,3,-84.3333333333333,-83,-86,3
26,LL,1,150,3,-74.3333333333333,-73,-77,4
26,LL,1,150,4,-75,-73,-79,6
26,LL,1,150,8,-75.75,-73,-78,5
26,LL,0,150,1,-75,-75,-75,0
26,LL,1,150,8,-74.5,-73,-76,3
26,LL,1,150,9,-74.7777777777778,-73,-76,3
26,LL,1,150,5,-72.6,-66,-76,10
26,LL,1,150,9,-69.8888888888889,-64,-79,15
26,LL,0,150,1,-74,-74,-74,0
26,LL,1,150,10,-72.6,-71,-76,5
26,LL,1,150,6,-71.5,-71,-73,2
26,LL,1,150,3,-73,-71,-75,4
26,LL,1,150,4,-73.25,-73,-74,1
26,LL,1,150,4,-74,-74,-74,0
26,LL,1,150,10,-76.4,-74,-79,5
26,LL,0,150,2,-79,-79,-79,0
26,LL,1,150,10,-78.5,-76,-81,5
26,LL,1,150,4,-77.75,-77,-79,2
26,LL,1,150,10,-79.3,-78,-81,3
26,LL,1,150,7,-78.8571428571429,-78,-81,3
26,LL,1,150,5,-78.2,-78,-79,1
26,LL,1,150,6,-78.6666666666667,-78,-80,2
26,LL,0,150,1,-78,-78,-78,0
26,LL,0,150,1,-78,-78,-78,0
26,LL,1,150,5,-78,-77,-79,2
26,LL,1,150,6,-77.8333333333333,-77,-79,2
26,LL,1,150,8,-77.75,-77,-80,3
26,LL,1,150,9,-78,-77,-80,3
26,LL,1,150,5,-78.2,-77,-79,2
26,LL,1,150,4,-78,-77,-79,2
26,LL,1,150,7,-77.4285714285714,-73,-80,7
26,LL,0,150,2,-78,-77,-79,2
26,LL,1,150,5,-76.8,-73,-80,7
26,LL,0,150,1,-75,-75,-75,0
26,LL,1,150,10,-73.1,-71,-75,4
26,LL,1,150,7,-72.8571428571429,-71,-75,4
26,LL,1,150,6,-72.3333333333333,-71,-75,4
26,LL,0,150,1,-71,-71,-71,0
26,LL,1,150,4,-72.25,-71,-74,3
26,LL,0,150,2,-73,-72,-74,2
26,LL,1,150,9,-73.1111111111111,-71,-76,5
26,LL,1,150,10,-71.8,-70,-76,6
26,LL,0,150,1,-70,-70,-70,0
26,LL,1,150,10,-71.1,-70,-75,5
26,LL,1,150,10,-71.2,-70,-75,5
26,LL,1,150,9,-71.4444444444444,-70,-75,5
26,LL,1,150,8,-71.5,-70,-75,5
26,LL,1,150,10,-75.4,-70,-84,14
26,LL,0,150,2,-72.5,-72,-73,1
26,LL,1,150,8,-71.5,-70,-75,5
26,LL,1,150,4,-76.25,-70,-84,14
26,LL,1,150,6,-78.6666666666667,-70,-84,14
31,RR,1,200,9,-76.4444444444444,-73,-80,7
31,RR,1,200,4,-76.75,-75,-78,3
31,RR,1,200,5,-75.8,-74,-79,5
31,RR,1,200,7,-74.4285714285714,-73,-75,2
31,RR,0,200,2,-75,-75,-75,0
31,RR,0,200,1,-75,-75,-75,0
31,RR,1,200,10,-80.9,-75,-89,14
31,RR,1,200,4,-81.25,-78,-88,10
31,RR,1,200,4,-82.5,-78,-88,10
31,RR,1,200,3,-81,-77,-89,12
31,RR,1,200,3,-85.6666666666667,-77,-91,14
31,RR,1,200,4,-80.75,-77,-91,14
31,RR,1,200,4,-80.75,-77,-91,14
31,RR,1,200,4,-78.5,-77,-83,6
31,RR,0,200,1,-96,-96,-96,0
31,RR,0,200,2,-85.5,-79,-92,13
31,RR,1,200,3,-76,-75,-77,2
31,RR,1,200,8,-77.75,-74,-88,14
31,RR,1,200,8,-80.375,-78,-82,4
31,RR,1,200,8,-80.625,-78,-84,6
31,RR,1,200,4,-79.75,-78,-82,4
31,RR,0,200,2,-80.5,-79,-82,3
31,RR,1,200,6,-81.8333333333333,-80,-84,4
31,RR,1,200,7,-82.5714285714286,-80,-86,6
31,RR,1,200,9,-85.1111111111111,-80,-95,15
31,RR,1,200,5,-86.4,-80,-95,15
31,RR,1,200,5,-81.6,-80,-87,7
31,RR,1,200,10,-84.5,-78,-92,14
31,RR,1,200,6,-85.5,-78,-92,14
31,RR,1,200,10,-81.7,-78,-88,10
31,RR,1,200,10,-81.4,-78,-88,10
31,RR,1,200,9,-80.8888888888889,-78,-88,10
31,RR,1,200,8,-83.625,-78,-90,12
31,RR,1,200,5,-82.8,-78,-88,10
31,RR,1,200,6,-82,-78,-90,12
31,RR,1,200,3,-79.6666666666667,-78,-82,4
31,RR,1,200,9,-80.3333333333333,-77,-85,8
31,RR,1,200,7,-81.5714285714286,-80,-84,4
31,RR,0,200,2,-82,-80,-84,4
31,RR,0,200,1,-81,-81,-81,0
31,RR,1,200,7,-82.7142857142857,-79,-86,7
31,RR,0,200,1,-82,-82,-82,0
31,RR,1,200,5,-81.2,-79,-83,4
31,RR,1,200,5,-84.6,-83,-86,3
31,RR,0,200,2,-82.5,-79,-86,7
31,RR,1,200,7,-83,-78,-92,14
31,RR,0,200,1,-82,-82,-82,0
31,RR,1,200,9,-84.5555555555556,-79,-99,20
31,RR,1,200,10,-85.9,-78,-101,23
31,RR,1,200,9,-86.6666666666667,-78,-101,23
31,RR,1,200,9,-80.2222222222222,-75,-87,12
31,RR,1,200,7,-81.5714285714286,-77,-88,11
31,RR,1,200,5,-80.4,-77,-88,11
31,RR,1,200,3,-91.6666666666667,-88,-96,8
31,RR,1,200,6,-89,-83,-96,13
31,RR,0,200,1,-91,-91,-91,0
31,RR,1,200,5,-85.4,-81,-92,11
31,RR,1,200,6,-85.3333333333333,-81,-92,11
31,RR,1,200,4,-83,-81,-87,6
31,RR,1,200,6,-79.1666666666667,-77,-83,6
31,RR,1,200,6,-79.6666666666667,-77,-84,7
31,RR,1,200,5,-83,-78,-86,8
31,RR,0,200,2,-81,-78,-84,6
31,RR,1,200,5,-82.6,-79,-86,7
31,RR,1,200,10,-81.3,-77,-89,12
31,RR,1,200,3,-82.6666666666667,-79,-89,10
31,RR,1,200,7,-85.4285714285714,-82,-89,7
31,RR,0,200,1,-85,-85,-85,0
31,RR,1,200,6,-83.6666666666667,-83,-84,1
31,RR,1,200,5,-83,-81,-84,3
31,RR,1,200,7,-82.8571428571429,-81,-85,4
31,RR,1,200,7,-82.5714285714286,-80,-87,7
31,RR,1,200,8,-82.75,-79,-87,8
31,RR,1,200,10,-82.7,-79,-87,8
31,RR,0,200,2,-80.5,-79,-82,3
31,RR,1,200,5,-88.2,-82,-93,11
31,RR,1,200,8,-89.125,-84,-98,14
31,RR,1,200,5,-87.6,-85,-93,8
31,RR,1,200,8,-86.125,-79,-93,14
31,RR,0,200,2,-81.5,-79,-84,5
31,RR,1,200,8,-84,-79,-90,11
31,LL,0,200,1,-75,-75,-75,0
31,LL,1,200,10,-79.3,-77,-82,5
31,LL,1,200,6,-79.8333333333333,-77,-84,7
31,LL,1,200,4,-79.5,-77,-84,7
31,LL,1,200,7,-78.8571428571429,-77,-82,5
31,LL,1,200,6,-81.5,-79,-85,6
31,LL,1,200,10,-83,-81,-86,5
31,LL,1,200,3,-83,-82,-85,3
31,LL,1,200,10,-82.5,-78,-86,8
31,LL,1,200,6,-81.1666666666667,-78,-84,6
31,LL,1,200,5,-81,-78,-84,6
31,LL,1,200,10,-80.6,-78,-84,6
31,LL,0,200,2,-81.5,-80,-83,3
31,LL,1,200,4,-85,-82,-90,8
31,LL,1,200,6,-87,-82,-94,12
31,LL,1,200,7,-85.4285714285714,-82,-90,8
31,LL,1,200,6,-84.6666666666667,-82,-88,6
31,LL,1,200,3,-85.3333333333333,-82,-88,6
31,LL,1,200,8,-84.625,-83,-87,4
31,LL,1,200,3,-85,-83,-87,4
31,LL,1,200,8,-84.25,-83,-88,5
31,LL,1,200,4,-83.25,-82,-84,2
31,LL,1,200,10,-85.1,-82,-88,6
31,LL,0,200,2,-83.5,-83,-84,1
31,LL,1,200,8,-84.375,-80,-88,8
31,LL,1,200,8,-85.5,-80,-90,10
31,LL,1,200,4,-86.75,-86,-88,2
31,LL,0,200,1,-86,-86,-86,0
31,LL,0,200,1,-87,-87,-87,0
31,LL,1,200,4,-90.5,-88,-96,8
31,LL,1,200,9,-86.7777777777778,-84,-96,12
31,LL,0,200,2,-85.5,-85,-86,1
31,LL,1,200,5,-85.4,-84,-86,2
31,LL,0,200,2,-85,-84,-86,2
31,LL,1,200,10,-85,-83,-88,5
31,LL,1,200,7,-85,-83,-87,4
31,LL,1,200,8,-84.25,-82,-87,5
31,LL,1,200,7,-85.4285714285714,-83,-92,9
31,LL,1,200,3,-87.3333333333333,-83,-92,9
31,LL,1,200,9,-84.8888888888889,-82,-92,10
31,LL,1,200,9,-84.3333333333333,-82,-86,4
31,LL,1,200,3,-86,-86,-86,0
31,LL,1,200,8,-85.25,-84,-87,3
31,LL,1,200,3,-85.3333333333333,-84,-87,3
31,LL,1,200,3,-83.6666666666667,-82,-86,4
31,LL,1,200,10,-85.3,-78,-91,13
31,LL,0,200,2,-85.5,-80,-91,11
31,LL,1,200,5,-80.2,-77,-85,8
31,LL,1,200,8,-80.125,-77,-85,8
31,LL,1,200,8,-79.125,-77,-82,5
31,LL,1,200,5,-78.8,-77,-82,5
31,LL,0,200,2,-79.5,-77,-82,5
31,LL,0,200,2,-78.5,-78,-79,1
31,LL,0,200,2,-81.5,-81,-82,1
31,LL,1,200,5,-81.4,-80,-82,2
31,LL,1,200,10,-77.8,-73,-97,24
31,LL,1,200,4,-76.25,-75,-78,3
31,LL,1,200,9,-77.5555555555556,-74,-81,7
31,LL,1,200,9,-78.5555555555556,-75,-81,6
31,LL,1,200,3,-79.3333333333333,-78,-81,3
31,LL,0,200,2,-77.5,-75,-80,5
31,LL,1,200,8,-77.875,-76,-81,5
31,LL,0,200,1,-76,-76,-76,0
31,LL,1,200,10,-77.6,-74,-83,9
31,LL,0,200,1,-76,-76,-76,0
31,LL,1,200,9,-77.3333333333333,-74,-83,9
31,LL,1,200,9,-77.4444444444444,-74,-86,12
31,LL,1,200,7,-76.4285714285714,-74,-82,8
31,LL,1,200,4,-74.75,-74,-76,2
31,LL,1,200,10,-77.7,-74,-86,12
26,RR,1,200,6,-78.6666666666667,-70,-85,15
26,RR,1,200,9,-76.3333333333333,-71,-80,9
26,RR,0,200,2,-75,-71,-79,8
26,RR,1,200,10,-75.8,-72,-80,8
26,RR,1,200,5,-73.4,-73,-75,2
26,RR,1,200,5,-75.8,-74,-78,4
26,RR,1,200,4,-73.5,-73,-74,1
26,RR,1,200,6,-75.5,-74,-78,4
26,RR,0,200,1,-74,-74,-74,0
26,RR,1,200,6,-74.6666666666667,-73,-78,5
26,RR,1,200,10,-77.7,-74,-80,6
26,RR,1,200,4,-77.5,-76,-80,4
26,RR,0,200,2,-78,-74,-82,8
26,RR,1,200,7,-79.5714285714286,-75,-87,12
26,RR,1,200,10,-77.4,-74,-80,6
26,RR,1,200,7,-77,-74,-80,6
26,RR,0,200,1,-73,-73,-73,0
26,RR,1,200,8,-78.75,-74,-90,16
26,RR,1,200,10,-81.1,-73,-95,22
26,RR,0,200,2,-83,-76,-90,14
26,RR,1,200,4,-76.75,-73,-85,12
26,RR,1,200,3,-87,-80,-91,11
26,RR,1,200,4,-81.75,-79,-85,6
26,RR,1,200,8,-84.5,-75,-92,17
26,RR,1,200,8,-84.875,-75,-92,17
26,RR,1,200,3,-89.3333333333333,-86,-92,6
26,RR,1,200,5,-85.2,-79,-95,16
26,RR,1,200,4,-83.5,-81,-86,5
26,RR,1,200,5,-81.4,-77,-85,8
26,RR,1,200,7,-80.8571428571429,-76,-88,12
26,RR,1,200,4,-80,-76,-88,12
26,RR,0,200,1,-80,-80,-80,0
26,RR,0,200,2,-77.5,-77,-78,1
26,RR,0,200,2,-81.5,-81,-82,1
26,RR,1,200,3,-77.6666666666667,-75,-80,5
26,RR,1,200,9,-80.4444444444444,-75,-83,8
26,RR,1,200,8,-79.875,-76,-84,8
26,RR,0,200,1,-79,-79,-79,0
26,RR,1,200,10,-85,-80,-90,10
26,RR,0,200,2,-86.5,-84,-89,5
26,RR,1,200,8,-84.125,-79,-90,11
26,RR,1,200,10,-83.3,-78,-92,14
26,RR,1,200,5,-82.6,-80,-87,7
26,RR,1,200,10,-82.3,-77,-88,11
26,RR,1,200,5,-86.4,-81,-96,15
26,RR,1,200,6,-85,-82,-95,13
26,RR,0,200,2,-84.5,-84,-85,1
26,RR,1,200,8,-86.125,-77,-95,18
26,RR,0,200,2,-76,-76,-76,0
26,RR,1,200,4,-82,-77,-90,13
26,RR,1,200,10,-85.6,-80,-94,14
26,RR,1,200,9,-85.1111111111111,-80,-94,14
26,RR,1,200,10,-80.2,-75,-85,10
26,RR,1,200,10,-80.1,-75,-84,9
26,RR,0,200,2,-87.5,-79,-96,17
26,RR,1,200,10,-83.1,-78,-90,12
26,RR,1,200,7,-83.2857142857143,-82,-84,2
26,RR,1,200,8,-82.5,-78,-87,9
26,RR,1,200,9,-82.1111111111111,-78,-87,9
26,RR,1,200,7,-82.7142857142857,-79,-88,9
26,RR,1,200,5,-87.6,-85,-91,6
26,RR,1,200,6,-89.3333333333333,-84,-97,13
26,RR,0,200,2,-86,-84,-88,4
26,RR,0,200,1,-88,-88,-88,0
26,RR,1,200,7,-84.4285714285714,-78,-93,15
26,RR,1,200,10,-76.3,-67,-88,21
26,RR,1,200,10,-78.4,-67,-93,26
26,LL,1,200,6,-77.3333333333333,-74,-83,9
26,LL,1,200,6,-79,-77,-83,6
26,LL,1,200,10,-79.9,-78,-90,12
26,LL,0,200,2,-79,-78,-80,2
26,LL,1,200,4,-78.75,-78,-80,2
26,LL,1,200,8,-77.5,-76,-79,3
26,LL,1,200,6,-77.1666666666667,-74,-79,5
26,LL,1,200,6,-77,-74,-78,4
26,LL,1,200,6,-79.6666666666667,-77,-82,5
26,LL,1,200,10,-80.2,-77,-84,7
26,LL,1,200,7,-80.4285714285714,-79,-84,5
26,LL,1,200,3,-79.6666666666667,-79,-80,1
26,LL,1,200,3,-79.3333333333333,-79,-80,1
26,LL,1,200,3,-78,-76,-79,3
26,LL,1,200,10,-80.7,-79,-86,7
26,LL,0,200,2,-80,-80,-80,0
26,LL,1,200,7,-81.2857142857143,-79,-86,7
26,LL,1,200,6,-81.5,-79,-86,7
26,LL,1,200,10,-82.9,-78,-87,9
26,LL,0,200,2,-83.5,-82,-85,3
26,LL,1,200,4,-83.75,-78,-87,9
26,LL,1,200,4,-88.75,-86,-95,9
26,LL,1,200,10,-86.7,-83,-95,12
26,LL,1,200,7,-87.2857142857143,-83,-95,12
26,LL,1,200,9,-85.7777777777778,-83,-91,8
26,LL,1,200,7,-84.1428571428571,-82,-87,5
26,LL,1,200,8,-83.875,-82,-87,5
26,LL,1,200,10,-83.2,-81,-87,6
26,LL,1,200,3,-83,-81,-84,3
26,LL,1,200,8,-85,-82,-90,8
26,LL,1,200,7,-86,-84,-88,4
26,LL,1,200,5,-85.8,-84,-88,4
26,LL,1,200,8,-84.625,-82,-88,6
26,LL,1,200,8,-84.25,-82,-88,6
26,LL,1,200,8,-83.5,-82,-86,4
26,LL,1,200,10,-83.7,-82,-87,5
26,LL,1,200,7,-83.4285714285714,-83,-84,1
26,LL,1,200,4,-83,-82,-84,2
26,LL,0,200,2,-82.5,-82,-83,1
26,LL,1,200,8,-83.875,-82,-87,5
26,LL,0,200,2,-82.5,-81,-84,3
26,LL,1,200,8,-83.125,-81,-86,5
26,LL,1,200,7,-83.4285714285714,-82,-85,3
26,LL,1,200,3,-84.3333333333333,-84,-85,1
26,LL,1,200,9,-84.3333333333333,-82,-86,4
26,LL,0,200,2,-84.5,-83,-86,3
26,LL,1,200,6,-83.3333333333333,-80,-85,5
26,LL,1,200,8,-82.5,-80,-85,5
26,LL,1,200,10,-81.7,-79,-83,4
26,LL,0,200,2,-82,-81,-83,2
26,LL,0,200,2,-84,-81,-87,6
26,LL,1,200,5,-83.2,-79,-88,9
26,LL,1,200,9,-84,-76,-95,19
26,LL,1,200,5,-83.2,-77,-88,11
26,LL,1,200,9,-79.1111111111111,-77,-82,5
26,LL,1,200,10,-79.5,-77,-81,4
26,LL,1,200,7,-79.8571428571429,-77,-81,4
26,LL,0,200,2,-80.5,-80,-81,1
26,LL,1,200,7,-78.1428571428571,-76,-81,5
26,LL,1,200,9,-77.1111111111111,-75,-81,6
26,LL,0,200,1,-81,-81,-81,0
26,LL,0,200,1,-77,-77,-77,0
26,LL,1,200,5,-73,-72,-74,2
26,LL,1,200,9,-74.2222222222222,-73,-78,5
26,LL,1,200,8,-76.125,-73,-80,7
26,LL,1,200,3,-74.6666666666667,-73,-76,3
26,LL,1,200,4,-78.5,-77,-80,3
26,LL,0,200,1,-76,-76,-76,0
26,LL,1,200,8,-76.125,-74,-79,5
26,LL,1,200,9,-76.4444444444444,-73,-79,6
26,LL,1,200,7,-76.5714285714286,-74,-79,5
26,LL,1,200,10,-75.7,-73,-79,6
26,LL,1,200,8,-76.25,-75,-77,2
26,LL,0,200,2,-76,-76,-76,0
26,LL,0,200,2,-76.5,-76,-77,1
26,LL,1,200,9,-76.4444444444444,-73,-82,9
26,LL,0,200,1,-72,-72,-72,0
26,LL,0,200,1,-74,-74,-74,0
26,LL,0,200,2,-77,-72,-82,10
31,RR,0,250,2,-73.5,-71,-76,5
31,RR,0,250,7,-72.1428571428571,-68,-84,16
31,RR,0,250,1,-72,-72,-72,0
31,RR,1,250,9,-71.7777777777778,-70,-74,4
31,RR,0,250,3,-72.3333333333333,-72,-73,1
31,RR,0,250,1,-72,-72,-72,0
31,RR,0,250,5,-73.6,-69,-81,12
31,RR,0,250,3,-76.6666666666667,-73,-79,6
31,RR,0,250,1,-86,-86,-86,0
31,RR,0,250,5,-79,-73,-82,9
31,RR,1,250,10,-81.1,-73,-90,17
31,RR,1,250,10,-79,-76,-85,9
31,RR,0,250,7,-78.7142857142857,-76,-85,9
31,RR,0,250,7,-79.1428571428571,-74,-85,11
31,RR,0,250,5,-79.4,-74,-85,11
31,RR,0,250,3,-79.6666666666667,-74,-85,11
31,RR,0,250,3,-82.3333333333333,-80,-85,5
31,RR,0,250,4,-84.25,-81,-90,9
31,RR,0,250,6,-81.1666666666667,-78,-83,5
31,RR,0,250,5,-80.2,-75,-87,12
31,RR,0,250,3,-81.6666666666667,-75,-87,12
31,RR,0,250,3,-83,-79,-87,8
31,RR,1,250,10,-79.9,-72,-90,18
31,RR,0,250,5,-79.2,-74,-83,9
31,RR,0,250,7,-82,-79,-90,11
31,RR,0,250,6,-82.8333333333333,-80,-90,10
31,RR,0,250,2,-80.5,-80,-81,1
31,RR,0,250,5,-86.2,-86,-87,1
31,RR,0,250,2,-86.5,-86,-87,1
31,RR,0,250,6,-87.5,-83,-97,14
31,RR,0,250,8,-86.125,-83,-92,9
31,RR,0,250,8,-84.375,-78,-92,14
31,RR,0,250,4,-90.5,-84,-98,14
31,RR,0,250,1,-98,-98,-98,0
31,RR,0,250,6,-84.5,-79,-90,11
31,RR,0,250,2,-84.5,-79,-90,11
31,RR,0,250,8,-88.25,-82,-97,15
31,RR,0,250,2,-84.5,-84,-85,1
31,RR,0,250,1,-87,-87,-87,0
31,RR,1,250,9,-84.7777777777778,-81,-90,9
31,RR,0,250,6,-84.5,-78,-90,12
31,RR,0,250,2,-85,-80,-90,10
31,RR,0,250,5,-83.8,-80,-87,7
31,RR,0,250,7,-83.5714285714286,-80,-87,7
31,RR,0,250,2,-83,-80,-86,6
31,RR,0,250,7,-82.2857142857143,-80,-86,6
31,RR,0,250,8,-81.875,-80,-85,5
31,RR,0,250,8,-82.625,-77,-90,13
31,RR,0,250,4,-80,-77,-84,7
31,RR,0,250,3,-81,-78,-84,6
31,RR,1,250,9,-83.6666666666667,-78,-89,11
31,RR,0,250,8,-84.25,-78,-89,11
31,RR,0,250,5,-86.4,-84,-89,5
31,RR,0,250,7,-84,-81,-89,8
31,RR,0,250,2,-83.5,-82,-85,3
31,RR,0,250,8,-81.75,-80,-85,5
31,RR,0,250,1,-85,-85,-85,0
31,RR,0,250,5,-82.2,-81,-84,3
31,RR,0,250,3,-86.3333333333333,-84,-88,4
31,RR,1,250,9,-83.2222222222222,-77,-88,11
31,RR,0,250,4,-84.5,-84,-85,1
31,RR,1,250,9,-85,-80,-88,8
31,RR,0,250,4,-84.75,-80,-88,8
31,RR,0,250,6,-84.1666666666667,-80,-88,8
31,RR,1,250,10,-85.8,-80,-91,11
31,RR,1,250,10,-86.3,-80,-93,13
31,RR,0,250,4,-84.5,-79,-93,14
31,RR,0,250,8,-78.75,-75,-83,8
31,RR,0,250,8,-79.375,-77,-83,6
31,RR,0,250,8,-83.25,-79,-87,8
31,RR,1,250,10,-85.8,-76,-98,22
31,RR,0,250,8,-88.375,-81,-98,17
31,RR,1,250,10,-85,-81,-93,12
31,RR,0,250,5,-81.8,-81,-83,2
31,RR,0,250,2,-81.5,-81,-82,1
31,RR,0,250,1,-82,-82,-82,0
31,RR,1,250,9,-86.4444444444444,-80,-100,20
31,RR,0,250,2,-84,-81,-87,6
31,RR,0,250,3,-87,-79,-100,21
31,RR,1,250,9,-79.8888888888889,-76,-88,12
31,RR,1,250,9,-82.5555555555556,-76,-97,21
31,RR,0,250,2,-76.5,-76,-77,1
31,RR,0,250,8,-82.125,-80,-85,5
31,RR,0,250,6,-78.3333333333333,-76,-80,4
31,RR,0,250,2,-78,-76,-80,4
31,RR,0,250,2,-79,-78,-80,2
31,RR,1,250,9,-77.3333333333333,-72,-86,14
31,RR,0,250,2,-79,-78,-80,2
31,RR,0,250,8,-79.875,-77,-86,9
31,RR,0,250,4,-75.75,-74,-78,4
31,RR,1,250,10,-76.5,-75,-80,5
31,RR,0,250,5,-76.4,-76,-77,1
31,RR,0,250,4,-77.5,-74,-81,7
31,RR,0,250,7,-76.1428571428571,-74,-79,5
31,RR,0,250,2,-76.5,-76,-77,1
31,RR,0,250,8,-77,-74,-80,6
31,RR,0,250,3,-84.3333333333333,-77,-94,17
31,LL,0,250,3,-82,-76,-90,14
31,LL,1,250,9,-79.7777777777778,-77,-84,7
31,LL,0,250,1,-80,-80,-80,0
31,LL,0,250,4,-82,-81,-84,3
31,LL,0,250,6,-81.6666666666667,-79,-84,5
31,LL,1,250,9,-82.2222222222222,-78,-84,6
31,LL,1,250,10,-82.7,-80,-84,4
31,LL,0,250,2,-81,-80,-82,2
31,LL,0,250,8,-82.375,-79,-84,5
31,LL,0,250,3,-83,-82,-84,2
31,LL,0,250,6,-82.6666666666667,-79,-86,7
31,LL,0,250,1,-79,-79,-79,0
31,LL,0,250,2,-82.5,-79,-86,7
31,LL,1,250,10,-85,-79,-91,12
31,LL,0,250,1,-86,-86,-86,0
31,LL,0,250,7,-82.8571428571429,-80,-86,6
31,LL,0,250,8,-82.375,-80,-87,7
31,LL,0,250,8,-87,-83,-98,15
31,LL,0,250,2,-85,-83,-87,4
31,LL,1,250,10,-87.4,-82,-98,16
31,LL,0,250,1,-94,-94,-94,0
31,LL,0,250,4,-87.75,-84,-92,8
31,LL,0,250,4,-82,-82,-82,0
31,LL,1,250,10,-81.8,-78,-84,6
31,LL,0,250,2,-81.5,-80,-83,3
31,LL,0,250,4,-81.5,-80,-83,3
31,LL,0,250,4,-80.25,-78,-82,4
31,LL,1,250,9,-80.5555555555556,-78,-83,5
31,LL,0,250,8,-80.625,-79,-83,4
31,LL,0,250,4,-80,-79,-81,2
31,LL,0,250,8,-80.375,-78,-81,3
31,LL,0,250,7,-80.5714285714286,-78,-82,4
31,LL,1,250,10,-80.7,-78,-82,4
31,LL,0,250,8,-80.625,-78,-82,4
31,LL,0,250,3,-80.3333333333333,-78,-82,4
31,LL,0,250,6,-81,-80,-82,2
31,LL,0,250,7,-81.1428571428571,-80,-82,2
31,LL,0,250,7,-81.7142857142857,-80,-85,5
31,LL,0,250,2,-81,-80,-82,2
31,LL,1,250,9,-85.4444444444444,-78,-93,15
31,LL,0,250,4,-87,-82,-93,11
31,LL,1,250,10,-86.9,-78,-96,18
31,LL,0,250,2,-84,-78,-90,12
31,LL,0,250,3,-80,-78,-82,4
31,LL,0,250,6,-81.1666666666667,-76,-90,14
31,LL,0,250,6,-83.6666666666667,-79,-90,11
31,LL,0,250,7,-83.4285714285714,-78,-87,9
31,LL,0,250,5,-84.4,-83,-87,4
31,LL,1,250,10,-82.6,-80,-87,7
31,LL,0,250,2,-83,-83,-83,0
31,LL,1,250,10,-82.6,-80,-85,5
31,LL,0,250,3,-83.3333333333333,-83,-84,1
31,LL,0,250,1,-82,-82,-82,0
31,LL,0,250,7,-81.8571428571429,-80,-86,6
31,LL,0,250,1,-80,-80,-80,0
31,LL,0,250,1,-81,-81,-81,0
31,LL,0,250,8,-81.5,-79,-83,4
31,LL,0,250,6,-81.3333333333333,-79,-83,4
31,LL,0,250,4,-83.25,-79,-88,9
31,LL,1,250,9,-82.6666666666667,-79,-86,7
31,LL,0,250,3,-81.3333333333333,-79,-84,5
31,LL,0,250,5,-80.6,-79,-83,4
31,LL,1,250,9,-80.6666666666667,-79,-83,4
31,LL,1,250,10,-80.8,-79,-83,4
31,LL,0,250,7,-81.1428571428571,-80,-84,4
31,LL,0,250,6,-81.1666666666667,-80,-84,4
31,LL,1,250,9,-82.1111111111111,-79,-89,10
31,LL,0,250,6,-87,-79,-95,16
31,LL,0,250,4,-93.25,-89,-98,9
31,LL,0,250,4,-84.25,-77,-93,16
31,LL,0,250,2,-85,-77,-93,16
31,LL,0,250,3,-81.3333333333333,-77,-88,11
31,LL,0,250,7,-80.5714285714286,-79,-82,3
31,LL,0,250,8,-82.25,-78,-90,12
31,LL,0,250,8,-85.625,-82,-90,8
31,LL,0,250,6,-86,-82,-90,8
31,LL,0,250,3,-86.6666666666667,-82,-90,8
31,LL,0,250,7,-87.5714285714286,-83,-94,11
31,LL,0,250,1,-83,-83,-83,0
31,LL,0,250,6,-89.8333333333333,-86,-94,8
31,LL,0,250,3,-91,-89,-92,3
31,LL,1,250,9,-87.5555555555556,-83,-97,14
31,LL,0,250,3,-91.3333333333333,-88,-94,6
31,LL,1,250,9,-88.2222222222222,-82,-97,15
31,LL,1,250,10,-88.3,-82,-97,15
31,LL,0,250,2,-85,-82,-88,6
31,LL,0,250,7,-85.1428571428571,-80,-92,12
31,LL,0,250,5,-85.2,-81,-90,9
31,LL,0,250,3,-89.3333333333333,-85,-93,8
31,LL,1,250,10,-86.8,-81,-94,13
31,LL,1,250,9,-86.1111111111111,-81,-94,13
31,LL,0,250,4,-84,-81,-88,7
31,LL,0,250,6,-82.1666666666667,-81,-85,4
31,LL,0,250,7,-83.1428571428571,-81,-86,5
31,LL,0,250,6,-82.3333333333333,-77,-88,11
31,LL,0,250,3,-85,-83,-88,5
26,RR,0,250,6,-69.8333333333333,-67,-75,8
26,RR,0,250,1,-69,-69,-69,0
26,RR,0,250,4,-73.25,-70,-77,7
26,RR,0,250,4,-75.25,-70,-80,10
26,RR,0,250,7,-77.2857142857143,-73,-81,8
26,RR,0,250,4,-77.5,-74,-81,7
26,RR,0,250,1,-73,-73,-73,0
26,RR,1,250,9,-81,-74,-86,12
26,RR,0,250,1,-76,-76,-76,0
26,RR,1,250,9,-80.8888888888889,-77,-86,9
26,RR,0,250,2,-77.5,-76,-79,3
26,RR,0,250,4,-79.25,-72,-85,13
26,RR,0,250,6,-76.3333333333333,-73,-80,7
26,RR,0,250,8,-82.625,-79,-86,7
26,RR,0,250,5,-85.4,-78,-90,12
26,RR,0,250,8,-88.875,-80,-98,18
26,RR,1,250,10,-87.8,-78,-98,20
26,RR,0,250,3,-87.3333333333333,-84,-91,7
26,RR,0,250,3,-79.3333333333333,-76,-82,6
26,RR,0,250,5,-81.8,-76,-88,12
26,RR,0,250,6,-83,-76,-88,12
26,RR,0,250,8,-85.5,-82,-90,8
26,RR,0,250,4,-85.5,-78,-94,16
26,RR,0,250,4,-85.5,-84,-88,4
26,RR,0,250,5,-87.8,-86,-93,7
26,RR,0,250,4,-88.25,-86,-93,7
26,RR,0,250,6,-84.3333333333333,-79,-88,9
26,RR,0,250,6,-84.1666666666667,-79,-90,11
26,RR,0,250,7,-82.4285714285714,-80,-86,6
26,RR,0,250,1,-83,-83,-83,0
26,RR,0,250,7,-80.7142857142857,-80,-82,2
26,RR,0,250,4,-80.75,-80,-82,2
26,RR,0,250,2,-78.5,-78,-79,1
26,RR,0,250,3,-78.6666666666667,-77,-82,5
26,RR,1,250,10,-84,-77,-90,13
26,RR,1,250,9,-81,-73,-89,16
26,RR,0,250,5,-78.4,-78,-79,1
26,RR,1,250,10,-84,-78,-94,16
26,RR,0,250,8,-85.375,-78,-94,16
26,RR,0,250,5,-88.4,-85,-94,9
26,RR,0,250,5,-87.4,-82,-94,12
26,RR,0,250,1,-86,-86,-86,0
26,RR,1,250,10,-80.2,-77,-85,8
26,RR,0,250,6,-79.8333333333333,-76,-85,9
26,RR,1,250,9,-81.1111111111111,-76,-86,10
26,RR,0,250,6,-83.6666666666667,-81,-87,6
26,RR,1,250,9,-82.7777777777778,-76,-87,11
26,RR,0,250,2,-81.5,-81,-82,1
26,RR,1,250,9,-81,-77,-88,11
26,RR,0,250,5,-82,-78,-88,10
26,RR,0,250,8,-82.875,-80,-88,8
26,RR,1,250,10,-78.7,-73,-84,11
26,RR,0,250,7,-78.5714285714286,-73,-84,11
26,RR,1,250,9,-80.5555555555556,-73,-89,16
26,RR,0,250,3,-78.3333333333333,-73,-84,11
26,RR,0,250,1,-83,-83,-83,0
26,RR,0,250,3,-79.6666666666667,-77,-84,7
26,RR,1,250,9,-79.4444444444444,-75,-87,12
26,RR,0,250,2,-80,-77,-83,6
26,RR,0,250,1,-82,-82,-82,0
26,RR,0,250,7,-85.5714285714286,-82,-90,8
26,RR,0,250,3,-86.6666666666667,-84,-90,6
26,RR,0,250,7,-84.7142857142857,-80,-90,10
26,RR,0,250,5,-83.4,-80,-87,7
26,RR,0,250,4,-83,-80,-87,7
26,RR,0,250,7,-82.8571428571429,-78,-87,9
26,RR,0,250,2,-82,-80,-84,4
26,RR,0,250,3,-77,-75,-79,4
26,RR,0,250,6,-83.1666666666667,-74,-97,23
26,RR,0,250,4,-80.25,-74,-86,12
26,RR,0,250,4,-78.5,-77,-80,3
26,RR,0,250,3,-76.6666666666667,-74,-79,5
26,RR,0,250,3,-77.6666666666667,-75,-81,6
26,RR,1,250,9,-75.4444444444444,-72,-80,8
26,RR,0,250,1,-74,-74,-74,0
26,RR,0,250,4,-82.5,-80,-86,6
26,LL,0,250,6,-79.8333333333333,-75,-87,12
26,LL,0,250,4,-79.5,-77,-82,5
26,LL,0,250,5,-79.2,-77,-81,4
26,LL,1,250,9,-80.6666666666667,-77,-84,7
26,LL,0,250,3,-81,-80,-82,2
26,LL,1,250,10,-82,-78,-86,8
26,LL,0,250,5,-80.8,-78,-83,5
26,LL,0,250,1,-77,-77,-77,0
26,LL,0,250,4,-81.75,-79,-86,7
26,LL,1,250,9,-84.7777777777778,-80,-89,9
26,LL,0,250,2,-86,-83,-89,6
26,LL,1,250,9,-84.4444444444444,-81,-92,11
26,LL,1,250,10,-83.2,-80,-92,12
26,LL,0,250,2,-87.5,-83,-92,9
26,LL,0,250,8,-81.625,-79,-86,7
26,LL,0,250,4,-80.25,-79,-82,3
26,LL,0,250,3,-81,-80,-82,2
26,LL,1,250,10,-83.7,-81,-88,7
26,LL,0,250,5,-84,-83,-87,4
26,LL,0,250,2,-83.5,-83,-84,1
26,LL,0,250,5,-81.8,-81,-83,2
26,LL,1,250,9,-81,-78,-83,5
26,LL,0,250,4,-79.5,-78,-82,4
26,LL,1,250,9,-79.1111111111111,-77,-81,4
26,LL,0,250,3,-78.3333333333333,-77,-79,2
26,LL,0,250,6,-79,-77,-80,3
26,LL,0,250,5,-78.2,-77,-80,3
26,LL,0,250,4,-79.25,-77,-81,4
26,LL,0,250,1,-82,-82,-82,0
26,LL,0,250,5,-83,-78,-90,12
26,LL,0,250,8,-81.5,-76,-87,11
26,LL,0,250,3,-82.6666666666667,-78,-87,9
26,LL,1,250,10,-80.6,-79,-82,3
26,LL,1,250,10,-80.6,-79,-82,3
26,LL,1,250,9,-80.3333333333333,-79,-82,3
26,LL,0,250,5,-79.8,-77,-82,5
26,LL,0,250,4,-79.75,-77,-82,5
26,LL,0,250,5,-80.6,-78,-83,5
26,LL,0,250,2,-82,-81,-83,2
26,LL,1,250,9,-80.3333333333333,-78,-83,5
26,LL,0,250,4,-82.75,-82,-83,1
26,LL,0,250,7,-88.5714285714286,-83,-94,11
26,LL,0,250,5,-83,-77,-90,13
26,LL,0,250,1,-81,-81,-81,0
26,LL,1,250,10,-81.2,-77,-89,12
26,LL,0,250,8,-81.875,-78,-88,10
26,LL,0,250,2,-82.5,-78,-87,9
26,LL,0,250,6,-83.3333333333333,-79,-89,10
26,LL,0,250,8,-84,-78,-92,14
26,LL,0,250,4,-89.25,-86,-91,5
26,LL,0,250,1,-86,-86,-86,0
26,LL,0,250,1,-90,-90,-90,0
26,LL,0,250,4,-89,-86,-96,10
26,LL,0,250,3,-92,-90,-94,4
26,LL,0,250,3,-93.6666666666667,-90,-99,9
26,LL,0,250,8,-87.25,-84,-94,10
26,LL,0,250,2,-87,-84,-90,6
26,LL,0,250,5,-89.2,-84,-95,11
26,LL,0,250,3,-89.3333333333333,-84,-95,11
26,LL,0,250,5,-84.2,-81,-87,6
26,LL,0,250,8,-82.5,-80,-87,7
26,LL,0,250,2,-83.5,-80,-87,7
26,LL,0,250,7,-83.1428571428571,-80,-92,12
26,LL,0,250,7,-83.5714285714286,-78,-93,15
26,LL,0,250,1,-82,-82,-82,0
31,RR,0,300,2,-75.5,-75,-76,1
31,RR,0,300,8,-77.375,-74,-91,17
31,RR,0,300,7,-77.8571428571429,-74,-91,17
31,RR,0,300,8,-78.25,-74,-91,17
31,RR,0,300,3,-80.3333333333333,-74,-91,17
31,RR,0,300,8,-83.5,-78,-92,14
31,RR,0,300,7,-84.5714285714286,-81,-92,11
31,RR,0,300,5,-82.2,-80,-85,5
31,RR,0,300,3,-82,-81,-84,3
31,RR,0,300,4,-84.25,-80,-88,8
31,RR,0,300,2,-85,-83,-87,4
31,RR,0,300,8,-83.375,-80,-87,7
31,RR,1,300,10,-82,-80,-88,8
31,RR,0,300,6,-83.1666666666667,-80,-86,6
31,RR,0,300,3,-83.6666666666667,-80,-87,7
31,RR,0,300,3,-86,-84,-87,3
31,RR,0,300,6,-86.5,-84,-87,3
31,RR,0,300,3,-87,-87,-87,0
31,RR,0,300,3,-84.6666666666667,-80,-87,7
31,RR,0,300,4,-85.5,-80,-90,10
31,RR,0,300,5,-83.2,-79,-87,8
31,RR,0,300,5,-84,-79,-87,8
31,RR,0,300,7,-84.5714285714286,-79,-93,14
31,RR,0,300,8,-83.375,-81,-88,7
31,RR,0,300,2,-83.5,-82,-85,3
31,RR,0,300,5,-84.2,-83,-86,3
31,RR,1,300,9,-81.8888888888889,-79,-86,7
31,RR,1,300,10,-80.5,-77,-86,9
31,RR,0,300,5,-85.8,-79,-90,11
31,RR,0,300,6,-86.5,-79,-90,11
31,RR,0,300,3,-84.6666666666667,-81,-87,6
31,RR,0,300,8,-84.25,-80,-88,8
31,RR,0,300,5,-83.8,-80,-88,8
31,RR,1,300,9,-85.3333333333333,-80,-98,18
31,RR,0,300,3,-85.3333333333333,-82,-87,5
31,RR,0,300,4,-87.5,-81,-98,17
31,RR,0,300,1,-86,-86,-86,0
31,RR,0,300,1,-79,-79,-79,0
31,RR,0,300,5,-77.4,-75,-82,7
31,RR,0,300,6,-86.5,-82,-92,10
31,RR,0,300,6,-86.3333333333333,-84,-94,10
31,RR,0,300,4,-86.75,-84,-94,10
31,RR,0,300,5,-85.2,-84,-89,5
31,RR,0,300,8,-86.875,-84,-93,9
31,RR,0,300,8,-88,-84,-94,10
31,RR,0,300,8,-85.875,-81,-90,9
31,RR,0,300,3,-91.6666666666667,-87,-95,8
31,RR,1,300,9,-86,-79,-95,16
31,RR,0,300,6,-87,-79,-95,16
31,RR,0,300,2,-89.5,-84,-95,11
31,RR,0,300,1,-84,-84,-84,0
31,RR,0,300,3,-88,-85,-91,6
31,RR,0,300,1,-88,-88,-88,0
31,RR,0,300,2,-83.5,-81,-86,5
31,RR,0,300,6,-85.8333333333333,-85,-87,2
31,RR,1,300,10,-86.2,-82,-92,10
31,RR,1,300,9,-86.2222222222222,-82,-92,10
31,RR,0,300,3,-79.3333333333333,-78,-81,3
31,RR,0,300,7,-82.1428571428571,-79,-86,7
31,RR,1,300,10,-79.6,-74,-86,12
31,RR,1,300,9,-76.7777777777778,-74,-82,8
31,RR,0,300,2,-75.5,-74,-77,3
31,RR,0,300,6,-81.8333333333333,-77,-86,9
31,RR,0,300,2,-85.5,-82,-89,7
31,RR,0,300,5,-84.8,-80,-90,10
31,RR,0,300,3,-81.6666666666667,-80,-84,4
31,RR,0,300,3,-82.3333333333333,-81,-84,3
31,RR,0,300,5,-82.8,-77,-88,11
31,RR,0,300,6,-82.6666666666667,-77,-88,11
31,RR,0,300,5,-80.8,-79,-86,7
31,RR,0,300,3,-83,-81,-85,4
31,RR,1,300,10,-80.9,-78,-86,8
31,RR,0,300,5,-82.6,-78,-94,16
31,RR,0,300,6,-85.5,-76,-96,20
31,RR,0,300,1,-88,-88,-88,0
31,RR,0,300,5,-88.8,-82,-96,14
31,RR,0,300,4,-83.75,-81,-89,8
31,RR,0,300,8,-80.375,-77,-84,7
31,RR,0,300,4,-79.25,-77,-82,5
31,RR,0,300,8,-81.125,-77,-88,11
31,RR,0,300,3,-80.6666666666667,-77,-88,11
31,RR,0,300,1,-88,-88,-88,0
31,RR,0,300,7,-83.1428571428571,-77,-90,13
31,RR,0,300,6,-83.3333333333333,-77,-91,14
31,RR,0,300,1,-84,-84,-84,0
31,RR,0,300,5,-79.4,-75,-86,11
31,RR,0,300,1,-75,-75,-75,0
31,RR,0,300,3,-82.6666666666667,-80,-87,7
31,RR,0,300,3,-86,-81,-90,9
31,RR,0,300,7,-89.4285714285714,-82,-95,13
31,RR,0,300,6,-89.8333333333333,-82,-95,13
31,RR,1,300,10,-85.3,-75,-95,20
31,LL,1,300,10,-80.6,-74,-89,15
31,LL,1,300,9,-80.4444444444444,-74,-89,15
31,LL,1,300,10,-79.6,-74,-89,15
31,LL,0,300,1,-83,-83,-83,0
31,LL,1,300,10,-81.9,-76,-90,14
31,LL,1,300,10,-82.1,-78,-91,13
31,LL,0,300,2,-84.5,-79,-90,11
31,LL,0,300,2,-80.5,-78,-83,5
31,LL,0,300,8,-82.25,-78,-91,13
31,LL,0,300,8,-80.625,-78,-89,11
31,LL,0,300,1,-89,-89,-89,0
31,LL,0,300,8,-81.375,-77,-92,15
31,LL,0,300,5,-83.8,-77,-96,19
31,LL,0,300,7,-81.7142857142857,-77,-90,13
31,LL,1,300,9,-80.5555555555556,-78,-84,6
31,LL,1,300,10,-80.3,-78,-83,5
31,LL,0,300,5,-79.6,-78,-82,4
31,LL,0,300,5,-79.8,-78,-82,4
31,LL,0,300,2,-80,-79,-81,2
31,LL,0,300,7,-81.5714285714286,-78,-91,13
31,LL,0,300,2,-84.5,-78,-91,13
31,LL,0,300,4,-80.75,-77,-83,6
31,LL,0,300,6,-80,-77,-85,8
31,LL,0,300,7,-82.7142857142857,-81,-91,10
31,LL,0,300,2,-81.5,-81,-82,1
31,LL,1,300,10,-81.7,-78,-85,7
31,LL,0,300,4,-79.25,-78,-80,2
31,LL,0,300,1,-81,-81,-81,0
31,LL,0,300,4,-83,-81,-88,7
31,LL,1,300,10,-83.4,-81,-88,7
31,LL,0,300,4,-81.75,-81,-83,2
31,LL,0,300,1,-81,-81,-81,0
31,LL,0,300,1,-82,-82,-82,0
31,LL,0,300,1,-82,-82,-82,0
31,LL,1,300,10,-82.1,-76,-87,11
31,LL,0,300,6,-82.5,-80,-87,7
31,LL,0,300,2,-80.5,-80,-81,1
31,LL,0,300,7,-82.8571428571429,-80,-87,7
31,LL,0,300,4,-81.25,-78,-90,12
31,LL,1,300,10,-82.6,-80,-88,8
31,LL,1,300,10,-82.2,-80,-88,8
31,LL,0,300,8,-82.375,-80,-85,5
31,LL,0,300,6,-83.3333333333333,-80,-86,6
31,LL,0,300,2,-83,-80,-86,6
31,LL,0,300,3,-80.6666666666667,-80,-82,2
31,LL,0,300,2,-81.5,-79,-84,5
31,LL,0,300,5,-82.4,-77,-90,13
31,LL,0,300,3,-83.3333333333333,-77,-90,13
31,LL,1,300,10,-82.7,-76,-92,16
31,LL,0,300,2,-80,-78,-82,4
31,LL,1,300,10,-84.6,-80,-92,12
31,LL,0,300,6,-82.6666666666667,-80,-84,4
31,LL,1,300,10,-81.9,-77,-88,11
31,LL,1,300,9,-82.2222222222222,-76,-92,16
31,LL,0,300,3,-80.3333333333333,-77,-86,9
31,LL,0,300,5,-85.8,-77,-93,16
31,LL,0,300,1,-93,-93,-93,0
31,LL,1,300,10,-82.2,-77,-93,16
31,LL,0,300,2,-85.5,-78,-93,15
31,LL,1,300,9,-82.1111111111111,-80,-86,6
31,LL,1,300,9,-83.8888888888889,-77,-94,17
31,LL,0,300,4,-85.25,-76,-92,16
31,LL,0,300,4,-84.5,-77,-92,15
31,LL,0,300,2,-78,-75,-81,6
31,LL,0,300,3,-87,-84,-90,6
31,LL,0,300,2,-82,-82,-82,0
31,LL,0,300,4,-81.25,-79,-82,3
31,LL,0,300,1,-82,-82,-82,0
31,LL,0,300,6,-86.3333333333333,-81,-100,19
31,LL,1,300,9,-83.8888888888889,-80,-90,10
31,LL,0,300,4,-83.5,-80,-90,10
31,LL,0,300,5,-77.4,-74,-81,7
31,LL,1,300,9,-80.7777777777778,-74,-97,23
31,LL,0,300,8,-81.125,-74,-97,23
31,LL,0,300,2,-77,-76,-78,2
31,LL,0,300,6,-83,-77,-97,20
31,LL,0,300,8,-82.125,-75,-93,18
31,LL,0,300,3,-89.6666666666667,-85,-94,9
26,RR,1,300,10,-83.1,-73,-90,17
26,RR,0,300,3,-84,-77,-90,13
26,RR,0,300,7,-84.4285714285714,-79,-88,9
26,RR,0,300,3,-82.6666666666667,-78,-91,13
26,RR,1,300,10,-81.4,-79,-87,8
26,RR,0,300,8,-81.375,-79,-86,7
26,RR,0,300,3,-81.6666666666667,-79,-86,7
26,RR,0,300,3,-80,-79,-82,3
26,RR,0,300,5,-80,-78,-82,4
26,RR,0,300,5,-80,-78,-82,4
26,RR,1,300,10,-80.4,-79,-82,3
26,RR,1,300,10,-80.9,-79,-84,5
26,RR,0,300,6,-80.6666666666667,-79,-84,5
26,RR,0,300,1,-83,-83,-83,0
26,RR,0,300,2,-81,-79,-83,4
26,RR,1,300,9,-83.1111111111111,-79,-89,10
26,RR,0,300,6,-82.8333333333333,-79,-89,10
26,RR,0,300,7,-82.7142857142857,-79,-89,10
26,RR,1,300,10,-83.1,-79,-90,11
26,RR,0,300,7,-85.7142857142857,-79,-100,21
26,RR,0,300,4,-89.75,-83,-100,17
26,RR,0,300,3,-84.3333333333333,-80,-87,7
26,RR,1,300,9,-82.3333333333333,-78,-93,15
26,RR,0,300,4,-84.25,-78,-92,14
26,RR,0,300,4,-84.25,-80,-90,10
26,RR,0,300,2,-83.5,-78,-89,11
26,RR,0,300,4,-81.5,-78,-88,10
26,RR,0,300,6,-80.8333333333333,-78,-87,9
26,RR,1,300,10,-81.4,-75,-91,16
26,RR,0,300,3,-82.6666666666667,-75,-91,16
26,RR,0,300,4,-83.5,-79,-91,12
26,RR,0,300,6,-78.6666666666667,-76,-84,8
26,RR,0,300,1,-81,-81,-81,0
26,RR,0,300,2,-75.5,-75,-76,1
26,RR,1,300,9,-87.2222222222222,-84,-95,11
26,RR,0,300,3,-86.3333333333333,-84,-91,7
26,RR,0,300,7,-86.4285714285714,-83,-95,12
26,RR,0,300,2,-83,-83,-83,0
26,RR,1,300,10,-88.6,-84,-95,11
26,RR,1,300,9,-88.5555555555556,-80,-98,18
26,RR,0,300,8,-88.25,-80,-98,18
26,RR,0,300,1,-94,-94,-94,0
26,RR,0,300,1,-92,-92,-92,0
26,RR,0,300,5,-86,-81,-94,13
26,RR,0,300,8,-84.25,-79,-94,15
26,RR,0,300,2,-82.5,-82,-83,1
26,RR,0,300,6,-82.5,-78,-94,16
26,RR,0,300,2,-82.5,-82,-83,1
26,RR,0,300,7,-82,-76,-87,11
26,RR,0,300,7,-81.2857142857143,-76,-87,11
26,RR,1,300,10,-77.2,-74,-82,8
26,RR,0,300,7,-76.8571428571429,-74,-82,8
26,RR,1,300,10,-77.5,-75,-82,7
26,RR,0,300,1,-76,-76,-76,0
26,RR,1,300,10,-79.3,-75,-88,13
26,RR,1,300,10,-82.8,-76,-88,12
26,RR,0,300,7,-83.2857142857143,-81,-88,7
26,RR,0,300,5,-82.6,-81,-85,4
26,RR,1,300,10,-82,-79,-87,8
26,RR,1,300,9,-82,-79,-87,8
26,RR,0,300,6,-81.8333333333333,-79,-87,8
26,RR,1,300,9,-82.6666666666667,-79,-85,6
26,RR,1,300,10,-81.4,-75,-85,10
26,RR,0,300,2,-84,-84,-84,0
26,RR,0,300,3,-86.3333333333333,-80,-98,18
26,RR,0,300,5,-84.2,-79,-91,12
26,RR,0,300,2,-84.5,-79,-90,11
26,RR,0,300,8,-85,-74,-98,24
26,RR,0,300,5,-89.6,-76,-98,22
26,RR,0,300,5,-87.2,-76,-98,22
26,RR,0,300,6,-82.5,-78,-86,8
26,RR,0,300,7,-83,-78,-86,8
26,RR,0,300,8,-82.875,-78,-86,8
26,RR,0,300,8,-82.75,-79,-86,7
26,RR,0,300,8,-82,-74,-89,15
26,RR,0,300,2,-78.5,-74,-83,9
26,RR,0,300,7,-76.1428571428571,-70,-81,11
26,RR,1,300,10,-78,-70,-87,17
26,LL,0,300,3,-83.6666666666667,-77,-92,15
26,LL,0,300,2,-80.5,-79,-82,3
26,LL,0,300,6,-83.1666666666667,-79,-96,17
26,LL,0,300,6,-78,-76,-83,7
26,LL,1,300,9,-80.1111111111111,-76,-89,13
26,LL,0,300,1,-83,-83,-83,0
26,LL,0,300,8,-80.375,-77,-89,12
26,LL,0,300,8,-79.5,-77,-82,5
26,LL,0,300,3,-79.6666666666667,-77,-81,4
26,LL,0,300,3,-79.3333333333333,-77,-81,4
26,LL,1,300,9,-80.4444444444444,-77,-86,9
26,LL,0,300,6,-80.5,-78,-86,8
26,LL,0,300,2,-80.5,-80,-81,1
26,LL,0,300,2,-81,-81,-81,0
26,LL,0,300,3,-84,-78,-90,12
26,LL,1,300,9,-79.3333333333333,-76,-82,6
26,LL,0,300,1,-82,-82,-82,0
26,LL,0,300,2,-82.5,-82,-83,1
26,LL,0,300,5,-78.2,-77,-80,3
26,LL,0,300,8,-80.125,-76,-84,8
26,LL,1,300,10,-82.5,-80,-87,7
26,LL,0,300,6,-83.8333333333333,-80,-87,7
26,LL,0,300,6,-83.3333333333333,-81,-88,7
26,LL,0,300,2,-81.5,-81,-82,1
26,LL,0,300,4,-82.75,-80,-88,8
26,LL,0,300,7,-81.8571428571429,-80,-86,6
26,LL,1,300,9,-81.7777777777778,-78,-90,12
26,LL,0,300,4,-81.75,-78,-90,12
26,LL,0,300,6,-82,-79,-85,6
26,LL,0,300,2,-81,-80,-82,2
26,LL,0,300,1,-80,-80,-80,0
26,LL,1,300,10,-80.4,-76,-83,7
26,LL,0,300,4,-78.75,-76,-80,4
26,LL,0,300,7,-82.7142857142857,-80,-88,8
26,LL,0,300,8,-82.5,-79,-88,9
26,LL,0,300,2,-80.5,-79,-82,3
26,LL,0,300,1,-80,-80,-80,0
26,LL,0,300,3,-79.3333333333333,-77,-81,4
26,LL,0,300,5,-79.6,-78,-86,8
26,LL,0,300,7,-81,-77,-86,9
26,LL,0,300,2,-77.5,-77,-78,1
26,LL,0,300,4,-82,-77,-88,11
26,LL,1,300,9,-81,-75,-92,17
26,LL,1,300,10,-79.9,-75,-89,14
26,LL,0,300,6,-79,-75,-81,6
26,LL,1,300,10,-80.8,-75,-89,14
26,LL,0,300,3,-80.3333333333333,-77,-82,5
26,LL,0,300,4,-81.75,-80,-84,4
26,LL,0,300,8,-82.25,-79,-85,6
26,LL,1,300,10,-81,-77,-83,6
26,LL,0,300,8,-80.625,-77,-83,6
26,LL,1,300,9,-81.4444444444444,-77,-90,13
26,LL,0,300,7,-81.7142857142857,-76,-90,14
26,LL,0,300,6,-80.5,-76,-90,14
26,LL,0,300,3,-82.3333333333333,-82,-83,1
26,LL,0,300,1,-83,-83,-83,0
26,LL,0,300,8,-86,-76,-96,20
26,LL,0,300,7,-86.1428571428571,-76,-96,20
26,LL,1,300,9,-86.3333333333333,-74,-96,22
26,LL,1,300,10,-85.5,-74,-96,22
26,LL,0,300,2,-90,-88,-92,4
26,LL,0,300,7,-79.5714285714286,-74,-88,14
26,LL,0,300,4,-77.25,-74,-80,6
26,LL,0,300,7,-80.2857142857143,-75,-88,13
26,LL,1,300,10,-79.4,-75,-85,10
26,LL,0,300,4,-77,-75,-79,4
26,LL,0,300,2,-75,-75,-75,0
26,LL,0,300,4,-79.25,-76,-83,7
26,LL,0,300,1,-85,-85,-85,0
26,LL,0,300,2,-83.5,-80,-87,7
26,LL,0,300,5,-82.2,-79,-94,15
26,LL,1,300,9,-80.8888888888889,-76,-95,19
26,LL,0,300,3,-77,-76,-78,2
26,LL,0,300,2,-77,-76,-78,2
26,LL,0,300,5,-80.2,-76,-85,9
26,LL,0,300,3,-82.3333333333333,-78,-85,7
31,RR,0,350,1,-76,-76,-76,0
31,RR,0,350,8,-81.875,-79,-88,9
31,RR,0,350,6,-80.3333333333333,-79,-84,5
31,RR,0,350,1,-80,-80,-80,0
31,RR,0,350,7,-81.5714285714286,-79,-84,5
31,RR,1,350,10,-81.7,-76,-87,11
31,RR,0,350,7,-82.1428571428571,-76,-87,11
31,RR,0,350,8,-86.125,-78,-97,19
31,RR,0,350,6,-83.6666666666667,-79,-90,11
31,RR,0,350,1,-80,-80,-80,0
31,RR,0,350,4,-85,-80,-93,13
31,RR,0,350,4,-87.5,-80,-94,14
31,RR,0,350,8,-83.125,-77,-90,13
31,RR,0,350,1,-88,-88,-88,0
31,RR,0,350,8,-84.375,-77,-90,13
31,RR,0,350,3,-82.6666666666667,-78,-91,13
31,RR,0,350,4,-82.5,-80,-85,5
31,RR,0,350,6,-85.3333333333333,-82,-88,6
31,RR,0,350,6,-84.1666666666667,-81,-89,8
31,RR,1,350,9,-86.3333333333333,-82,-89,7
31,RR,0,350,6,-86.5,-83,-89,6
31,RR,0,350,8,-86.375,-84,-88,4
31,RR,0,350,8,-86.25,-83,-88,5
31,RR,0,350,1,-87,-87,-87,0
31,RR,0,350,4,-86.25,-84,-88,4
31,RR,1,350,10,-85.6,-82,-90,8
31,RR,0,350,1,-83,-83,-83,0
31,RR,0,350,6,-86.1666666666667,-82,-90,8
31,RR,0,350,7,-88.4285714285714,-82,-92,10
31,RR,0,350,8,-87.75,-79,-92,13
31,RR,0,350,6,-86.3333333333333,-79,-92,13
31,RR,1,350,10,-84.8,-79,-96,17
31,RR,1,350,10,-85.2,-79,-96,17
31,RR,0,350,8,-85.125,-81,-92,11
31,RR,0,350,2,-84.5,-81,-88,7
31,RR,1,350,9,-85.2222222222222,-83,-92,9
31,RR,0,350,7,-87.5714285714286,-85,-93,8
31,RR,0,350,4,-86.75,-80,-93,13
31,RR,0,350,7,-87,-81,-92,11
31,RR,0,350,3,-86.3333333333333,-81,-94,13
31,RR,0,350,7,-83.5714285714286,-79,-93,14
31,RR,0,350,4,-86,-80,-93,13
31,RR,0,350,3,-81,-79,-84,5
31,RR,0,350,1,-82,-82,-82,0
31,RR,0,350,6,-85.3333333333333,-80,-94,14
31,RR,0,350,2,-88,-82,-94,12
31,RR,0,350,5,-84.4,-80,-89,9
31,RR,0,350,2,-85,-85,-85,0
31,RR,1,350,10,-83.4,-79,-88,9
31,RR,0,350,8,-83.5,-79,-88,9
31,RR,0,350,6,-84.1666666666667,-79,-88,9
31,RR,0,350,4,-89.75,-84,-102,18
31,RR,1,350,10,-84.9,-82,-88,6
31,RR,0,350,7,-85,-82,-88,6
31,RR,0,350,2,-87.5,-87,-88,1
31,RR,1,350,9,-81.4444444444444,-78,-87,9
31,RR,0,350,8,-82.875,-78,-90,12
31,RR,0,350,7,-84,-81,-90,9
31,RR,0,350,3,-83.6666666666667,-82,-85,3
31,RR,0,350,3,-82.6666666666667,-80,-88,8
31,RR,0,350,5,-86,-84,-88,4
31,RR,1,350,10,-83.7,-80,-87,7
31,RR,0,350,2,-82.5,-82,-83,1
31,RR,1,350,10,-88.8,-81,-102,21
31,RR,0,350,5,-88.6,-82,-96,14
31,RR,0,350,3,-92,-90,-96,6
31,RR,0,350,7,-91.4285714285714,-86,-102,16
31,LL,0,350,6,-84.8333333333333,-81,-94,13
31,LL,0,350,1,-82,-82,-82,0
31,LL,0,350,1,-80,-80,-80,0
31,LL,0,350,5,-90.6,-82,-95,13
31,LL,1,350,9,-87.2222222222222,-79,-94,15
31,LL,0,350,7,-83.5714285714286,-81,-88,7
31,LL,0,350,5,-83.8,-81,-88,7
31,LL,0,350,4,-83.25,-81,-86,5
31,LL,0,350,8,-83.375,-81,-88,7
31,LL,0,350,1,-81,-81,-81,0
31,LL,1,350,9,-83.8888888888889,-81,-89,8
31,LL,0,350,2,-81,-81,-81,0
31,LL,0,350,8,-82.625,-80,-89,9
31,LL,0,350,5,-82.4,-80,-89,9
31,LL,0,350,4,-83.25,-81,-89,8
31,LL,0,350,6,-83.5,-80,-90,10
31,LL,0,350,6,-83.5,-80,-90,10
31,LL,1,350,9,-86.5555555555556,-80,-94,14
31,LL,0,350,7,-86.2857142857143,-81,-94,13
31,LL,0,350,6,-86.5,-84,-91,7
31,LL,1,350,9,-84.6666666666667,-76,-90,14
31,LL,1,350,10,-82.7,-76,-90,14
31,LL,0,350,3,-78.6666666666667,-76,-83,7
31,LL,0,350,6,-78.1666666666667,-76,-83,7
31,LL,0,350,2,-78.5,-78,-79,1
31,LL,1,350,10,-77.8,-76,-80,4
31,LL,0,350,1,-79,-79,-79,0
31,LL,0,350,4,-85,-78,-100,22
31,LL,0,350,1,-100,-100,-100,0
31,LL,0,350,7,-81.4285714285714,-75,-87,12
31,LL,0,350,5,-81.2,-79,-85,6
31,LL,0,350,6,-82,-78,-87,9
31,LL,0,350,1,-86,-86,-86,0
31,LL,0,350,2,-85,-77,-93,16
31,LL,1,350,9,-85.6666666666667,-80,-97,17
31,LL,0,350,1,-84,-84,-84,0
31,LL,0,350,3,-83,-78,-89,11
31,LL,0,350,7,-83.5714285714286,-78,-87,9
31,LL,0,350,7,-83.4285714285714,-77,-87,10
31,LL,0,350,1,-87,-87,-87,0
31,LL,0,350,2,-80.5,-77,-84,7
31,LL,0,350,1,-84,-84,-84,0
31,LL,1,350,9,-80,-76,-90,14
31,LL,0,350,3,-77.6666666666667,-76,-81,5
31,LL,0,350,1,-80,-80,-80,0
31,LL,0,350,5,-83.6,-80,-88,8
31,LL,0,350,5,-85,-81,-88,7
31,LL,0,350,5,-86.4,-82,-88,6
31,LL,1,350,9,-85.8888888888889,-81,-90,9
31,LL,0,350,6,-84,-81,-90,9
31,LL,0,350,8,-84.5,-81,-90,9
31,LL,0,350,8,-83.875,-80,-90,10
31,LL,0,350,1,-87,-87,-87,0
31,LL,0,350,7,-81.7142857142857,-78,-86,8
31,LL,0,350,6,-81.5,-78,-86,8
31,LL,0,350,1,-83,-83,-83,0
31,LL,0,350,1,-83,-83,-83,0
31,LL,0,350,8,-83.25,-80,-92,12
31,LL,0,350,4,-81,-80,-83,3
31,LL,0,350,5,-81.8,-80,-84,4
31,LL,0,350,6,-84.3333333333333,-80,-90,10
31,LL,0,350,1,-81,-81,-81,0
31,LL,0,350,8,-83.5,-78,-88,10
31,LL,0,350,5,-82,-78,-86,8
31,LL,0,350,5,-84.2,-79,-93,14
31,LL,0,350,2,-87,-81,-93,12
31,LL,0,350,8,-79.25,-77,-81,4
31,LL,0,350,2,-77.5,-77,-78,1
31,LL,0,350,8,-80.75,-76,-87,11
31,LL,0,350,6,-81.8333333333333,-79,-87,8
31,LL,0,350,8,-79.125,-75,-90,15
31,LL,0,350,6,-80.6666666666667,-77,-86,9
31,LL,0,350,7,-80.4285714285714,-78,-81,3
31,LL,1,350,10,-82.6,-80,-88,8
31,LL,0,350,2,-80,-80,-80,0
31,LL,0,350,2,-82,-80,-84,4
31,LL,1,350,9,-82.5555555555556,-80,-87,7
31,LL,0,350,1,-80,-80,-80,0
31,LL,0,350,7,-82.8571428571429,-80,-95,15
31,LL,0,350,7,-83.7142857142857,-80,-95,15
26,RR,0,350,7,-84.2857142857143,-81,-86,5
26,RR,0,350,7,-82,-76,-94,18
26,RR,0,350,5,-81.6,-76,-94,18
26,RR,1,350,9,-84.1111111111111,-78,-88,10
26,RR,0,350,6,-80.8333333333333,-77,-88,11
26,RR,0,350,5,-81.6,-78,-88,10
26,RR,0,350,4,-80.5,-78,-88,10
26,RR,0,350,5,-81.8,-78,-88,10
26,RR,0,350,8,-82.875,-78,-91,13
26,RR,1,350,9,-87.5555555555556,-78,-92,14
26,RR,0,350,5,-83.8,-77,-90,13
26,RR,0,350,2,-82,-78,-86,8
26,RR,0,350,1,-76,-76,-76,0
26,RR,0,350,6,-85,-76,-88,12
26,RR,0,350,8,-86.375,-76,-94,18
26,RR,0,350,1,-92,-92,-92,0
26,RR,0,350,7,-87.2857142857143,-76,-94,18
26,RR,1,350,9,-87.5555555555556,-76,-94,18
26,RR,0,350,6,-86.5,-79,-91,12
26,RR,0,350,4,-86.5,-79,-91,12
26,RR,1,350,10,-85.4,-80,-97,17
26,RR,0,350,2,-88,-86,-90,4
26,RR,1,350,9,-85.1111111111111,-79,-97,18
26,RR,0,350,3,-87.6666666666667,-80,-97,17
26,RR,0,350,3,-86,-82,-90,8
26,RR,0,350,6,-85.1666666666667,-82,-88,6
26,RR,1,350,10,-85,-81,-88,7
26,RR,0,350,4,-83.5,-81,-86,5
26,RR,0,350,2,-87.5,-87,-88,1
26,RR,0,350,3,-81.6666666666667,-81,-82,1
26,RR,0,350,2,-90,-89,-91,2
26,RR,0,350,5,-83.6,-79,-88,9
26,RR,0,350,8,-87,-79,-93,14
26,RR,0,350,2,-83.5,-79,-88,9
26,RR,0,350,4,-88.5,-79,-93,14
26,RR,0,350,1,-92,-92,-92,0
26,RR,1,350,9,-84.4444444444444,-79,-92,13
26,RR,0,350,4,-84.75,-80,-90,10
26,RR,1,350,10,-84.7,-82,-88,6
26,RR,0,350,7,-84.4285714285714,-82,-88,6
26,RR,0,350,7,-84.5714285714286,-82,-88,6
26,RR,0,350,6,-87,-79,-95,16
26,RR,1,350,10,-85.8,-81,-96,15
26,RR,0,350,2,-93,-90,-96,6
26,RR,0,350,6,-83.5,-80,-90,10
26,RR,1,350,10,-82.3,-77,-88,11
26,RR,0,350,6,-82.6666666666667,-78,-87,9
26,RR,0,350,7,-85.2857142857143,-81,-97,16
26,RR,0,350,3,-83,-79,-88,9
26,RR,0,350,3,-85.3333333333333,-82,-88,6
26,RR,0,350,6,-86.6666666666667,-84,-93,9
26,RR,0,350,3,-87.6666666666667,-84,-93,9
26,RR,1,350,10,-83.1,-78,-93,15
26,RR,0,350,1,-82,-82,-82,0
26,RR,0,350,3,-87.6666666666667,-83,-94,11
26,RR,0,350,3,-89.3333333333333,-86,-94,8
26,RR,1,350,10,-85.9,-80,-95,15
26,RR,0,350,5,-87.8,-83,-95,12
26,RR,1,350,9,-83.7777777777778,-79,-95,16
26,RR,1,350,10,-82.4,-79,-88,9
26,RR,0,350,2,-80,-79,-81,2
26,RR,0,350,7,-81.8571428571429,-80,-83,3
26,RR,1,350,9,-84.5555555555556,-80,-90,10
26,RR,0,350,4,-85,-80,-90,10
26,RR,1,350,10,-80.7,-77,-84,7
26,RR,1,350,10,-80.3,-77,-83,6
26,RR,0,350,7,-80.4285714285714,-77,-83,6
26,RR,0,350,2,-80.5,-79,-82,3
26,RR,0,350,1,-81,-81,-81,0
26,RR,0,350,2,-89.5,-87,-92,5
26,RR,0,350,1,-91,-91,-91,0
26,RR,0,350,4,-83.5,-80,-92,12
26,RR,0,350,2,-82,-80,-84,4
26,RR,1,350,10,-83.4,-80,-87,7
26,RR,1,350,9,-82.5555555555556,-80,-90,10
26,RR,0,350,1,-80,-80,-80,0
26,RR,1,350,9,-81.4444444444444,-79,-88,9
26,RR,0,350,5,-82.6,-80,-88,8
26,RR,0,350,1,-88,-88,-88,0
26,RR,1,350,10,-83.9,-79,-88,9
26,RR,0,350,1,-81,-81,-81,0
26,RR,0,350,1,-87,-87,-87,0
26,RR,0,350,6,-85.3333333333333,-81,-90,9
26,RR,0,350,8,-84.625,-81,-88,7
26,LL,1,350,9,-88.1111111111111,-76,-98,22
26,LL,0,350,7,-85.7142857142857,-76,-97,21
26,LL,0,350,1,-90,-90,-90,0
26,LL,0,350,7,-86.4285714285714,-79,-96,17
26,LL,0,350,1,-82,-82,-82,0
26,LL,0,350,3,-86,-84,-89,5
26,LL,0,350,1,-81,-81,-81,0
26,LL,0,350,2,-79.5,-79,-80,1
26,LL,0,350,2,-87,-80,-94,14
26,LL,1,350,10,-85.9,-78,-94,16
26,LL,1,350,9,-83,-80,-86,6
26,LL,0,350,8,-82.75,-80,-86,6
26,LL,0,350,6,-83.5,-81,-86,5
26,LL,0,350,6,-83.6666666666667,-80,-87,7
26,LL,1,350,9,-82.8888888888889,-79,-87,8
26,LL,0,350,1,-80,-80,-80,0
26,LL,0,350,2,-87,-87,-87,0
26,LL,0,350,7,-80.5714285714286,-79,-86,7
26,LL,0,350,1,-79,-79,-79,0
26,LL,0,350,2,-79.5,-79,-80,1
26,LL,0,350,2,-83,-80,-86,6
26,LL,0,350,6,-82.8333333333333,-80,-88,8
26,LL,1,350,10,-81.3,-79,-88,9
26,LL,0,350,2,-84,-80,-88,8
26,LL,1,350,9,-81.8888888888889,-79,-88,9
26,LL,0,350,4,-82.5,-80,-88,8
26,LL,0,350,3,-83,-80,-88,8
26,LL,0,350,1,-90,-90,-90,0
26,LL,0,350,5,-81.2,-79,-86,7
26,LL,0,350,7,-83,-80,-88,8
26,LL,1,350,9,-82.7777777777778,-76,-88,12
26,LL,1,350,10,-81.3,-75,-88,13
26,LL,1,350,10,-78.1,-75,-88,13
26,LL,0,350,1,-78,-78,-78,0
26,LL,0,350,6,-75.8333333333333,-75,-77,2
26,LL,0,350,4,-75.75,-75,-76,1
26,LL,0,350,4,-76.75,-75,-80,5
26,LL,0,350,8,-79.625,-75,-83,8
26,LL,0,350,6,-79.8333333333333,-77,-82,5
26,LL,1,350,9,-83.5555555555556,-76,-90,14
26,LL,0,350,7,-83.4285714285714,-78,-94,16
26,LL,0,350,7,-82.1428571428571,-79,-87,8
26,LL,1,350,9,-82.1111111111111,-77,-87,10
26,LL,0,350,2,-83,-80,-86,6
26,LL,0,350,6,-86.5,-79,-91,12
26,LL,0,350,3,-86.6666666666667,-83,-89,6
26,LL,0,350,3,-84.6666666666667,-77,-91,14
26,LL,0,350,7,-83,-75,-88,13
26,LL,0,350,8,-76.625,-75,-84,9
26,LL,0,350,6,-77,-75,-84,9
26,LL,0,350,4,-80,-77,-84,7
26,LL,0,350,7,-79.2857142857143,-77,-82,5
26,LL,0,350,7,-79.7142857142857,-77,-87,10
26,LL,0,350,4,-81.25,-79,-87,8
26,LL,0,350,8,-82.5,-79,-86,7
26,LL,0,350,1,-86,-86,-86,0
26,LL,0,350,8,-84.875,-81,-91,10
26,LL,0,350,8,-83.625,-81,-87,6
26,LL,1,350,9,-83.2222222222222,-80,-87,7
26,LL,0,350,6,-83.6666666666667,-81,-87,6
26,LL,0,350,5,-82,-78,-86,8
26,LL,0,350,5,-80.8,-77,-86,9
26,LL,0,350,7,-80.8571428571429,-77,-86,9
26,LL,1,350,10,-81,-77,-87,10
26,LL,0,350,7,-80.7142857142857,-77,-87,10
26,LL,0,350,1,-92,-92,-92,0
26,LL,0,350,4,-85,-80,-92,12
26,LL,0,350,8,-80.75,-78,-88,10
26,LL,0,350,5,-81.6,-79,-90,11
26,LL,0,350,6,-82.3333333333333,-77,-90,13
26,LL,0,350,2,-79.5,-77,-82,5
26,LL,0,350,1,-80,-80,-80,0
26,LL,0,350,3,-80.6666666666667,-78,-82,4
26,LL,0,350,4,-81,-80,-83,3
26,LL,0,350,8,-81.25,-75,-86,11
26,LL,0,350,4,-79.5,-76,-83,7
26,LL,0,350,3,-81.3333333333333,-78,-86,8
26,LL,1,350,10,-77,-75,-84,9
26,LL,1,350,9,-77,-75,-84,9
26,LL,0,350,2,-81,-78,-84,6
26,LL,1,350,9,-78.2222222222222,-74,-90,16
26,LL,0,350,5,-80,-78,-82,4
26,LL,0,350,3,-79.3333333333333,-77,-82,5
26,LL,0,350,5,-81.8,-76,-89,13
26,LL,0,350,5,-78.8,-75,-84,9
26,LL,0,350,5,-77.8,-75,-80,5
26,LL,0,350,4,-78.5,-76,-80,4
26,LL,1,350,9,-83.1111111111111,-79,-86,7
26,LL,0,350,4,-80,-79,-82,3
26,LL,0,350,4,-83.5,-77,-89,12
31,RR,1,400,9,-81,-71,-96,25
31,RR,0,400,4,-77.25,-71,-85,14
31,RR,0,400,5,-80.6,-71,-96,25
31,RR,1,400,9,-79.3333333333333,-77,-86,9
31,RR,0,400,2,-82.5,-79,-86,7
31,RR,0,400,1,-79,-79,-79,0
31,RR,1,400,9,-78,-76,-80,4
31,RR,1,400,9,-78.1111111111111,-76,-80,4
31,RR,0,400,6,-76.3333333333333,-74,-80,6
31,RR,0,400,8,-77.625,-74,-88,14
31,RR,0,400,7,-80.1428571428571,-76,-88,12
31,RR,0,400,8,-78.375,-76,-82,6
31,RR,1,400,10,-78.5,-77,-82,5
31,RR,1,400,10,-80,-78,-82,4
31,RR,0,400,3,-79,-78,-80,2
31,RR,0,400,6,-80.5,-78,-82,4
31,RR,0,400,3,-81.3333333333333,-80,-82,2
31,RR,0,400,4,-78,-77,-79,2
31,RR,0,400,5,-78.8,-77,-80,3
31,RR,0,400,8,-78.375,-75,-80,5
31,RR,0,400,2,-76,-75,-77,2
31,RR,1,400,9,-78.7777777777778,-75,-81,6
31,RR,0,400,5,-79.2,-77,-81,4
31,RR,0,400,3,-80.3333333333333,-79,-81,2
31,RR,0,400,1,-81,-81,-81,0
31,RR,0,400,2,-82,-81,-83,2
31,RR,0,400,3,-76.6666666666667,-76,-77,1
31,RR,0,400,3,-78.6666666666667,-77,-82,5
31,RR,0,400,3,-80,-77,-82,5
31,RR,1,400,9,-80.1111111111111,-76,-94,18
31,RR,1,400,10,-80,-76,-94,18
31,RR,0,400,5,-79.6,-78,-80,2
31,RR,0,400,5,-79.2,-78,-80,2
31,RR,0,400,2,-78.5,-78,-79,1
31,RR,0,400,2,-77,-76,-78,2
31,RR,0,400,3,-78.6666666666667,-78,-79,1
31,RR,0,400,6,-78.8333333333333,-77,-80,3
31,RR,1,400,10,-79.6,-76,-83,7
31,RR,0,400,5,-80.4,-79,-83,4
31,RR,0,400,2,-76.5,-76,-77,1
31,RR,0,400,6,-77.8333333333333,-77,-79,2
31,RR,0,400,6,-77.3333333333333,-77,-78,1
31,RR,1,400,10,-78.8,-77,-82,5
31,RR,0,400,5,-79.6,-77,-82,5
31,RR,0,400,6,-80.3333333333333,-79,-84,5
31,RR,0,400,3,-87.6666666666667,-80,-98,18
31,RR,0,400,6,-83.3333333333333,-80,-86,6
31,RR,1,400,9,-83.5555555555556,-80,-86,6
31,RR,0,400,1,-86,-86,-86,0
31,RR,1,400,10,-82.2,-77,-85,8
31,RR,0,400,3,-80,-77,-82,5
31,RR,0,400,2,-80.5,-79,-82,3
31,RR,0,400,3,-81,-78,-83,5
31,RR,1,400,10,-81.9,-77,-88,11
31,RR,1,400,10,-77.6,-74,-81,7
31,RR,0,400,2,-76,-75,-77,2
31,RR,0,400,3,-79.3333333333333,-77,-81,4
31,RR,1,400,10,-77.4,-75,-80,5
31,RR,0,400,8,-77.375,-75,-80,5
31,RR,0,400,3,-76.3333333333333,-75,-78,3
31,RR,0,400,6,-78,-75,-80,5
31,RR,1,400,9,-77.6666666666667,-75,-80,5
31,RR,0,400,3,-84,-79,-88,9
31,RR,1,400,9,-82.3333333333333,-79,-88,9
31,RR,0,400,3,-80.3333333333333,-79,-82,3
31,RR,0,400,7,-82,-80,-85,5
31,RR,0,400,7,-82.7142857142857,-76,-93,17
31,RR,0,400,1,-81,-81,-81,0
31,RR,0,400,1,-86,-86,-86,0
31,RR,0,400,7,-91.2857142857143,-84,-95,11
31,RR,0,400,3,-91.6666666666667,-88,-95,7
31,RR,0,400,8,-90.25,-84,-93,9
31,RR,0,400,6,-91,-85,-93,8
31,RR,0,400,3,-88.6666666666667,-87,-91,4
31,RR,0,400,4,-85.5,-82,-88,6
31,RR,1,400,9,-88.5555555555556,-82,-94,12
31,RR,1,400,10,-89.9,-85,-101,16
31,RR,0,400,8,-87.125,-81,-94,13
31,RR,0,400,4,-90,-83,-94,11
31,RR,0,400,2,-91.5,-90,-93,3
31,RR,0,400,1,-84,-84,-84,0
31,RR,0,400,8,-92.375,-87,-100,13
31,RR,0,400,4,-83.75,-78,-92,14
31,LL,0,400,6,-84.3333333333333,-77,-92,15
31,LL,0,400,8,-82.5,-74,-92,18
31,LL,0,400,4,-80.75,-74,-87,13
31,LL,0,400,6,-79.1666666666667,-74,-87,13
31,LL,0,400,4,-82,-81,-83,2
31,LL,0,400,7,-83.2857142857143,-80,-88,8
31,LL,0,400,3,-84.3333333333333,-84,-85,1
31,LL,0,400,5,-87.2,-84,-91,7
31,LL,0,400,6,-89.5,-86,-94,8
31,LL,0,400,7,-88.8571428571429,-87,-94,7
31,LL,0,400,1,-88,-88,-88,0
31,LL,0,400,8,-88.375,-86,-91,5
31,LL,0,400,8,-87.625,-80,-91,11
31,LL,0,400,5,-88.6,-86,-91,5
31,LL,0,400,4,-87.75,-80,-91,11
31,LL,0,400,7,-84.2857142857143,-81,-90,9
31,LL,0,400,6,-84.5,-81,-89,8
31,LL,0,400,1,-81,-81,-81,0
31,LL,0,400,6,-85.5,-81,-92,11
31,LL,0,400,1,-82,-82,-82,0
31,LL,0,400,7,-87.2857142857143,-82,-92,10
31,LL,0,400,4,-85,-80,-91,11
31,LL,0,400,8,-86.5,-81,-92,11
31,LL,1,400,9,-87.4444444444444,-81,-93,12
31,LL,1,400,10,-86.5,-82,-93,11
31,LL,0,400,4,-89.25,-85,-93,8
31,LL,1,400,9,-83.7777777777778,-81,-89,8
31,LL,0,400,1,-83,-83,-83,0
31,LL,0,400,6,-84.5,-82,-87,5
31,LL,0,400,7,-84.7142857142857,-81,-88,7
31,LL,1,400,9,-84.7777777777778,-81,-88,7
31,LL,1,400,10,-85.7,-81,-91,10
31,LL,0,400,8,-81.625,-78,-86,8
31,LL,0,400,5,-81.6,-78,-86,8
31,LL,1,400,10,-80.9,-74,-89,15
31,LL,0,400,3,-80,-74,-83,9
31,LL,0,400,3,-82.6666666666667,-75,-88,13
31,LL,0,400,7,-81.4285714285714,-77,-91,14
31,LL,0,400,5,-80,-77,-83,6
31,LL,0,400,6,-84.5,-78,-95,17
31,LL,0,400,3,-81.6666666666667,-80,-84,4
31,LL,0,400,6,-83,-79,-92,13
31,LL,0,400,1,-81,-81,-81,0
31,LL,0,400,1,-78,-78,-78,0
31,LL,1,400,9,-81.1111111111111,-77,-94,17
31,LL,0,400,7,-84.1428571428571,-77,-94,17
31,LL,0,400,2,-86,-80,-92,12
31,LL,0,400,2,-85,-78,-92,14
31,LL,0,400,7,-83.2857142857143,-79,-91,12
31,LL,0,400,1,-82,-82,-82,0
31,LL,0,400,6,-86.5,-83,-92,9
31,LL,0,400,8,-85.875,-82,-92,10
31,LL,1,400,10,-85.5,-82,-92,10
31,LL,0,400,6,-85.1666666666667,-82,-88,6
31,LL,0,400,2,-84,-82,-86,4
31,LL,0,400,6,-86.1666666666667,-84,-89,5
31,LL,0,400,8,-84,-82,-89,7
31,LL,0,400,1,-84,-84,-84,0
31,LL,1,400,9,-84,-82,-89,7
31,LL,0,400,5,-84.2,-82,-89,7
31,LL,0,400,6,-83,-81,-85,4
31,LL,1,400,10,-84.1,-81,-92,11
31,LL,0,400,1,-82,-82,-82,0
31,LL,0,400,3,-78.3333333333333,-78,-79,1
31,LL,0,400,6,-79.1666666666667,-78,-81,3
31,LL,0,400,6,-82.6666666666667,-77,-90,13
31,LL,0,400,4,-86.75,-79,-90,11
31,LL,0,400,4,-88.25,-86,-90,4
31,LL,0,400,1,-84,-84,-84,0
31,LL,0,400,8,-89.125,-86,-94,8
31,LL,0,400,5,-85,-81,-87,6
31,LL,1,400,9,-86.6666666666667,-83,-88,5
31,LL,0,400,2,-86.5,-86,-87,1
31,LL,0,400,2,-88,-88,-88,0
31,LL,0,400,5,-86.4,-80,-91,11
31,LL,0,400,1,-87,-87,-87,0
31,LL,0,400,5,-87,-85,-91,6
26,RR,0,400,4,-77.5,-75,-82,7
26,RR,0,400,7,-77,-76,-79,3
26,RR,0,400,3,-76.3333333333333,-76,-77,1
26,RR,0,400,8,-76.75,-75,-79,4
26,RR,1,400,10,-77,-75,-79,4
26,RR,0,400,3,-75.6666666666667,-75,-76,1
26,RR,0,400,8,-77,-75,-80,5
26,RR,0,400,8,-76.875,-76,-78,2
26,RR,0,400,6,-75.3333333333333,-72,-79,7
26,RR,0,400,6,-78.3333333333333,-77,-79,2
26,RR,1,400,10,-78,-74,-82,8
26,RR,0,400,1,-77,-77,-77,0
26,RR,1,400,10,-75.1,-73,-81,8
26,RR,0,400,2,-76.5,-76,-77,1
26,RR,0,400,1,-79,-79,-79,0
26,RR,0,400,8,-78.75,-74,-81,7
26,RR,0,400,4,-78.75,-77,-80,3
26,RR,0,400,2,-79.5,-78,-81,3
26,RR,0,400,8,-79.125,-77,-81,4
26,RR,0,400,2,-79.5,-79,-80,1
26,RR,0,400,4,-80.75,-79,-84,5
26,RR,1,400,9,-81.2222222222222,-77,-87,10
26,RR,0,400,5,-81.2,-79,-84,5
26,RR,0,400,2,-80,-79,-81,2
26,RR,1,400,10,-76.6,-75,-78,3
26,RR,0,400,5,-77.4,-76,-79,3
26,RR,0,400,8,-77,-75,-79,4
26,RR,0,400,6,-78.8333333333333,-75,-90,15
26,RR,0,400,2,-77,-77,-77,0
26,RR,0,400,6,-76.8333333333333,-74,-79,5
26,RR,0,400,5,-75.8,-75,-77,2
26,RR,0,400,4,-75.25,-74,-76,2
26,RR,0,400,1,-74,-74,-74,0
26,RR,1,400,9,-77.3333333333333,-75,-79,4
26,RR,0,400,2,-75.5,-75,-76,1
26,RR,0,400,7,-78.2857142857143,-78,-79,1
26,RR,0,400,4,-77.75,-77,-78,1
26,RR,0,400,2,-79,-76,-82,6
26,RR,0,400,5,-80.8,-79,-84,5
26,RR,0,400,3,-81.6666666666667,-80,-84,4
26,RR,0,400,4,-77.25,-75,-79,4
26,RR,0,400,6,-77.1666666666667,-76,-79,3
26,RR,0,400,5,-76.8,-76,-78,2
26,RR,1,400,10,-82.8,-77,-93,16
26,RR,0,400,4,-86,-79,-93,14
26,RR,0,400,2,-85.5,-85,-86,1
26,RR,0,400,4,-81.75,-80,-84,4
26,RR,0,400,2,-81.5,-81,-82,1
26,RR,0,400,8,-82.375,-78,-95,17
26,RR,0,400,7,-78.5714285714286,-76,-83,7
26,RR,1,400,9,-77.5555555555556,-74,-80,6
26,RR,0,400,2,-79.5,-79,-80,1
26,RR,0,400,6,-77,-73,-80,7
26,RR,0,400,1,-79,-79,-79,0
26,RR,0,400,7,-76.1428571428571,-73,-80,7
26,RR,0,400,3,-77,-76,-79,3
26,RR,0,400,5,-81,-78,-85,7
26,RR,0,400,6,-80.8333333333333,-78,-85,7
26,RR,0,400,4,-81,-79,-85,6
26,RR,0,400,4,-80.75,-79,-85,6
26,RR,0,400,7,-81.7142857142857,-79,-86,7
26,RR,0,400,1,-83,-83,-83,0
26,RR,0,400,3,-93.6666666666667,-90,-97,7
26,RR,0,400,2,-87.5,-87,-88,1
26,RR,1,400,10,-88.2,-84,-94,10
26,RR,0,400,7,-87.7142857142857,-84,-92,8
26,RR,1,400,10,-89.3,-84,-96,12
26,RR,0,400,6,-88.8333333333333,-84,-94,10
26,RR,0,400,5,-91,-84,-98,14
26,RR,1,400,10,-85.3,-77,-98,21
26,RR,1,400,10,-84.7,-77,-92,15
26,RR,0,400,3,-89.6666666666667,-89,-90,1
26,RR,0,400,4,-91.25,-81,-97,16
26,RR,0,400,4,-83.75,-78,-87,9
26,RR,0,400,3,-84.3333333333333,-81,-90,9
26,RR,1,400,9,-81.8888888888889,-76,-87,11
26,LL,0,400,5,-84.6,-79,-88,9
26,LL,0,400,1,-88,-88,-88,0
26,LL,0,400,4,-91.5,-87,-98,11
26,LL,0,400,2,-87.5,-87,-88,1
26,LL,0,400,8,-81.375,-77,-88,11
26,LL,0,400,2,-77.5,-77,-78,1
26,LL,0,400,2,-84.5,-83,-86,3
26,LL,0,400,1,-84,-84,-84,0
26,LL,0,400,1,-86,-86,-86,0
26,LL,0,400,5,-86.6,-84,-94,10
26,LL,1,400,9,-87.3333333333333,-82,-94,12
26,LL,0,400,4,-86.75,-82,-94,12
26,LL,0,400,6,-87,-82,-94,12
26,LL,1,400,10,-83.7,-78,-90,12
26,LL,1,400,10,-83.8,-78,-90,12
26,LL,0,400,1,-79,-79,-79,0
26,LL,0,400,8,-85,-80,-89,9
26,LL,0,400,2,-83,-80,-86,6
26,LL,0,400,4,-85,-80,-89,9
26,LL,0,400,5,-86,-80,-90,10
26,LL,0,400,8,-86.125,-80,-90,10
26,LL,0,400,2,-86.5,-86,-87,1
26,LL,0,400,2,-88.5,-87,-90,3
26,LL,1,400,9,-85.8888888888889,-81,-89,8
26,LL,0,400,6,-85.8333333333333,-82,-89,7
26,LL,0,400,8,-85.125,-80,-91,11
26,LL,0,400,6,-84.6666666666667,-80,-89,9
26,LL,0,400,6,-85.3333333333333,-80,-91,11
26,LL,0,400,2,-89.5,-88,-91,3
26,LL,0,400,8,-85.625,-81,-88,7
26,LL,0,400,4,-84.5,-81,-88,7
26,LL,0,400,2,-84.5,-81,-88,7
26,LL,0,400,3,-83.3333333333333,-80,-86,6
26,LL,0,400,2,-89.5,-87,-92,5
26,LL,0,400,8,-84.5,-81,-89,8
26,LL,0,400,7,-83.8571428571429,-82,-87,5
26,LL,0,400,7,-85.7142857142857,-81,-91,10
26,LL,0,400,5,-86.6,-82,-91,9
26,LL,1,400,10,-89.1,-81,-97,16
26,LL,0,400,8,-83.5,-72,-91,19
26,LL,1,400,9,-84.8888888888889,-76,-98,22
26,LL,0,400,1,-76,-76,-76,0
26,LL,0,400,7,-84.8571428571429,-75,-98,23
26,LL,0,400,6,-83.6666666666667,-79,-92,13
26,LL,1,400,9,-80.1111111111111,-74,-88,14
26,LL,0,400,2,-84.5,-82,-87,5
26,LL,0,400,8,-85.625,-75,-95,20
26,LL,0,400,3,-89,-80,-95,15
26,LL,0,400,8,-84.375,-74,-94,20
26,LL,1,400,10,-83.3,-74,-94,20
26,LL,0,400,6,-82.1666666666667,-74,-94,20
26,LL,0,400,6,-84,-74,-94,20
26,LL,1,400,9,-83.7777777777778,-74,-94,20
26,LL,0,400,1,-93,-93,-93,0
26,LL,1,400,9,-81.3333333333333,-78,-90,12
26,LL,0,400,6,-82.3333333333333,-78,-90,12
26,LL,0,400,3,-79.6666666666667,-79,-80,1
26,LL,0,400,5,-78,-77,-79,2
26,LL,1,400,9,-84.6666666666667,-78,-97,19
26,LL,0,400,6,-86.5,-82,-97,15
26,LL,0,400,2,-83.5,-83,-84,1
26,LL,0,400,7,-83.8571428571429,-83,-86,3
26,LL,1,400,9,-83.7777777777778,-80,-88,8
26,LL,0,400,2,-84.5,-83,-86,3
26,LL,0,400,8,-83.125,-80,-88,8
26,LL,0,400,5,-81.6,-79,-86,7
26,LL,0,400,2,-84,-82,-86,4
26,LL,0,400,1,-86,-86,-86,0
26,LL,0,400,7,-78,-76,-81,5
26,LL,0,400,5,-77.6,-76,-80,4
26,LL,0,400,6,-78.6666666666667,-76,-85,9
26,LL,0,400,2,-77,-76,-78,2
26,LL,0,400,6,-79.3333333333333,-76,-85,9
26,LL,0,400,6,-78.3333333333333,-76,-81,5
26,LL,0,400,3,-86.6666666666667,-82,-92,10
26,LL,0,400,5,-89.2,-86,-97,11
26,LL,0,400,4,-89.5,-86,-97,11
26,LL,0,400,7,-90.1428571428571,-86,-99,13
26,LL,1,400,9,-89.1111111111111,-83,-99,16
26,LL,0,400,6,-86.3333333333333,-80,-92,12
26,LL,0,400,4,-85,-82,-86,4
26,LL,0,400,7,-85.5714285714286,-82,-88,6
26,LL,0,400,1,-86,-86,-86,0
26,LL,0,400,3,-84.3333333333333,-79,-88,9
26,LL,0,400,1,-86,-86,-86,0
31,RR,0,450,7,-80,-76,-86,10
31,RR,1,450,9,-82.6666666666667,-76,-92,16
31,RR,0,450,1,-96,-96,-96,0
31,RR,0,450,7,-89.2857142857143,-85,-92,7
31,RR,0,450,7,-90.5714285714286,-88,-96,8
31,RR,0,450,8,-89.625,-87,-96,9
31,RR,0,450,8,-87.5,-83,-92,9
31,RR,0,450,4,-84.75,-83,-88,5
31,RR,0,450,6,-88.1666666666667,-83,-92,9
31,RR,1,450,10,-89.8,-85,-95,10
31,RR,0,450,7,-90.1428571428571,-85,-95,10
31,RR,0,450,7,-85.1428571428571,-82,-88,6
31,RR,0,450,8,-87.125,-84,-93,9
31,RR,0,450,6,-87.3333333333333,-84,-93,9
31,RR,0,450,4,-88,-84,-93,9
31,RR,0,450,3,-90.3333333333333,-83,-98,15
31,RR,0,450,2,-85.5,-82,-89,7
31,RR,0,450,7,-84.2857142857143,-81,-87,6
31,RR,0,450,1,-84,-84,-84,0
31,RR,0,450,6,-83.1666666666667,-80,-86,6
31,RR,0,450,6,-82.8333333333333,-81,-84,3
31,RR,0,450,5,-83,-81,-84,3
31,RR,0,450,2,-82.5,-81,-84,3
31,RR,1,450,10,-81.2,-77,-84,7
31,RR,1,450,9,-85.3333333333333,-83,-89,6
31,RR,0,450,4,-83.5,-83,-85,2
31,RR,0,450,7,-85.8571428571429,-82,-93,11
31,RR,0,450,2,-82.5,-82,-83,1
31,RR,0,450,2,-84.5,-84,-85,1
31,RR,0,450,1,-80,-80,-80,0
31,RR,0,450,1,-84,-84,-84,0
31,RR,0,450,7,-85.5714285714286,-82,-93,11
31,RR,0,450,6,-88.8333333333333,-85,-92,7
31,RR,0,450,6,-86.3333333333333,-83,-91,8
31,RR,0,450,5,-84,-81,-87,6
31,RR,0,450,3,-82,-79,-85,6
31,RR,0,450,1,-88,-88,-88,0
31,RR,0,450,5,-82.6,-81,-86,5
31,RR,1,450,10,-81.8,-80,-84,4
31,RR,0,450,5,-81.8,-80,-84,4
31,RR,1,450,10,-82.1,-80,-85,5
31,RR,1,450,10,-83.9,-81,-90,9
31,RR,0,450,8,-85.625,-79,-96,17
31,RR,0,450,2,-83.5,-81,-86,5
31,RR,0,450,6,-84.1666666666667,-78,-91,13
31,RR,0,450,6,-84,-78,-89,11
31,RR,0,450,6,-84.8333333333333,-77,-90,13
31,RR,0,450,1,-87,-87,-87,0
31,RR,0,450,5,-85,-77,-90,13
31,RR,0,450,2,-85,-84,-86,2
31,RR,0,450,7,-84,-78,-92,14
31,RR,0,450,2,-85.5,-83,-88,5
31,RR,0,450,7,-86.4285714285714,-82,-91,9
31,RR,0,450,6,-87.3333333333333,-82,-92,10
31,RR,0,450,5,-87.6,-83,-92,9
31,RR,1,450,9,-87.1111111111111,-84,-92,8
31,RR,1,450,10,-84.6,-81,-88,7
31,RR,1,450,10,-85.1,-81,-94,13
31,RR,0,450,4,-83.25,-81,-85,4
31,RR,1,450,10,-84.9,-81,-94,13
31,RR,0,450,4,-83.75,-79,-87,8
31,RR,0,450,2,-83,-79,-87,8
31,RR,0,450,7,-88.5714285714286,-80,-94,14
31,RR,0,450,1,-85,-85,-85,0
31,RR,0,450,7,-85.7142857142857,-79,-93,14
31,RR,1,450,9,-81.5555555555556,-78,-88,10
31,RR,0,450,3,-80.3333333333333,-78,-82,4
31,RR,0,450,1,-84,-84,-84,0
31,RR,0,450,1,-83,-83,-83,0
31,RR,0,450,8,-84.5,-81,-86,5
31,RR,0,450,2,-86,-86,-86,0
31,RR,0,450,5,-83.4,-76,-88,12
31,RR,0,450,8,-83.25,-76,-90,14
31,RR,0,450,7,-83.2857142857143,-81,-90,9
31,RR,0,450,6,-82.1666666666667,-74,-90,16
31,RR,1,450,10,-81.5,-74,-90,16
31,RR,0,450,8,-80,-74,-84,10
31,RR,0,450,5,-80.6,-77,-84,7
31,LL,0,450,3,-83.3333333333333,-81,-86,5
31,LL,0,450,6,-82.1666666666667,-80,-86,6
31,LL,0,450,7,-81.2857142857143,-78,-86,8
31,LL,0,450,3,-79,-78,-81,3
31,LL,0,450,8,-80.125,-78,-85,7
31,LL,0,450,2,-85.5,-84,-87,3
31,LL,0,450,2,-81.5,-81,-82,1
31,LL,0,450,1,-85,-85,-85,0
31,LL,0,450,8,-82.625,-80,-86,6
31,LL,0,450,4,-82.25,-80,-84,4
31,LL,0,450,2,-83,-81,-85,4
31,LL,0,450,4,-82.75,-81,-85,4
31,LL,0,450,2,-81.5,-81,-82,1
31,LL,0,450,3,-81,-81,-81,0
31,LL,0,450,1,-81,-81,-81,0
31,LL,0,450,7,-82.8571428571429,-81,-86,5
31,LL,0,450,8,-83.125,-81,-86,5
31,LL,1,450,9,-83.4444444444444,-81,-86,5
31,LL,0,450,8,-82.5,-82,-83,1
31,LL,1,450,9,-82.5555555555556,-81,-84,3
31,LL,0,450,8,-81.75,-80,-84,4
31,LL,1,450,10,-82,-80,-86,6
31,LL,0,450,1,-81,-81,-81,0
31,LL,0,450,6,-83.6666666666667,-81,-86,5
31,LL,0,450,8,-83,-81,-86,5
31,LL,1,450,9,-83.2222222222222,-81,-87,6
31,LL,0,450,7,-83.2857142857143,-81,-86,5
31,LL,1,450,9,-85.1111111111111,-80,-95,15
31,LL,0,450,1,-87,-87,-87,0
31,LL,0,450,8,-87.875,-86,-95,9
31,LL,0,450,6,-86.8333333333333,-81,-91,10
31,LL,0,450,5,-88.2,-82,-92,10
31,LL,0,450,3,-90.3333333333333,-87,-94,7
31,LL,1,450,10,-92.3,-87,-100,13
31,LL,1,450,10,-93.2,-87,-101,14
31,LL,0,450,4,-92,-87,-95,8
31,LL,1,450,9,-91.6666666666667,-86,-100,14
31,LL,0,450,6,-90.6666666666667,-86,-100,14
31,LL,0,450,1,-91,-91,-91,0
31,LL,0,450,8,-88.75,-85,-95,10
31,LL,0,450,6,-88.5,-85,-95,10
31,LL,0,450,6,-89.5,-85,-99,14
31,LL,0,450,5,-87.6,-86,-90,4
31,LL,0,450,6,-91.1666666666667,-86,-102,16
31,LL,0,450,1,-87,-87,-87,0
31,LL,0,450,8,-87.75,-87,-90,3
31,LL,0,450,4,-87.5,-87,-89,2
31,LL,0,450,3,-94,-89,-97,8
31,LL,0,450,1,-89,-89,-89,0
31,LL,0,450,4,-91.25,-90,-93,3
31,LL,0,450,4,-90,-87,-94,7
31,LL,1,450,9,-90.7777777777778,-85,-94,9
31,LL,0,450,3,-93,-85,-100,15
31,LL,0,450,6,-87,-84,-92,8
31,LL,0,450,1,-95,-95,-95,0
31,LL,0,450,3,-96.3333333333333,-86,-104,18
31,LL,1,450,10,-91.5,-87,-101,14
31,LL,0,450,5,-90.4,-87,-99,12
31,LL,0,450,2,-89.5,-87,-92,5
31,LL,0,450,5,-92.4,-86,-101,15
31,LL,0,450,1,-86,-86,-86,0
31,LL,0,450,3,-90.3333333333333,-87,-93,6
31,LL,0,450,1,-87,-87,-87,0
31,LL,0,450,7,-91.5714285714286,-86,-98,12
31,LL,1,450,9,-91.6666666666667,-86,-98,12
31,LL,0,450,4,-90.75,-86,-98,12
31,LL,0,450,2,-88.5,-87,-90,3
31,LL,0,450,5,-89.6,-86,-101,15
31,LL,0,450,2,-86,-84,-88,4
31,LL,0,450,5,-87.8,-84,-91,7
31,LL,1,450,10,-93.8,-89,-99,10
31,LL,0,450,3,-89.6666666666667,-89,-91,2
31,LL,1,450,9,-93.6666666666667,-84,-99,15
31,LL,0,450,5,-97.4,-96,-99,3
31,LL,0,450,5,-96.4,-92,-99,7
31,LL,0,450,8,-90.75,-84,-98,14
31,LL,0,450,3,-93.3333333333333,-91,-97,6
31,LL,0,450,7,-88.4285714285714,-84,-92,8
31,LL,0,450,5,-87.8,-84,-91,7
31,LL,0,450,3,-87.3333333333333,-86,-88,2
31,LL,0,450,6,-90.3333333333333,-85,-97,12
31,LL,0,450,1,-92,-92,-92,0
31,LL,0,450,2,-85.5,-85,-86,1
31,LL,0,450,6,-91.8333333333333,-86,-100,14
31,LL,0,450,6,-92.1666666666667,-86,-100,14
31,LL,0,450,5,-89.2,-84,-99,15
31,LL,0,450,1,-99,-99,-99,0
31,LL,0,450,7,-90.8571428571429,-83,-99,16
31,LL,0,450,4,-91,-83,-98,15
26,RR,0,450,7,-83.4285714285714,-77,-95,18
26,RR,0,450,7,-84.7142857142857,-80,-95,15
26,RR,1,450,9,-88.7777777777778,-86,-94,8
26,RR,0,450,4,-87.75,-86,-90,4
26,RR,1,450,10,-91.5,-85,-98,13
26,RR,1,450,9,-92.4444444444444,-88,-98,10
26,RR,0,450,2,-90.5,-88,-93,5
26,RR,1,450,10,-89.9,-84,-99,15
26,RR,0,450,2,-93,-87,-99,12
26,RR,0,450,5,-88.8,-84,-92,8
26,RR,1,450,10,-89.5,-84,-98,14
26,RR,0,450,4,-90.75,-85,-98,13
26,RR,0,450,3,-88.3333333333333,-85,-92,7
26,RR,0,450,4,-88.75,-83,-96,13
26,RR,0,450,4,-91.75,-88,-95,7
26,RR,0,450,7,-84.1428571428571,-81,-87,6
26,RR,0,450,2,-85.5,-84,-87,3
26,RR,0,450,2,-83,-82,-84,2
26,RR,0,450,4,-83.75,-82,-86,4
26,RR,0,450,8,-82.875,-82,-84,2
26,RR,0,450,7,-83,-79,-85,6
26,RR,0,450,8,-80.375,-75,-83,8
26,RR,0,450,4,-83,-83,-83,0
26,RR,0,450,2,-83,-83,-83,0
26,RR,0,450,2,-87.5,-83,-92,9
26,RR,1,450,9,-86.7777777777778,-84,-90,6
26,RR,0,450,4,-87,-84,-90,6
26,RR,0,450,5,-86,-84,-88,4
26,RR,0,450,7,-83.1428571428571,-82,-84,2
26,RR,0,450,2,-83.5,-81,-86,5
26,RR,1,450,9,-85.6666666666667,-83,-92,9
26,RR,0,450,1,-87,-87,-87,0
26,RR,0,450,2,-83,-80,-86,6
26,RR,0,450,8,-80.75,-78,-84,6
26,RR,1,450,10,-80.7,-78,-84,6
26,RR,0,450,4,-81,-78,-83,5
26,RR,0,450,1,-83,-83,-83,0
26,RR,0,450,6,-83,-81,-87,6
26,RR,1,450,10,-82.2,-79,-87,8
26,RR,0,450,3,-83.6666666666667,-82,-87,5
26,RR,0,450,6,-81.5,-79,-85,6
26,RR,1,450,10,-81,-79,-84,5
26,RR,0,450,7,-84.4285714285714,-79,-87,8
26,RR,0,450,8,-82.25,-77,-87,10
26,RR,0,450,2,-84,-81,-87,6
26,RR,1,450,10,-80.8,-77,-92,15
26,RR,0,450,1,-77,-77,-77,0
26,RR,0,450,3,-82.3333333333333,-77,-86,9
26,RR,1,450,10,-84.7,-75,-91,16
26,RR,0,450,1,-86,-86,-86,0
26,RR,0,450,4,-86.25,-75,-91,16
26,RR,0,450,1,-91,-91,-91,0
26,RR,0,450,6,-82.1666666666667,-76,-94,18
26,RR,0,450,3,-79,-77,-83,6
26,RR,1,450,9,-84.5555555555556,-74,-94,20
26,RR,1,450,10,-85.5,-79,-93,14
26,RR,0,450,5,-84.6,-82,-88,6
26,RR,0,450,4,-83,-79,-86,7
26,RR,0,450,5,-85,-79,-93,14
26,RR,1,450,9,-84.7777777777778,-79,-89,10
26,RR,0,450,4,-84.75,-79,-87,8
26,RR,0,450,2,-83,-79,-87,8
26,RR,0,450,6,-84.8333333333333,-80,-92,12
26,RR,0,450,4,-82.5,-80,-85,5
26,RR,0,450,7,-87.1428571428571,-80,-95,15
26,RR,0,450,1,-85,-85,-85,0
26,RR,0,450,3,-85,-80,-89,9
26,RR,0,450,3,-85.6666666666667,-79,-89,10
26,RR,0,450,2,-84,-79,-89,10
26,RR,0,450,5,-86.2,-80,-93,13
26,RR,1,450,10,-86.3,-79,-95,16
26,RR,0,450,3,-85.6666666666667,-79,-95,16
26,RR,0,450,1,-83,-83,-83,0
26,RR,0,450,4,-86.25,-78,-95,17
26,RR,0,450,6,-85.8333333333333,-78,-95,17
26,RR,0,450,2,-90,-85,-95,10
26,RR,0,450,2,-85,-83,-87,4
26,RR,0,450,5,-80.4,-78,-83,5
26,RR,1,450,9,-81.1111111111111,-79,-83,4
26,RR,0,450,2,-80.5,-79,-82,3
26,RR,1,450,9,-82.3333333333333,-80,-84,4
26,RR,0,450,4,-82.25,-81,-84,3
26,RR,0,450,6,-82.1666666666667,-81,-84,3
26,RR,0,450,4,-81,-75,-86,11
26,RR,0,450,8,-84,-83,-86,3
26,LL,0,450,2,-85,-83,-87,4
26,LL,0,450,7,-81.5714285714286,-76,-86,10
26,LL,0,450,3,-81,-78,-86,8
26,LL,0,450,4,-80.25,-78,-86,8
26,LL,0,450,6,-79.8333333333333,-78,-86,8
26,LL,0,450,2,-79,-78,-80,2
26,LL,0,450,6,-79.1666666666667,-78,-82,4
26,LL,0,450,3,-79,-78,-81,3
26,LL,0,450,2,-80.5,-78,-83,5
26,LL,0,450,4,-82.5,-80,-86,6
26,LL,1,450,9,-82.2222222222222,-80,-85,5
26,LL,0,450,3,-81,-80,-82,2
26,LL,0,450,7,-83.4285714285714,-80,-86,6
26,LL,1,450,10,-81.9,-79,-86,7
26,LL,0,450,5,-83.8,-82,-86,4
26,LL,0,450,2,-81.5,-81,-82,1
26,LL,0,450,4,-80.75,-80,-82,2
26,LL,0,450,2,-80.5,-80,-81,1
26,LL,0,450,1,-81,-81,-81,0
26,LL,1,450,10,-82.2,-80,-85,5
26,LL,0,450,5,-83,-80,-86,6
26,LL,1,450,10,-82.6,-80,-86,6
26,LL,1,450,9,-82.1111111111111,-80,-84,4
26,LL,0,450,1,-80,-80,-80,0
26,LL,0,450,5,-86,-82,-90,8
26,LL,0,450,8,-86.125,-82,-90,8
26,LL,0,450,1,-90,-90,-90,0
26,LL,1,450,9,-85.8888888888889,-83,-89,6
26,LL,0,450,3,-86,-85,-87,2
26,LL,0,450,4,-87,-84,-90,6
26,LL,0,450,8,-84.375,-80,-89,9
26,LL,1,450,10,-87.6,-85,-95,10
26,LL,1,450,10,-88.2,-85,-95,10
26,LL,0,450,2,-85.5,-85,-86,1
26,LL,0,450,5,-89,-85,-95,10
26,LL,1,450,10,-89.1,-83,-97,14
26,LL,0,450,3,-91.6666666666667,-86,-97,11
26,LL,0,450,3,-89,-83,-92,9
26,LL,0,450,6,-89.8333333333333,-85,-94,9
26,LL,1,450,9,-91,-86,-97,11
26,LL,0,450,1,-86,-86,-86,0
26,LL,0,450,8,-88,-84,-96,12
26,LL,1,450,10,-89.3,-86,-99,13
26,LL,0,450,4,-89.5,-86,-99,13
26,LL,0,450,2,-91.5,-87,-96,9
26,LL,1,450,10,-88.8,-86,-95,9
26,LL,0,450,8,-88.75,-86,-92,6
26,LL,0,450,1,-91,-91,-91,0
26,LL,1,450,9,-88.5555555555556,-82,-95,13
26,LL,0,450,8,-87.625,-82,-95,13
26,LL,0,450,4,-88.5,-85,-98,13
26,LL,0,450,7,-90.1428571428571,-84,-100,16
26,LL,0,450,5,-89.2,-84,-100,16
26,LL,0,450,2,-91,-85,-97,12
26,LL,1,450,10,-88.5,-83,-98,15
26,LL,0,450,8,-87,-83,-91,8
26,LL,0,450,1,-91,-91,-91,0
26,LL,0,450,2,-85.5,-85,-86,1
26,LL,0,450,6,-83.6666666666667,-74,-90,16
26,LL,0,450,3,-95.3333333333333,-94,-98,4
31,RR,1,500,10,-86.6,-81,-92,11
31,RR,0,500,7,-89.7142857142857,-81,-101,20
31,RR,0,500,3,-86.3333333333333,-85,-88,3
31,RR,0,500,8,-87,-85,-90,5
31,RR,0,500,4,-87.75,-85,-90,5
31,RR,0,500,7,-87.4285714285714,-85,-92,7
31,RR,0,500,5,-87.8,-85,-92,7
31,RR,0,500,2,-88.5,-86,-91,5
31,RR,0,500,2,-85,-84,-86,2
31,RR,0,500,8,-85.375,-82,-90,8
31,RR,0,500,7,-84.4285714285714,-82,-88,6
31,RR,0,500,4,-85,-82,-88,6
31,RR,0,500,3,-82.6666666666667,-82,-83,1
31,RR,0,500,5,-86.4,-83,-89,6
31,RR,0,500,7,-84.8571428571429,-84,-87,3
31,RR,0,500,4,-86,-84,-88,4
31,RR,0,500,4,-84.75,-84,-86,2
31,RR,1,500,10,-85.6,-83,-88,5
31,RR,0,500,3,-85.3333333333333,-85,-86,1
31,RR,0,500,8,-85.75,-83,-88,5
31,RR,0,500,2,-86,-84,-88,4
31,RR,1,500,10,-85.3,-83,-88,5
31,RR,0,500,5,-85.8,-83,-88,5
31,RR,0,500,3,-86,-85,-88,3
31,RR,0,500,4,-84.75,-83,-88,5
31,RR,0,500,8,-85.25,-84,-88,4
31,RR,0,500,3,-85,-85,-85,0
31,RR,0,500,7,-85.7142857142857,-85,-87,2
31,RR,0,500,3,-85.3333333333333,-84,-87,3
31,RR,0,500,2,-86,-84,-88,4
31,RR,1,500,10,-86.1,-83,-92,9
31,RR,0,500,1,-86,-86,-86,0
31,RR,1,500,10,-87.4,-85,-99,14
31,RR,1,500,9,-87.5555555555556,-85,-92,7
31,RR,0,500,3,-86.6666666666667,-86,-88,2
31,RR,0,500,1,-88,-88,-88,0
31,RR,0,500,2,-89.5,-87,-92,5
31,RR,1,500,9,-87.6666666666667,-84,-92,8
31,RR,0,500,3,-86,-85,-88,3
31,RR,0,500,1,-85,-85,-85,0
31,RR,0,500,3,-89.6666666666667,-85,-92,7
31,RR,0,500,8,-90.125,-87,-96,9
31,RR,0,500,7,-88,-86,-95,9
31,RR,0,500,4,-88.75,-86,-94,8
31,RR,0,500,3,-89.3333333333333,-86,-94,8
31,RR,0,500,6,-90.6666666666667,-89,-93,4
31,RR,0,500,5,-87.8,-86,-91,5
31,RR,0,500,6,-88.3333333333333,-86,-91,5
31,RR,0,500,4,-87.5,-85,-90,5
31,RR,0,500,7,-90.1428571428571,-88,-92,4
31,RR,0,500,7,-89.7142857142857,-88,-92,4
31,RR,0,500,2,-89.5,-89,-90,1
31,RR,0,500,7,-87.8571428571429,-82,-94,12
31,RR,1,500,10,-89.9,-82,-99,17
31,RR,0,500,1,-82,-82,-82,0
31,RR,0,500,8,-90.5,-87,-96,9
31,RR,0,500,1,-87,-87,-87,0
31,RR,0,500,5,-89.8,-86,-94,8
31,RR,1,500,9,-90.8888888888889,-89,-95,6
31,RR,0,500,8,-91.5,-90,-95,5
31,RR,0,500,2,-89.5,-85,-94,9
31,RR,0,500,4,-88.75,-86,-94,8
31,RR,1,500,9,-87.3333333333333,-86,-90,4
31,RR,0,500,1,-92,-92,-92,0
31,RR,1,500,10,-86.7,-82,-94,12
31,RR,0,500,5,-88.2,-82,-94,12
31,RR,1,500,10,-87.3,-84,-94,10
31,RR,0,500,5,-88.6,-85,-94,9
31,RR,0,500,8,-86.375,-84,-90,6
31,RR,0,500,7,-86.4285714285714,-84,-92,8
31,RR,0,500,1,-88,-88,-88,0
31,RR,0,500,2,-92,-92,-92,0
31,RR,1,500,9,-89.4444444444444,-82,-95,13
31,RR,0,500,8,-89.125,-82,-95,13
31,RR,0,500,1,-88,-88,-88,0
31,RR,0,500,1,-94,-94,-94,0
31,RR,0,500,6,-92.5,-89,-96,7
31,RR,0,500,7,-86.8571428571429,-77,-95,18
31,RR,0,500,3,-86,-84,-90,6
31,LL,0,500,4,-78.75,-78,-80,2
31,LL,1,500,10,-82.7,-81,-86,5
31,LL,1,500,10,-83.8,-82,-88,6
31,LL,1,500,10,-84.8,-82,-90,8
31,LL,0,500,6,-82.1666666666667,-80,-85,5
31,LL,1,500,9,-82.7777777777778,-80,-86,6
31,LL,0,500,4,-84.25,-83,-86,3
31,LL,0,500,3,-83,-83,-83,0
31,LL,0,500,2,-81.5,-80,-83,3
31,LL,0,500,5,-82.2,-80,-84,4
31,LL,0,500,1,-80,-80,-80,0
31,LL,1,500,9,-83.3333333333333,-80,-85,5
31,LL,0,500,2,-83,-82,-84,2
31,LL,0,500,3,-81.3333333333333,-79,-85,6
31,LL,0,500,7,-82.8571428571429,-79,-91,12
31,LL,0,500,2,-86,-81,-91,10
31,LL,0,500,8,-82.125,-79,-86,7
31,LL,1,500,10,-82.2,-78,-88,10
31,LL,0,500,6,-83,-78,-88,10
31,LL,1,500,9,-82.3333333333333,-78,-88,10
31,LL,0,500,5,-82.6,-79,-86,7
31,LL,0,500,7,-86.8571428571429,-85,-90,5
31,LL,0,500,2,-85.5,-83,-88,5
31,LL,0,500,5,-82.6,-81,-84,3
31,LL,0,500,4,-83,-81,-84,3
31,LL,1,500,10,-83.5,-81,-86,5
31,LL,0,500,4,-83.5,-82,-86,4
31,LL,1,500,9,-83.4444444444444,-81,-86,5
31,LL,0,500,2,-84,-83,-85,2
31,LL,0,500,3,-86.3333333333333,-84,-91,7
31,LL,0,500,5,-83.4,-83,-84,1
31,LL,0,500,8,-83.375,-82,-88,6
31,LL,0,500,1,-84,-84,-84,0
31,LL,0,500,3,-82.3333333333333,-80,-84,4
31,LL,1,500,10,-83,-80,-87,7
31,LL,0,500,6,-83.3333333333333,-80,-87,7
31,LL,1,500,9,-83.8888888888889,-81,-88,7
31,LL,1,500,10,-85.2,-81,-89,8
31,LL,0,500,6,-85.5,-82,-89,7
31,LL,1,500,9,-85.6666666666667,-83,-89,6
31,LL,0,500,1,-86,-86,-86,0
31,LL,0,500,6,-84.8333333333333,-83,-87,4
31,LL,1,500,9,-84.3333333333333,-82,-87,5
31,LL,0,500,8,-84.25,-82,-86,4
31,LL,1,500,10,-84.7,-82,-87,5
31,LL,0,500,5,-84.2,-82,-86,4
31,LL,0,500,2,-84.5,-83,-86,3
31,LL,1,500,9,-82.7777777777778,-80,-87,7
31,LL,0,500,5,-83.2,-80,-87,7
31,LL,1,500,9,-82.4444444444444,-80,-87,7
31,LL,0,500,5,-82.4,-81,-86,5
31,LL,0,500,2,-85.5,-84,-87,3
31,LL,1,500,9,-84.8888888888889,-83,-88,5
31,LL,0,500,7,-84.7142857142857,-83,-88,5
31,LL,0,500,6,-84.1666666666667,-83,-88,5
31,LL,1,500,9,-83.6666666666667,-81,-88,7
31,LL,0,500,4,-84.75,-82,-88,6
31,LL,0,500,4,-82,-78,-86,8
31,LL,0,500,5,-79.8,-78,-83,5
31,LL,0,500,3,-81.3333333333333,-78,-83,5
31,LL,0,500,8,-79.75,-78,-81,3
31,LL,1,500,10,-81.2,-79,-84,5
31,LL,0,500,6,-81,-79,-84,5
31,LL,0,500,6,-80.3333333333333,-80,-81,1
31,LL,0,500,1,-80,-80,-80,0
31,LL,0,500,2,-80.5,-80,-81,1
31,LL,0,500,3,-79.3333333333333,-78,-80,2
31,LL,0,500,1,-83,-83,-83,0
31,LL,0,500,1,-80,-80,-80,0
31,LL,0,500,1,-79,-79,-79,0
31,LL,0,500,2,-81,-81,-81,0
31,LL,0,500,8,-81.375,-80,-85,5
31,LL,1,500,9,-80.8888888888889,-79,-83,4
31,LL,0,500,5,-82.2,-80,-85,5
31,LL,1,500,9,-80.4444444444444,-78,-85,7
31,LL,0,500,5,-79,-78,-80,2
31,LL,0,500,8,-80.25,-78,-86,8
31,LL,0,500,3,-79.6666666666667,-79,-80,1
31,LL,1,500,10,-83,-77,-90,13
31,LL,0,500,3,-82.3333333333333,-79,-86,7
31,LL,0,500,7,-83.4285714285714,-79,-86,7
31,LL,0,500,6,-85,-81,-90,9
31,LL,0,500,4,-87.75,-85,-90,5
26,RR,0,500,5,-85.8,-81,-94,13
26,RR,0,500,8,-86.5,-81,-92,11
26,RR,1,500,10,-87.8,-81,-92,11
26,RR,1,500,9,-87.5555555555556,-81,-92,11
26,RR,1,500,10,-87.4,-85,-90,5
26,RR,0,500,4,-87.75,-85,-90,5
26,RR,0,500,8,-86.125,-83,-91,8
26,RR,1,500,9,-86.8888888888889,-82,-92,10
26,RR,1,500,10,-87.4,-82,-92,10
26,RR,0,500,8,-86.625,-82,-92,10
26,RR,0,500,7,-87.1428571428571,-82,-92,10
26,RR,0,500,8,-85.125,-81,-92,11
26,RR,0,500,2,-84,-81,-87,6
26,RR,0,500,2,-85,-83,-87,4
26,RR,0,500,3,-85.3333333333333,-82,-87,5
26,RR,0,500,7,-84,-82,-86,4
26,RR,0,500,8,-83.5,-82,-86,4
26,RR,0,500,8,-83.75,-82,-88,6
26,RR,1,500,9,-83.4444444444444,-81,-88,7
26,RR,1,500,9,-83.1111111111111,-81,-88,7
26,RR,0,500,6,-82.1666666666667,-81,-83,2
26,RR,0,500,5,-82.2,-81,-83,2
26,RR,0,500,6,-84.5,-83,-86,3
26,RR,0,500,4,-85,-84,-86,2
26,RR,0,500,4,-85.25,-84,-87,3
26,RR,0,500,8,-84.625,-82,-89,7
26,RR,0,500,1,-84,-84,-84,0
26,RR,0,500,8,-83.125,-82,-87,5
26,RR,0,500,6,-83.5,-82,-87,5
26,RR,0,500,4,-83.75,-82,-86,4
26,RR,0,500,1,-84,-84,-84,0
26,RR,0,500,2,-83.5,-82,-85,3
26,RR,0,500,8,-85.625,-83,-87,4
26,RR,0,500,7,-83.2857142857143,-81,-86,5
26,RR,0,500,8,-86.5,-80,-94,14
26,RR,0,500,3,-84,-80,-88,8
26,RR,0,500,3,-92.3333333333333,-90,-94,4
26,RR,0,500,3,-89.6666666666667,-86,-93,7
26,RR,1,500,10,-85.7,-84,-89,5
26,RR,0,500,7,-85.7142857142857,-84,-91,7
26,RR,0,500,4,-87.5,-87,-89,2
26,RR,0,500,6,-85.8333333333333,-84,-90,6
26,RR,1,500,10,-87,-84,-92,8
26,RR,1,500,9,-89.3333333333333,-86,-92,6
26,RR,0,500,2,-85.5,-85,-86,1
26,RR,0,500,1,-86,-86,-86,0
26,RR,0,500,6,-87.5,-84,-94,10
26,RR,0,500,4,-88,-84,-94,10
26,RR,0,500,3,-88.6666666666667,-86,-93,7
26,RR,0,500,7,-88.5714285714286,-85,-92,7
26,RR,0,500,6,-88.3333333333333,-85,-92,7
26,RR,0,500,4,-87,-86,-90,4
26,RR,0,500,4,-86,-86,-86,0
26,RR,1,500,10,-87.6,-84,-92,8
26,RR,0,500,3,-86,-86,-86,0
26,RR,1,500,9,-88.3333333333333,-84,-92,8
26,RR,1,500,9,-88.6666666666667,-84,-92,8
26,RR,0,500,8,-89,-86,-91,5
26,RR,0,500,5,-88.8,-86,-91,5
26,RR,0,500,5,-90,-88,-95,7
26,RR,0,500,2,-88.5,-88,-89,1
26,RR,0,500,7,-87.5714285714286,-84,-96,12
26,RR,0,500,4,-85.5,-84,-87,3
26,RR,0,500,2,-86.5,-84,-89,5
26,RR,0,500,1,-88,-88,-88,0
26,RR,1,500,9,-92.2222222222222,-87,-97,10
26,RR,1,500,9,-92.3333333333333,-88,-97,9
26,RR,1,500,10,-91.2,-85,-99,14
26,RR,1,500,10,-89.1,-84,-99,15
26,RR,0,500,4,-84.5,-80,-88,8
26,RR,0,500,8,-86.375,-82,-91,9
26,RR,1,500,10,-85.6,-82,-90,8
26,RR,0,500,6,-85.3333333333333,-82,-90,8
26,RR,0,500,4,-87.5,-85,-91,6
26,RR,0,500,7,-88.4285714285714,-87,-93,6
26,RR,0,500,1,-87,-87,-87,0
26,RR,0,500,8,-87.375,-84,-93,9
26,RR,1,500,10,-86.6,-80,-93,13
26,RR,0,500,7,-87.8571428571429,-80,-96,16
26,RR,0,500,6,-89.1666666666667,-83,-96,13
26,RR,0,500,2,-85.5,-83,-88,5
26,RR,0,500,6,-90.8333333333333,-86,-98,12
26,RR,0,500,8,-84.375,-81,-89,8
26,RR,0,500,5,-85.4,-83,-89,6
26,RR,1,500,10,-85,-81,-89,8
26,LL,0,500,2,-90,-86,-94,8
26,LL,0,500,2,-91,-88,-94,6
26,LL,0,500,7,-89.5714285714286,-86,-94,8
26,LL,1,500,9,-84.7777777777778,-77,-94,17
26,LL,0,500,6,-85.1666666666667,-77,-94,17
26,LL,1,500,10,-79.7,-77,-83,6
26,LL,1,500,9,-80.5555555555556,-79,-83,4
26,LL,0,500,7,-80.2857142857143,-79,-82,3
26,LL,1,500,9,-81.4444444444444,-80,-84,4
26,LL,0,500,7,-82.8571428571429,-81,-86,5
26,LL,0,500,2,-84,-82,-86,4
26,LL,0,500,5,-84.4,-81,-90,9
26,LL,0,500,4,-85,-79,-90,11
26,LL,0,500,2,-83,-83,-83,0
26,LL,0,500,8,-82.5,-80,-85,5
26,LL,0,500,2,-84.5,-84,-85,1
26,LL,0,500,2,-82,-82,-82,0
26,LL,0,500,8,-81.75,-80,-84,4
26,LL,0,500,7,-81.7142857142857,-80,-84,4
26,LL,0,500,2,-82.5,-82,-83,1
26,LL,0,500,4,-83,-81,-85,4
26,LL,1,500,9,-80.1111111111111,-78,-82,4
26,LL,0,500,6,-80.3333333333333,-78,-86,8
26,LL,0,500,2,-79.5,-78,-81,3
26,LL,1,500,9,-80.4444444444444,-77,-84,7
26,LL,0,500,8,-80.375,-77,-86,9
26,LL,1,500,10,-82.1,-77,-91,14
26,LL,0,500,3,-85.6666666666667,-83,-88,5
26,LL,0,500,8,-83.5,-80,-88,8
26,LL,0,500,3,-84,-82,-88,6
26,LL,0,500,7,-83.1428571428571,-80,-86,6
26,LL,1,500,9,-83.6666666666667,-81,-86,5
26,LL,0,500,2,-83,-82,-84,2
26,LL,0,500,7,-83.1428571428571,-81,-86,5
26,LL,0,500,3,-82.6666666666667,-81,-84,3
26,LL,0,500,6,-82.5,-80,-84,4
26,LL,0,500,8,-82.625,-80,-84,4
26,LL,0,500,2,-81.5,-80,-83,3
26,LL,1,500,10,-82.8,-80,-88,8
26,LL,0,500,1,-81,-81,-81,0
26,LL,0,500,5,-84,-80,-88,8
26,LL,0,500,4,-81.5,-80,-83,3
26,LL,0,500,7,-81.5714285714286,-79,-84,5
26,LL,0,500,4,-81.75,-79,-84,5
26,LL,0,500,4,-83.5,-80,-87,7
26,LL,0,500,6,-84.1666666666667,-81,-87,6
26,LL,1,500,10,-84.1,-81,-86,5
26,LL,0,500,4,-84,-83,-86,3
26,LL,0,500,6,-84.3333333333333,-81,-87,6
26,LL,1,500,10,-82.9,-81,-87,6
26,LL,0,500,5,-82.6,-81,-86,5
26,LL,0,500,2,-82.5,-82,-83,1
26,LL,0,500,4,-83,-81,-87,6
26,LL,1,500,10,-82.9,-79,-86,7
26,LL,0,500,8,-82.375,-79,-85,6
26,LL,0,500,7,-82.8571428571429,-82,-85,3
26,LL,0,500,2,-82,-81,-83,2
26,LL,0,500,8,-82,-80,-85,5
26,LL,0,500,7,-81.2857142857143,-80,-82,2
26,LL,0,500,7,-81.5714285714286,-80,-84,4
26,LL,0,500,3,-82,-80,-84,4
26,LL,0,500,7,-81.5714285714286,-80,-86,6
26,LL,1,500,9,-81.6666666666667,-80,-88,8
26,LL,0,500,6,-80.3333333333333,-80,-81,1
26,LL,0,500,4,-81.5,-80,-83,3
26,LL,1,500,10,-81.7,-77,-86,9
26,LL,0,500,5,-80.8,-77,-86,9
26,LL,0,500,7,-80.2857142857143,-78,-82,4
26,LL,0,500,3,-81.3333333333333,-80,-82,2
26,LL,0,500,4,-79.25,-77,-82,5
26,LL,0,500,4,-81.25,-78,-84,6
26,LL,0,500,3,-79,-79,-79,0
26,LL,1,500,9,-78.6666666666667,-78,-82,4
26,LL,0,500,1,-79,-79,-79,0
26,LL,0,500,4,-80.75,-78,-82,4
26,LL,0,500,7,-79.1428571428571,-77,-82,5
26,LL,0,500,4,-79,-78,-80,2
26,LL,0,500,7,-81.1428571428571,-79,-84,5
26,LL,0,500,5,-80.6,-79,-84,5
26,LL,1,500,9,-80.8888888888889,-79,-84,5
26,LL,1,500,9,-80.1111111111111,-79,-83,4
26,LL,0,500,4,-79.25,-78,-81,3
26,LL,0,500,2,-79.5,-79,-80,1
26,LL,1,500,10,-80.2,-77,-90,13
26,LL,0,500,4,-78.25,-77,-81,4
26,LL,0,500,4,-83.25,-80,-90,10
26,LL,0,500,1,-80,-80,-80,0
26,LL,0,500,1,-82,-82,-82,0
26,LL,0,500,2,-76.5,-75,-78,3
26,LL,1,500,9,-82.3333333333333,-76,-86,10
26,LL,0,500,7,-83.4285714285714,-76,-86,10
26,LL,0,500,1,-94,-94,-94,0
26,LL,1,500,9,-86.2222222222222,-76,-94,18
