watch,combination,risk,dist,samples,meanRSS,maxRSS,minRSS,rangeRSS
31,RL,0,50,2,-62.5,-62,-63,1
31,RL,1,50,10,-71.8,-62,-87,25
31,RL,1,50,3,-77.6666666666667,-74,-84,10
31,RL,1,50,3,-78.6666666666667,-74,-87,13
31,RL,1,50,9,-70.3333333333333,-66,-87,21
31,RL,1,50,5,-71.2,-66,-87,21
31,RL,1,50,8,-68,-66,-72,6
31,RL,0,50,2,-67,-67,-67,0
31,RL,0,50,1,-67,-67,-67,0
31,RL,0,50,2,-66.5,-66,-67,1
31,RL,1,50,3,-67.6666666666667,-67,-68,1
31,RL,1,50,6,-73,-68,-78,10
31,RL,1,50,3,-72,-68,-76,8
31,RL,1,50,10,-74.6,-68,-79,11
31,RL,0,50,1,-76,-76,-76,0
31,RL,1,50,8,-74.75,-68,-79,11
31,RL,1,50,8,-74.125,-68,-79,11
31,RL,1,50,5,-73.6,-68,-79,11
31,RL,1,50,6,-72.3333333333333,-68,-79,11
31,RL,1,50,5,-71,-68,-73,5
31,RL,1,50,6,-71.8333333333333,-68,-73,5
31,RL,1,50,3,-73,-73,-73,0
31,RL,1,50,7,-75.2857142857143,-73,-80,7
31,RL,1,50,7,-75.1428571428571,-72,-80,8
31,RL,1,50,7,-74.1428571428571,-68,-80,12
31,RL,1,50,5,-74.6,-71,-80,9
31,RL,1,50,10,-70.2,-65,-76,11
31,RL,1,50,4,-71.25,-68,-74,6
31,RL,1,50,3,-71,-68,-74,6
31,RL,0,50,1,-68,-68,-68,0
31,RL,0,50,2,-66,-65,-67,2
31,RL,1,50,3,-67.3333333333333,-65,-71,6
31,RL,1,50,4,-70.25,-66,-72,6
31,RL,1,50,9,-72.3333333333333,-68,-75,7
31,RL,0,50,2,-72,-72,-72,0
31,RL,1,50,7,-73.1428571428571,-68,-76,8
31,RL,0,50,2,-72.5,-71,-74,3
31,RL,1,50,9,-73.4444444444444,-71,-76,5
31,RL,1,50,8,-73.25,-71,-76,5
31,RL,1,50,10,-72.3,-67,-75,8
31,RL,1,50,3,-71.6666666666667,-71,-73,2
31,RL,1,50,7,-71.4285714285714,-67,-75,8
31,RL,0,50,2,-74.5,-74,-75,1
31,RL,0,50,2,-72,-69,-75,6
31,RL,1,50,10,-68.8,-67,-75,8
31,RL,1,50,3,-70.3333333333333,-67,-75,8
31,RL,0,50,1,-67,-67,-67,0
31,RL,1,50,4,-69,-67,-71,4
31,RL,1,50,7,-68.2857142857143,-67,-71,4
31,RL,0,50,1,-67,-67,-67,0
31,RL,1,50,3,-70.6666666666667,-69,-73,4
31,RL,1,50,4,-70.5,-69,-73,4
31,RL,1,50,7,-69.4285714285714,-67,-73,6
31,RL,0,50,1,-69,-69,-69,0
31,RL,1,50,5,-69.6,-67,-73,6
31,RL,0,50,1,-68,-68,-68,0
31,RL,1,50,6,-70.8333333333333,-67,-73,6
31,RL,1,50,4,-71.5,-69,-73,4
31,RL,1,50,10,-70.3,-66,-72,6
31,RL,1,50,7,-71,-68,-72,4
31,RL,1,50,6,-70.8333333333333,-68,-72,4
31,RL,1,50,8,-70.125,-66,-72,6
31,RL,1,50,8,-69.875,-66,-72,6
31,RL,1,50,10,-69.9,-66,-72,6
31,RL,1,50,4,-68.5,-66,-71,5
31,RL,1,50,9,-70.4444444444444,-66,-73,7
31,RL,1,50,3,-70.6666666666667,-70,-71,1
31,RL,0,50,2,-70.5,-70,-71,1
31,RL,1,50,5,-71,-70,-73,3
31,RL,0,50,2,-70,-70,-70,0
31,RL,0,50,1,-70,-70,-70,0
31,RL,1,50,6,-69,-66,-73,7
31,RL,1,50,3,-68.3333333333333,-67,-71,4
31,RL,0,50,2,-68,-66,-70,4
31,RL,0,50,1,-70,-70,-70,0
31,RL,1,50,10,-68.8,-67,-70,3
31,RL,1,50,8,-68.625,-67,-70,3
31,RL,1,50,6,-68.8333333333333,-67,-70,3
31,RL,1,50,5,-68.6,-67,-70,3
31,RL,1,50,4,-68.5,-67,-70,3
31,RL,0,50,1,-70,-70,-70,0
31,RL,1,50,4,-67.25,-67,-68,1
31,RL,1,50,8,-67.75,-67,-70,3
31,RL,0,50,2,-67.5,-67,-68,1
31,RL,1,50,6,-68,-67,-70,3
31,RL,1,50,9,-67.3333333333333,-66,-70,4
31,RL,1,50,5,-67.4,-67,-68,1
31,RL,1,50,4,-67.5,-67,-68,1
31,RL,1,50,8,-67.25,-66,-69,3
31,RL,1,50,9,-67.7777777777778,-66,-70,4
31,RL,1,50,7,-67.8571428571429,-66,-70,4
31,RL,1,50,4,-67.5,-66,-69,3
31,RL,0,50,1,-67,-67,-67,0
31,RL,1,50,10,-68.9,-67,-71,4
31,RL,0,50,1,-68,-68,-68,0
31,RL,1,50,9,-69.1111111111111,-67,-71,4
31,RL,0,50,2,-68.5,-68,-69,1
31,RL,1,50,10,-69,-67,-71,4
31,RL,1,50,9,-69.1111111111111,-67,-71,4
31,RL,0,50,2,-68.5,-67,-70,3
31,RL,1,50,9,-69.3333333333333,-67,-71,4
31,RL,1,50,9,-69.3333333333333,-67,-71,4
31,RL,1,50,5,-69.6,-67,-71,4
31,RL,0,50,1,-70,-70,-70,0
31,RL,0,50,2,-70,-70,-70,0
31,RL,1,50,10,-68.7,-67,-70,3
31,RL,1,50,5,-68.6,-67,-70,3
31,RL,1,50,10,-68.3,-66,-70,4
31,RL,0,50,1,-68,-68,-68,0
31,RL,1,50,9,-67.8888888888889,-66,-70,4
31,RL,0,50,1,-68,-68,-68,0
31,RL,1,50,10,-67.3,-66,-70,4
31,RL,1,50,10,-66.9,-66,-68,2
31,RL,1,50,6,-66.6666666666667,-66,-67,1
31,RL,1,50,10,-67.7,-66,-71,5
31,RL,1,50,6,-67,-66,-68,2
31,RL,1,50,8,-68,-66,-71,5
31,RL,1,50,8,-68,-66,-71,5
31,RL,1,50,4,-68,-66,-70,4
31,RL,1,50,6,-68.5,-67,-71,4
31,RL,1,50,8,-68.875,-67,-72,5
31,RL,1,50,6,-69.1666666666667,-67,-72,5
31,RL,1,50,7,-68.7142857142857,-67,-72,5
31,RL,1,50,7,-68.5714285714286,-67,-72,5
31,RL,1,50,8,-69.125,-67,-72,5
31,RL,1,50,7,-69.4285714285714,-68,-72,4
31,RL,1,50,7,-69.4285714285714,-68,-70,2
31,RL,1,50,9,-69.5555555555556,-68,-70,2
31,RL,1,50,7,-69.7142857142857,-68,-70,2
31,RL,1,50,6,-69.6666666666667,-68,-70,2
31,RL,1,50,4,-69.5,-68,-70,2
31,RL,1,50,6,-69.1666666666667,-67,-70,3
31,RL,1,50,3,-69.3333333333333,-68,-70,2
31,RL,0,50,2,-70,-70,-70,0
31,RL,1,50,8,-68.625,-67,-70,3
31,RL,0,50,2,-68.5,-67,-70,3
31,RL,1,50,5,-68.2,-67,-69,2
31,RL,1,50,3,-68.3333333333333,-68,-69,1
31,RL,0,50,1,-68,-68,-68,0
31,RL,0,50,1,-69,-69,-69,0
31,RL,1,50,5,-69.4,-68,-71,3
31,RL,1,50,9,-69.5555555555556,-68,-71,3
31,RL,1,50,10,-70,-68,-72,4
31,RL,0,50,2,-70,-70,-70,0
31,RL,1,50,3,-69,-68,-70,2
31,RL,0,50,2,-72,-72,-72,0
31,RL,1,50,3,-68.6666666666667,-67,-72,5
31,RL,1,50,6,-67.8333333333333,-67,-70,3
31,RL,1,50,9,-68.6666666666667,-67,-71,4
31,RL,1,50,4,-69,-67,-70,3
31,RL,1,50,8,-69.125,-67,-71,4
31,RL,1,50,6,-69.6666666666667,-67,-71,4
31,RL,0,50,1,-71,-71,-71,0
31,RL,1,50,7,-68.2857142857143,-67,-70,3
31,RL,0,50,2,-68.5,-67,-70,3
31,RL,0,50,1,-67,-67,-67,0
31,RL,1,50,6,-68,-66,-70,4
31,RL,1,50,3,-67.3333333333333,-66,-69,3
31,RL,1,50,9,-68,-66,-72,6
31,RL,1,50,7,-68.2857142857143,-66,-72,6
31,RL,0,50,1,-68,-68,-68,0
31,RL,1,50,5,-68.8,-67,-72,5
31,RL,0,50,2,-68.5,-67,-70,3
31,RL,0,50,2,-69.5,-67,-72,5
31,RL,1,50,4,-67.25,-67,-68,1
31,RL,1,50,5,-67.8,-67,-69,2
31,RL,0,50,1,-69,-69,-69,0
31,RL,1,50,10,-67.4,-66,-69,3
31,RL,1,50,9,-67.3333333333333,-66,-69,3
31,RL,1,50,8,-67.625,-66,-69,3
31,RL,0,50,2,-68.5,-68,-69,1
31,RL,1,50,5,-67.8,-67,-69,2
31,RL,1,50,7,-67.8571428571429,-67,-70,3
31,RL,1,50,5,-68.2,-67,-70,3
31,RL,1,50,5,-68,-67,-70,3
31,RL,0,50,1,-70,-70,-70,0
31,RL,0,50,1,-67,-67,-67,0
31,RL,1,50,9,-67.5555555555556,-66,-70,4
31,RL,1,50,7,-68,-67,-70,3
31,RL,1,50,10,-67.5,-66,-70,4
31,RL,0,50,1,-69,-69,-69,0
31,RL,0,50,2,-67,-67,-67,0
31,RL,1,50,5,-66.8,-66,-68,2
31,RL,1,50,7,-67.2857142857143,-65,-70,5
31,RL,1,50,4,-68,-66,-70,4
31,RL,1,50,5,-67.8,-65,-70,5
31,RL,0,50,2,-69,-68,-70,2
31,RL,1,50,9,-67.5555555555556,-65,-70,5
31,RL,1,50,10,-67.7,-65,-70,5
31,RL,0,50,1,-65,-65,-65,0
31,RL,1,50,6,-68.3333333333333,-67,-70,3
31,RL,1,50,4,-68.25,-67,-70,3
31,RL,0,50,2,-69,-68,-70,2
31,RL,1,50,6,-68,-66,-70,4
31,RL,1,50,7,-68,-66,-72,6
31,RL,0,50,2,-67,-66,-68,2
31,RL,1,50,7,-67.5714285714286,-66,-72,6
31,RL,1,50,10,-67.7,-66,-72,6
31,RL,1,50,9,-67.6666666666667,-66,-72,6
31,RL,1,50,6,-67.6666666666667,-66,-72,6
31,RL,1,50,8,-67.25,-66,-69,3
31,RL,1,50,10,-67.4,-66,-70,4
31,RL,1,50,9,-67.2222222222222,-66,-70,4
31,RL,1,50,9,-67.4444444444444,-66,-70,4
31,RL,1,50,9,-67.7777777777778,-66,-70,4
31,RL,1,50,3,-67.3333333333333,-66,-70,4
31,RL,1,50,8,-68.125,-66,-70,4
31,RL,1,50,5,-68.4,-67,-70,3
31,RL,1,50,4,-68,-67,-70,3
31,RL,0,50,2,-67,-67,-67,0
31,RL,1,50,3,-67.6666666666667,-67,-68,1
31,RL,1,50,9,-70.1111111111111,-67,-76,9
31,RL,1,50,3,-68.6666666666667,-68,-69,1
31,RL,0,50,2,-69,-69,-69,0
31,RL,1,50,7,-70.5714285714286,-67,-76,9
31,RL,0,50,1,-73,-73,-73,0
31,RL,1,50,4,-70.75,-67,-76,9
31,RL,1,50,7,-70.2857142857143,-67,-73,6
31,RL,1,50,8,-71.25,-68,-73,5
31,RL,1,50,6,-71.8333333333333,-68,-73,5
31,RL,1,50,7,-71.1428571428571,-68,-73,5
31,RL,1,50,10,-70.4,-68,-73,5
31,RL,0,50,2,-73,-73,-73,0
31,RL,1,50,4,-71.25,-69,-73,4
31,RL,0,50,2,-71,-69,-73,4
31,RL,0,50,1,-69,-69,-69,0
31,RL,1,50,6,-68.6666666666667,-68,-70,2
31,RL,1,50,5,-68.4,-68,-70,2
31,RL,0,50,2,-68,-68,-68,0
31,RL,0,50,1,-68,-68,-68,0
31,RL,1,50,4,-68.5,-68,-69,1
31,RL,1,50,3,-68.6666666666667,-68,-69,1
31,RL,0,50,1,-69,-69,-69,0
31,RL,1,50,10,-66.9,-65,-69,4
31,RL,1,50,4,-66.75,-65,-69,4
31,RL,0,50,1,-65,-65,-65,0
31,RL,1,50,5,-68.2,-68,-69,1
31,RL,1,50,8,-67,-65,-69,4
31,RL,0,50,2,-68,-68,-68,0
31,RL,1,50,6,-66.5,-65,-68,3
31,RL,1,50,9,-66.6666666666667,-64,-70,6
31,RL,1,50,3,-66,-66,-66,0
31,RL,0,50,2,-66,-66,-66,0
31,RL,1,50,4,-65,-64,-66,2
31,RL,0,50,2,-65,-65,-65,0
31,RL,1,50,4,-67.25,-64,-70,6
31,RL,1,50,6,-66.8333333333333,-64,-70,6
31,RL,1,50,7,-66.5714285714286,-63,-70,7
31,RL,1,50,6,-66,-63,-70,7
31,RL,0,50,1,-65,-65,-65,0
31,RL,1,50,7,-67.4285714285714,-63,-71,8
31,RL,1,50,6,-68.1666666666667,-65,-71,6
31,RL,0,50,1,-68,-68,-68,0
31,RL,1,50,4,-67.75,-65,-71,6
31,RL,1,50,5,-65.6,-63,-71,8
31,RL,1,50,9,-66.2222222222222,-63,-71,8
31,RL,1,50,7,-65.7142857142857,-63,-69,6
31,RL,1,50,4,-65.5,-63,-69,6
31,RL,1,50,4,-66.75,-63,-69,6
31,RL,1,50,7,-66.2857142857143,-64,-69,5
31,RL,1,50,7,-67,-64,-70,6
31,RL,1,50,7,-67.5714285714286,-65,-70,5
31,RL,1,50,10,-67.9,-65,-70,5
31,RL,1,50,6,-68.3333333333333,-66,-70,4
31,RL,1,50,4,-69.25,-68,-70,2
31,RL,1,50,8,-67.75,-66,-70,4
31,RL,1,50,4,-68.25,-67,-69,2
31,RL,1,50,10,-66.8,-66,-69,3
31,RL,0,50,1,-69,-69,-69,0
31,RL,1,50,4,-66.25,-66,-67,1
31,RL,1,50,8,-66.375,-66,-68,2
31,RL,1,50,9,-66.3333333333333,-65,-68,3
31,RL,1,50,8,-66.375,-65,-68,3
31,RL,1,50,6,-66.3333333333333,-65,-68,3
31,RL,1,50,3,-67,-66,-68,2
31,RL,1,50,6,-66.3333333333333,-65,-68,3
31,RL,1,50,6,-66.3333333333333,-65,-68,3
31,RL,1,50,7,-66.4285714285714,-65,-68,3
31,RL,1,50,7,-66.5714285714286,-66,-68,2
31,RL,1,50,4,-66.75,-66,-68,2
31,RL,1,50,4,-66.75,-66,-68,2
31,RL,0,50,2,-67.5,-67,-68,1
31,RL,1,50,9,-65.2222222222222,-63,-68,5
31,RL,1,50,3,-67,-66,-68,2
31,RL,0,50,2,-67,-66,-68,2
31,RL,1,50,7,-64.5714285714286,-63,-66,3
31,RL,1,50,4,-64,-63,-66,3
31,RL,0,50,2,-63.5,-63,-64,1
31,RL,1,50,5,-65.6,-63,-68,5
31,RL,1,50,4,-66.25,-64,-68,4
31,RL,0,50,2,-66.5,-66,-67,1
31,RL,1,50,4,-68.5,-66,-73,7
31,RL,1,50,4,-66,-66,-66,0
31,RL,1,50,3,-66,-66,-66,0
31,RL,1,50,5,-70.8,-66,-76,10
31,RL,1,50,10,-71.7,-66,-82,16
31,RL,1,50,4,-72.25,-67,-76,9
31,RL,1,50,5,-70.2,-66,-76,10
31,RL,1,50,4,-68.75,-66,-73,7
31,RL,1,50,6,-72.5,-66,-82,16
31,RL,1,50,5,-73.8,-69,-82,13
31,RL,1,50,6,-74.5,-72,-82,10
31,RL,0,50,2,-77,-72,-82,10
31,RL,1,50,10,-71.8,-67,-82,15
31,RL,1,50,8,-71.125,-68,-75,7
31,RL,1,50,9,-70.4444444444444,-67,-75,8
31,RL,1,50,5,-70.2,-68,-72,4
31,RL,1,50,6,-69.3333333333333,-67,-72,5
31,RL,1,50,5,-69.6,-67,-72,5
31,RL,1,50,8,-69,-67,-72,5
31,RL,1,50,3,-69.6666666666667,-67,-72,5
31,RL,0,50,2,-68.5,-67,-70,3
31,RL,1,50,9,-68.2222222222222,-67,-72,5
31,RL,1,50,5,-67.8,-67,-69,2
31,RL,1,50,5,-67.6,-67,-69,2
31,RL,1,50,9,-68.6666666666667,-67,-72,5
31,RL,1,50,4,-67.75,-67,-69,2
31,RL,1,50,8,-69.25,-67,-72,5
31,RL,1,50,9,-70,-67,-73,6
31,RL,1,50,4,-70,-68,-72,4
31,RL,1,50,9,-70.6666666666667,-68,-73,5
31,RL,1,50,3,-70.6666666666667,-70,-72,2
31,RL,1,50,5,-71.6,-70,-73,3
31,RL,1,50,8,-77,-70,-88,18
31,RL,1,50,4,-75,-70,-87,17
31,RL,1,50,8,-80.875,-70,-93,23
31,RL,0,50,1,-87,-87,-87,0
31,RL,0,50,1,-77,-77,-77,0
31,RL,1,50,10,-78.8,-71,-93,22
31,RL,0,50,2,-88,-83,-93,10
31,RL,1,50,7,-76.5714285714286,-72,-83,11
31,RL,1,50,4,-76.5,-73,-83,10
31,RL,1,50,9,-74.8888888888889,-71,-83,12
31,RL,1,50,6,-74.1666666666667,-71,-79,8
31,RL,1,50,10,-73.3,-70,-79,9
31,RL,1,50,7,-73.4285714285714,-71,-79,8
31,RL,0,50,2,-71.5,-71,-72,1
31,RL,0,50,1,-71,-71,-71,0
31,RL,0,50,2,-77,-75,-79,4
31,RL,1,50,10,-71.3,-68,-75,7
31,RL,1,50,9,-71.3333333333333,-68,-75,7
31,RL,1,50,8,-71.375,-68,-75,7
31,RL,1,50,6,-70.8333333333333,-68,-75,7
31,RL,0,50,1,-72,-72,-72,0
31,RL,1,50,9,-69.8888888888889,-67,-75,8
31,RL,1,50,5,-69.8,-67,-72,5
31,RL,1,50,10,-69.7,-67,-72,5
31,RL,0,50,2,-69,-67,-71,4
31,RL,1,50,3,-67.6666666666667,-67,-69,2
31,RL,1,50,9,-69.6666666666667,-67,-72,5
31,RL,0,50,1,-67,-67,-67,0
31,RL,1,50,9,-69.7777777777778,-66,-72,6
31,RL,1,50,4,-71,-69,-72,3
31,RL,0,50,2,-70.5,-69,-72,3
31,RL,1,50,4,-69.25,-68,-71,3
31,RL,0,50,2,-69.5,-68,-71,3
31,RL,1,50,3,-68.6666666666667,-68,-69,1
31,RL,1,50,4,-68.25,-66,-69,3
31,RL,1,50,7,-68.4285714285714,-66,-72,6
31,RL,1,50,4,-69.25,-67,-72,5
31,RL,0,50,1,-72,-72,-72,0
31,RL,1,50,6,-69,-66,-74,8
31,RL,1,50,8,-70.125,-66,-74,8
31,RL,0,50,1,-72,-72,-72,0
31,RL,0,50,2,-71,-68,-74,6
31,RL,1,50,10,-71,-67,-76,9
31,RL,0,50,1,-71,-71,-71,0
31,RL,1,50,4,-70,-68,-74,6
31,RL,1,50,3,-68.6666666666667,-68,-69,1
31,RL,0,50,2,-68.5,-68,-69,1
31,RL,1,50,4,-71.5,-68,-76,8
31,RL,0,50,2,-69.5,-67,-72,5
31,RL,1,50,5,-69,-67,-70,3
31,RL,1,50,6,-69.6666666666667,-68,-70,2
31,RL,1,50,4,-69.5,-68,-70,2
31,RL,1,50,6,-71.3333333333333,-70,-75,5
31,RL,1,50,4,-71.25,-70,-75,5
31,RL,1,50,9,-74.3333333333333,-70,-77,7
31,RL,1,50,3,-74,-73,-75,2
31,RL,1,50,4,-76.25,-74,-77,3
31,RL,1,50,5,-76.6,-76,-77,1
31,RL,1,50,7,-79,-76,-86,10
31,RL,1,50,4,-78,-76,-84,8
31,RL,1,50,3,-78.6666666666667,-76,-84,8
31,RL,1,50,5,-81.2,-78,-86,8
31,RL,1,50,8,-80.375,-78,-86,8
31,RL,1,50,5,-79,-78,-81,3
31,RL,0,50,2,-79,-79,-79,0
31,RL,1,50,6,-78.8333333333333,-73,-82,9
31,RL,1,50,5,-78.8,-73,-82,9
31,RL,1,50,7,-77.1428571428571,-73,-82,9
31,RL,0,50,1,-74,-74,-74,0
31,RL,1,50,8,-75.75,-74,-78,4
31,RL,1,50,7,-75.8571428571429,-74,-78,4
31,RL,1,50,9,-76.2222222222222,-74,-78,4
31,RL,1,50,3,-75.6666666666667,-74,-78,4
31,RL,1,50,9,-76.1111111111111,-74,-78,4
31,RL,1,50,8,-76.375,-75,-78,3
31,RL,1,50,9,-76.4444444444444,-75,-79,4
31,RL,0,50,1,-77,-77,-77,0
31,RL,1,50,7,-76.4285714285714,-75,-79,4
31,RL,1,50,9,-75.8888888888889,-72,-79,7
31,RL,1,50,3,-75,-75,-75,0
31,RL,1,50,3,-75.3333333333333,-75,-76,1
31,RL,1,50,9,-74.8888888888889,-72,-79,7
31,RL,1,50,8,-74.75,-72,-79,7
31,RL,0,50,2,-75.5,-72,-79,7
31,RL,1,50,7,-73.2857142857143,-72,-75,3
31,RL,1,50,10,-75.2,-72,-83,11
31,RL,1,50,6,-74.5,-72,-82,10
31,RL,1,50,4,-75,-72,-82,10
31,RL,1,50,4,-75.5,-73,-82,9
31,RL,0,50,2,-73.5,-73,-74,1
31,RL,1,50,9,-74.6666666666667,-72,-81,9
31,RL,1,50,4,-77.25,-72,-81,9
31,RL,1,50,10,-75.6,-72,-87,15
31,RL,1,50,6,-72,-72,-72,0
31,RL,1,50,3,-72,-72,-72,0
31,RL,1,50,4,-74,-72,-80,8
31,RL,1,50,10,-77.4,-72,-88,16
31,RL,1,50,3,-76.3333333333333,-72,-80,8
31,RL,0,50,2,-78.5,-77,-80,3
31,RL,1,50,6,-79.5,-74,-88,14
31,RL,1,50,8,-77.5,-73,-88,15
31,RL,1,50,4,-78.25,-74,-88,14
31,RL,0,50,1,-76,-76,-76,0
31,RL,1,50,7,-71.4285714285714,-67,-74,7
31,RL,1,50,10,-71.2,-67,-75,8
31,RL,1,50,10,-71,-67,-75,8
31,RL,1,50,6,-70.6666666666667,-67,-72,5
31,RL,1,50,3,-69.3333333333333,-67,-72,5
31,RL,1,50,5,-70.2,-67,-72,5
31,RL,0,50,1,-72,-72,-72,0
31,RL,1,50,4,-71.75,-68,-75,7
31,RL,1,50,6,-73,-68,-76,8
31,RL,1,50,9,-73.7777777777778,-68,-76,8
31,RL,1,50,3,-74.3333333333333,-72,-76,4
31,RL,0,50,1,-76,-76,-76,0
31,RL,1,50,8,-73.375,-70,-76,6
31,RL,1,50,8,-73.25,-70,-76,6
31,RL,1,50,4,-73.5,-71,-76,5
31,RL,1,50,6,-72.6666666666667,-70,-76,6
31,RL,1,50,4,-72,-70,-74,4
31,RL,1,50,8,-72.75,-69,-76,7
31,RL,1,50,9,-72.2222222222222,-69,-76,7
31,RL,1,50,7,-72.5714285714286,-69,-76,7
31,RL,1,50,7,-71.8571428571429,-69,-76,7
31,RL,1,50,6,-71.6666666666667,-69,-76,7
31,RL,1,50,3,-72.6666666666667,-69,-76,7
31,RL,1,50,6,-73.3333333333333,-69,-81,12
31,RL,1,50,8,-72.75,-69,-81,12
31,RL,1,50,3,-73,-69,-81,12
31,RL,1,50,8,-73.375,-69,-81,12
31,RL,1,50,5,-75,-69,-81,12
31,RL,1,50,10,-72.1,-69,-79,10
31,RL,1,50,4,-71.75,-69,-74,5
31,RL,1,50,10,-70.8,-69,-74,5
31,RL,1,50,6,-70.6666666666667,-69,-72,3
31,RL,1,50,8,-70.625,-69,-72,3
31,RL,1,50,10,-71.2,-69,-74,5
31,RL,1,50,10,-71.2,-69,-74,5
31,RL,0,50,2,-71.5,-71,-72,1
31,RL,1,50,3,-69,-69,-69,0
31,RL,1,50,5,-72,-69,-74,5
31,RL,1,50,3,-73.6666666666667,-73,-74,1
31,RL,1,50,10,-72.2,-69,-76,7
31,RL,1,50,4,-72.5,-70,-74,4
31,RL,0,50,1,-74,-74,-74,0
31,RL,1,50,5,-72.2,-69,-76,7
31,RL,1,50,7,-71.8571428571429,-69,-76,7
31,RL,0,50,1,-76,-76,-76,0
31,RL,1,50,6,-72.1666666666667,-70,-75,5
31,RL,1,50,5,-72.2,-70,-75,5
31,RL,0,50,1,-70,-70,-70,0
31,RL,0,50,1,-75,-75,-75,0
31,RL,1,50,4,-72.5,-68,-75,7
31,RL,1,50,7,-72.4285714285714,-68,-75,7
31,RL,0,50,2,-71,-68,-74,6
31,RL,0,50,1,-74,-74,-74,0
31,RL,1,50,6,-72.8333333333333,-68,-77,9
31,RL,1,50,7,-73.2857142857143,-68,-77,9
31,RL,1,50,4,-72.75,-68,-77,9
31,RL,1,50,9,-73.1111111111111,-68,-77,9
31,RL,1,50,4,-73.25,-72,-77,5
31,RL,1,50,9,-73,-71,-76,5
31,RL,0,50,1,-72,-72,-72,0
31,RL,1,50,9,-73.6666666666667,-71,-76,5
31,RL,1,50,4,-74.25,-73,-76,3
31,RL,1,50,4,-73.5,-73,-74,1
31,RL,1,50,3,-73.3333333333333,-73,-74,1
31,RL,1,50,3,-72.3333333333333,-71,-73,2
31,RL,1,50,9,-73.2222222222222,-71,-75,4
31,RL,1,50,3,-73.6666666666667,-71,-75,4
31,RL,1,50,5,-73.2,-71,-75,4
31,RL,1,50,7,-73.4285714285714,-71,-75,4
31,RL,1,50,10,-72.5,-70,-75,5
31,RL,1,50,10,-72.6,-70,-75,5
31,RL,0,50,1,-75,-75,-75,0
31,RL,1,50,10,-72.5,-70,-76,6
31,RL,1,50,4,-72,-70,-74,4
31,RL,0,50,1,-72,-72,-72,0
31,RL,1,50,3,-71.3333333333333,-70,-72,2
31,RL,0,50,1,-70,-70,-70,0
31,RL,1,50,7,-73,-71,-76,5
31,RL,1,50,9,-72.3333333333333,-70,-76,6
31,RL,1,50,3,-73,-71,-76,5
31,RL,1,50,7,-72.5714285714286,-70,-76,6
31,RL,1,50,9,-72,-70,-76,6
31,RL,1,50,6,-71.3333333333333,-70,-74,4
31,RL,1,50,5,-71.6,-70,-74,4
31,RL,1,50,7,-72,-70,-74,4
31,RL,1,50,4,-72,-70,-74,4
31,RL,1,50,3,-72.6666666666667,-72,-74,2
31,RL,1,50,6,-72.6666666666667,-72,-74,2
31,RL,1,50,5,-72.8,-72,-74,2
31,RL,1,50,10,-72.6,-69,-76,7
31,RL,0,50,1,-72,-72,-72,0
31,RL,1,50,3,-73.3333333333333,-72,-74,2
31,RL,0,50,2,-74,-74,-74,0
31,RL,1,50,9,-72.1111111111111,-69,-76,7
31,RL,1,50,4,-72,-69,-76,7
31,RL,1,50,6,-71.6666666666667,-69,-76,7
31,RL,1,50,9,-72.4444444444444,-69,-76,7
31,RL,0,50,1,-71,-71,-71,0
31,RL,1,50,9,-72.8888888888889,-71,-75,4
31,RL,0,50,1,-74,-74,-74,0
31,RL,1,50,6,-73.5,-72,-77,5
31,RL,1,50,9,-73.5555555555556,-71,-77,6
31,RL,1,50,4,-74.25,-73,-77,4
31,RL,1,50,7,-73.8571428571429,-71,-77,6
31,RL,1,50,3,-75,-74,-77,3
31,RL,1,50,7,-73.7142857142857,-67,-82,15
31,RL,1,50,6,-73.6666666666667,-67,-82,15
31,RL,1,50,10,-74.6,-67,-82,15
31,RL,1,50,5,-75.8,-67,-82,15
31,RL,1,50,10,-74.8,-67,-82,15
31,RL,1,50,10,-74.5,-67,-82,15
31,RL,0,50,2,-82,-82,-82,0
31,RL,1,50,9,-73.6666666666667,-67,-82,15
31,RL,1,50,7,-73.4285714285714,-70,-78,8
31,RL,1,50,3,-72.6666666666667,-70,-75,5
31,RL,1,50,7,-72,-67,-78,11
31,RL,0,50,1,-73,-73,-73,0
31,RL,1,50,8,-72,-67,-77,10
31,RL,1,50,6,-72,-67,-77,10
31,RL,1,50,9,-72.5555555555556,-67,-77,10
31,RL,1,50,4,-73,-67,-77,10
31,RL,0,50,1,-77,-77,-77,0
31,RL,0,50,2,-74,-72,-76,4
31,RL,1,50,10,-72.8,-70,-76,6
31,RL,1,50,9,-72.4444444444444,-70,-75,5
31,RL,1,50,9,-72.6666666666667,-70,-75,5
31,RL,1,50,3,-71,-70,-72,2
31,RL,1,50,3,-72,-71,-73,2
31,RL,1,50,4,-73,-71,-75,4
31,RL,1,50,6,-73.8333333333333,-72,-76,4
31,RL,1,50,4,-73.5,-72,-75,3
31,RL,1,50,4,-74.25,-72,-76,4
31,RL,1,50,6,-74,-70,-76,6
31,RL,0,50,2,-75,-74,-76,2
31,RL,1,50,7,-73.2857142857143,-70,-76,6
31,RL,1,50,4,-73,-70,-76,6
31,RL,1,50,8,-72.5,-71,-74,3
31,RL,1,50,4,-72.5,-72,-73,1
31,RL,1,50,5,-72.6,-72,-74,2
31,RL,1,50,10,-72.9,-70,-75,5
31,RL,0,50,1,-74,-74,-74,0
31,RL,1,50,10,-73.1,-70,-76,6
31,RL,1,50,7,-73.7142857142857,-70,-76,6
31,RL,1,50,5,-73,-70,-75,5
31,RL,1,50,8,-73.25,-70,-76,6
31,RL,0,50,1,-75,-75,-75,0
31,RL,1,50,3,-75,-74,-76,2
31,RL,1,50,8,-74,-71,-76,5
31,RL,1,50,3,-73.3333333333333,-71,-76,5
31,RL,0,50,2,-72.5,-72,-73,1
31,RL,1,50,3,-74,-72,-76,4
31,RL,1,50,10,-73.5,-71,-76,5
31,RL,1,50,5,-74,-71,-76,5
31,RL,1,50,10,-73,-71,-76,5
31,RL,1,50,10,-72.9,-71,-76,5
31,RL,1,50,3,-72.6666666666667,-71,-76,5
31,RL,1,50,10,-72.5,-70,-75,5
31,RL,1,50,9,-72.6666666666667,-70,-75,5
31,RL,1,50,7,-72.7142857142857,-70,-75,5
31,RL,1,50,7,-73.1428571428571,-70,-75,5
31,RL,1,50,3,-73.3333333333333,-71,-75,4
31,RL,0,50,2,-72.5,-71,-74,3
31,RL,1,50,10,-72.3,-70,-74,4
31,RL,1,50,8,-72.375,-70,-74,4
31,RL,1,50,3,-72.3333333333333,-70,-74,4
31,RL,1,50,6,-72.5,-70,-74,4
31,RL,0,50,1,-73,-73,-73,0
31,RL,1,50,5,-72.2,-70,-74,4
31,RL,1,50,3,-73.6666666666667,-73,-74,1
31,RL,1,50,10,-73,-70,-76,6
31,RL,1,50,3,-72.3333333333333,-70,-74,4
31,RL,1,50,8,-72.875,-70,-76,6
31,RL,1,50,7,-72.7142857142857,-70,-76,6
31,RL,1,50,4,-73.25,-72,-75,3
31,RL,1,50,5,-72.8,-70,-76,6
31,RL,1,50,7,-72.2857142857143,-70,-77,7
31,RL,1,50,8,-71.625,-70,-77,7
31,RL,1,50,4,-72.5,-71,-77,6
31,RL,0,50,1,-71,-71,-71,0
31,RL,1,50,3,-70.6666666666667,-70,-71,1
31,RL,1,50,9,-72,-70,-74,4
31,RL,1,50,4,-73,-72,-74,2
31,RL,0,50,1,-72,-72,-72,0
31,RL,1,50,7,-72.5714285714286,-70,-74,4
31,RL,1,50,3,-72.3333333333333,-70,-74,4
31,RL,1,50,5,-72.2,-70,-74,4
31,RL,1,50,9,-72.8888888888889,-70,-75,5
31,RL,0,50,1,-72,-72,-72,0
31,RL,1,50,10,-73.4,-71,-75,4
31,RL,1,50,5,-73.4,-71,-75,4
31,RL,1,50,5,-73.6,-71,-75,4
31,RL,1,50,7,-73.4285714285714,-71,-75,4
31,RL,1,50,4,-74,-73,-75,2
31,RL,1,50,4,-74.25,-73,-75,2
31,RL,1,50,8,-74.125,-71,-78,7
31,RL,1,50,8,-73.875,-71,-78,7
31,RL,1,50,8,-74.375,-71,-78,7
31,RL,1,50,6,-74,-71,-78,7
31,RL,1,50,7,-73.8571428571429,-69,-78,9
31,RL,0,50,2,-74.5,-71,-78,7
31,RL,1,50,10,-72.9,-69,-78,9
31,RL,1,50,3,-73,-69,-77,8
31,RL,1,50,8,-71.625,-69,-73,4
31,RL,1,50,9,-73.6666666666667,-71,-79,8
31,RL,0,50,2,-71.5,-71,-72,1
31,RL,1,50,5,-74.4,-72,-79,7
31,RL,1,50,3,-73.6666666666667,-72,-76,4
31,RL,1,50,7,-75.5714285714286,-73,-79,6
31,RL,1,50,3,-76.6666666666667,-75,-79,4
31,RL,1,50,7,-75.5714285714286,-71,-79,8
31,RL,1,50,8,-75.25,-71,-78,7
31,RL,0,50,1,-74,-74,-74,0
31,RL,1,50,3,-75,-71,-78,7
31,RL,0,50,1,-78,-78,-78,0
31,RL,1,50,10,-74.7,-72,-84,12
31,RL,0,50,1,-76,-76,-76,0
31,RL,1,50,7,-73,-72,-74,2
31,RL,1,50,4,-72.5,-72,-74,2
31,RL,1,50,6,-74.6666666666667,-72,-77,5
31,RL,1,50,5,-74.8,-72,-77,5
31,RL,1,50,6,-75,-71,-77,6
31,RL,1,50,10,-74.2,-71,-77,6
31,RL,0,50,1,-75,-75,-75,0
31,RL,0,50,2,-74,-71,-77,6
31,RL,1,50,3,-72.6666666666667,-71,-76,5
31,RL,0,50,2,-73.5,-71,-76,5
31,RL,1,50,5,-75,-72,-80,8
31,RL,1,50,4,-74.75,-72,-80,8
31,RL,1,50,8,-75.5,-71,-82,11
31,RL,1,50,8,-75.125,-71,-82,11
31,RL,1,50,7,-75.5714285714286,-71,-82,11
31,RL,0,50,1,-74,-74,-74,0
31,RL,1,50,7,-74.4285714285714,-67,-82,15
31,RL,0,50,1,-82,-82,-82,0
31,RL,1,50,4,-73.25,-67,-82,15
31,RL,1,50,8,-73.375,-67,-82,15
31,RL,1,50,6,-72.8333333333333,-67,-82,15
31,RL,0,50,1,-82,-82,-82,0
31,RL,1,50,4,-72,-68,-76,8
31,RL,1,50,5,-74.6,-68,-78,10
31,RL,1,50,6,-75.5,-72,-78,6
31,RL,1,50,6,-76.6666666666667,-72,-81,9
31,RL,1,50,7,-74,-61,-81,20
31,RL,1,50,6,-73.3333333333333,-61,-81,20
31,RL,1,50,8,-75.125,-68,-82,14
31,RL,1,50,10,-74,-67,-82,15
31,RL,1,50,10,-75.4,-68,-82,14
31,RL,1,50,4,-75.5,-72,-81,9
31,RL,1,50,3,-71.6666666666667,-61,-81,20
31,RL,1,50,3,-67.6666666666667,-61,-73,12
31,RL,1,50,8,-72,-61,-81,20
31,RL,1,50,4,-65.5,-61,-69,8
31,LR,1,50,9,-60.8888888888889,-60,-62,2
31,LR,1,50,3,-60,-60,-60,0
31,LR,1,50,3,-60.3333333333333,-60,-61,1
31,LR,1,50,10,-60.9,-59,-62,3
31,LR,1,50,9,-60.8888888888889,-59,-62,3
31,LR,1,50,6,-61,-59,-62,3
31,LR,1,50,5,-60.8,-59,-62,3
31,LR,0,50,2,-61,-61,-61,0
31,LR,1,50,10,-60.4,-59,-62,3
31,LR,1,50,9,-60.4444444444444,-59,-62,3
31,LR,1,50,9,-60.4444444444444,-59,-62,3
31,LR,1,50,6,-60.5,-59,-62,3
31,LR,1,50,7,-60.4285714285714,-59,-62,3
31,LR,1,50,10,-60.7,-60,-62,2
31,LR,1,50,4,-60.75,-60,-62,2
31,LR,1,50,7,-60.8571428571429,-60,-62,2
31,LR,0,50,2,-61,-60,-62,2
31,LR,1,50,6,-60.5,-60,-61,1
31,LR,1,50,5,-60.6,-60,-61,1
31,LR,1,50,3,-60.3333333333333,-60,-61,1
31,LR,1,50,8,-61.375,-60,-63,3
31,LR,1,50,6,-61.1666666666667,-60,-63,3
31,LR,1,50,10,-61.5,-60,-63,3
31,LR,1,50,5,-61.8,-60,-63,3
31,LR,1,50,8,-62.125,-60,-63,3
31,LR,1,50,10,-61.9,-59,-63,4
31,LR,1,50,3,-61.3333333333333,-60,-63,3
31,LR,1,50,5,-61.6,-60,-63,3
31,LR,1,50,9,-62.1111111111111,-59,-63,4
31,LR,0,50,1,-63,-63,-63,0
31,LR,1,50,6,-62.1666666666667,-59,-63,4
31,LR,1,50,6,-61.6666666666667,-59,-63,4
31,LR,1,50,7,-61.8571428571429,-60,-63,3
31,LR,0,50,2,-61,-60,-62,2
31,LR,0,50,1,-63,-63,-63,0
31,LR,0,50,1,-62,-62,-62,0
31,LR,1,50,3,-61.6666666666667,-60,-63,3
31,LR,1,50,7,-61.4285714285714,-60,-62,2
31,LR,1,50,6,-61.6666666666667,-60,-62,2
31,LR,1,50,6,-61.3333333333333,-60,-62,2
31,LR,1,50,7,-61.4285714285714,-60,-62,2
31,LR,1,50,7,-61.1428571428571,-60,-62,2
31,LR,1,50,6,-61,-60,-62,2
31,LR,1,50,9,-61.1111111111111,-60,-62,2
31,LR,1,50,8,-61.25,-60,-62,2
31,LR,1,50,9,-61.1111111111111,-60,-62,2
31,LR,1,50,8,-61.25,-60,-62,2
31,LR,0,50,2,-61,-60,-62,2
31,LR,1,50,8,-61.125,-59,-62,3
31,LR,1,50,4,-61.5,-60,-62,2
31,LR,1,50,9,-61.3333333333333,-59,-62,3
31,LR,1,50,9,-61.4444444444444,-59,-63,4
31,LR,1,50,3,-61,-59,-62,3
31,LR,1,50,8,-61.375,-59,-63,4
31,LR,1,50,6,-62,-61,-63,2
31,LR,1,50,4,-61.75,-61,-62,1
31,LR,0,50,2,-61.5,-61,-62,1
31,LR,0,50,1,-62,-62,-62,0
31,LR,1,50,5,-61.6,-60,-63,3
31,LR,1,50,10,-61.1,-60,-63,3
31,LR,0,50,1,-62,-62,-62,0
31,LR,1,50,7,-60.8571428571429,-60,-62,2
31,LR,1,50,6,-61,-60,-62,2
31,LR,1,50,6,-60.8333333333333,-59,-62,3
31,LR,0,50,1,-62,-62,-62,0
31,LR,0,50,2,-61,-60,-62,2
31,LR,1,50,5,-60.8,-59,-62,3
31,LR,1,50,6,-60.5,-60,-62,2
31,LR,1,50,4,-60.25,-60,-61,1
31,LR,1,50,7,-61.1428571428571,-60,-64,4
31,LR,0,50,1,-60,-60,-60,0
31,LR,1,50,9,-62.7777777777778,-59,-66,7
31,LR,1,50,4,-61.75,-59,-64,5
31,LR,0,50,2,-63,-62,-64,2
31,LR,1,50,8,-63.125,-59,-66,7
31,LR,1,50,3,-64.6666666666667,-64,-66,2
31,LR,1,50,5,-64,-62,-66,4
31,LR,0,50,2,-65,-64,-66,2
31,LR,0,50,1,-64,-64,-64,0
31,LR,1,50,5,-63.2,-62,-64,2
31,LR,0,50,1,-64,-64,-64,0
31,LR,1,50,9,-62,-59,-64,5
31,LR,1,50,8,-62.375,-61,-64,3
31,LR,1,50,8,-62.25,-60,-64,4
31,LR,1,50,8,-62.125,-60,-64,4
31,LR,1,50,9,-61.4444444444444,-59,-64,5
31,LR,1,50,7,-61.5714285714286,-59,-64,5
31,LR,0,50,1,-63,-63,-63,0
31,LR,1,50,6,-61,-59,-64,5
31,LR,1,50,6,-61,-59,-64,5
31,LR,1,50,6,-60.1666666666667,-59,-62,3
31,LR,1,50,4,-60.5,-59,-62,3
31,LR,1,50,8,-59.875,-59,-62,3
31,LR,1,50,6,-59.8333333333333,-59,-62,3
31,LR,1,50,4,-59.25,-59,-60,1
31,LR,1,50,6,-59.6666666666667,-59,-60,1
31,LR,1,50,6,-59.3333333333333,-58,-60,2
31,LR,0,50,1,-60,-60,-60,0
31,LR,1,50,5,-59.2,-58,-60,2
31,LR,0,50,2,-60,-60,-60,0
31,LR,0,50,1,-60,-60,-60,0
31,LR,0,50,2,-58.5,-58,-59,1
31,LR,1,50,4,-58.5,-58,-59,1
31,LR,0,50,2,-58,-58,-58,0
31,LR,1,50,9,-58.5555555555556,-58,-60,2
31,LR,1,50,8,-58.625,-58,-60,2
31,LR,1,50,5,-58.6,-58,-59,1
31,LR,1,50,5,-58.4,-58,-59,1
31,LR,1,50,10,-58.2,-58,-59,1
31,LR,1,50,4,-58,-58,-58,0
31,LR,1,50,5,-58.2,-58,-59,1
31,LR,1,50,9,-58.2222222222222,-58,-59,1
31,LR,0,50,2,-58.5,-58,-59,1
31,LR,1,50,4,-58.25,-58,-59,1
31,LR,0,50,1,-58,-58,-58,0
31,LR,1,50,6,-58.3333333333333,-58,-59,1
31,LR,1,50,6,-58.3333333333333,-58,-59,1
31,LR,1,50,6,-58.3333333333333,-58,-59,1
31,LR,1,50,5,-58.4,-58,-59,1
31,LR,0,50,2,-58.5,-58,-59,1
31,LR,1,50,5,-58.8,-58,-60,2
31,LR,1,50,3,-58.6666666666667,-58,-59,1
31,LR,0,50,2,-58.5,-58,-59,1
31,LR,1,50,7,-59.4285714285714,-58,-60,2
31,LR,1,50,3,-59.6666666666667,-59,-60,1
31,LR,1,50,3,-59,-58,-60,2
31,LR,1,50,8,-59.5,-58,-62,4
31,LR,0,50,1,-58,-58,-58,0
31,LR,1,50,8,-60.625,-59,-62,3
31,LR,1,50,3,-60.6666666666667,-60,-62,2
31,LR,1,50,3,-61,-60,-62,2
31,LR,1,50,3,-61.3333333333333,-61,-62,1
31,LR,1,50,4,-61,-60,-62,2
31,LR,0,50,1,-61,-61,-61,0
31,LR,1,50,3,-60.6666666666667,-60,-62,2
31,LR,0,50,2,-60,-60,-60,0
31,LR,1,50,3,-61,-60,-62,2
31,LR,1,50,3,-61.6666666666667,-61,-62,1
31,LR,1,50,7,-62.4285714285714,-62,-64,2
31,LR,1,50,10,-62.6,-62,-65,3
31,LR,1,50,9,-62.6666666666667,-62,-65,3
31,LR,0,50,2,-63,-62,-64,2
31,LR,0,50,1,-62,-62,-62,0
31,LR,1,50,4,-62,-62,-62,0
31,LR,1,50,8,-63.125,-62,-65,3
31,LR,1,50,10,-63.5,-62,-65,3
31,LR,1,50,5,-63.2,-62,-65,3
31,LR,1,50,8,-63.875,-62,-65,3
31,LR,1,50,6,-64,-62,-65,3
31,LR,1,50,6,-64,-62,-65,3
31,LR,0,50,1,-62,-62,-62,0
31,LR,1,50,7,-63.1428571428571,-61,-65,4
31,LR,0,50,1,-65,-65,-65,0
31,LR,1,50,9,-61.1111111111111,-59,-65,6
31,LR,0,50,2,-61.5,-61,-62,1
31,LR,1,50,3,-61,-60,-62,2
31,LR,0,50,1,-62,-62,-62,0
31,LR,0,50,2,-59.5,-59,-60,1
31,LR,1,50,4,-59.25,-59,-60,1
31,LR,0,50,2,-59.5,-59,-60,1
31,LR,0,50,1,-59,-59,-59,0
31,LR,0,50,2,-59.5,-59,-60,1
31,LR,0,50,1,-60,-60,-60,0
31,LR,1,50,9,-60.3333333333333,-59,-62,3
31,LR,0,50,2,-59,-59,-59,0
31,LR,1,50,3,-60.3333333333333,-60,-61,1
31,LR,1,50,3,-60,-59,-61,2
31,LR,1,50,9,-61.2222222222222,-59,-63,4
31,LR,1,50,3,-61,-59,-62,3
31,LR,1,50,3,-62,-62,-62,0
31,LR,1,50,4,-61,-59,-62,3
31,LR,1,50,8,-61.375,-59,-64,5
31,LR,1,50,9,-61.2222222222222,-59,-64,5
31,LR,0,50,2,-61,-59,-63,4
31,LR,1,50,9,-61.1111111111111,-59,-64,5
31,LR,1,50,9,-60.6666666666667,-59,-64,5
31,LR,1,50,5,-60.6,-60,-62,2
31,LR,1,50,5,-60.2,-59,-62,3
31,LR,1,50,7,-60,-59,-62,3
31,LR,1,50,10,-60.6,-59,-63,4
31,LR,1,50,3,-59.6666666666667,-59,-61,2
31,LR,1,50,4,-60,-59,-61,2
31,LR,1,50,8,-61.25,-59,-63,4
31,LR,0,50,1,-61,-61,-61,0
31,LR,1,50,3,-62.3333333333333,-61,-63,2
31,LR,1,50,6,-60.3333333333333,-58,-63,5
31,LR,1,50,10,-59.8,-58,-63,5
31,LR,1,50,8,-59.625,-58,-62,4
31,LR,1,50,4,-58.75,-58,-60,2
31,LR,1,50,6,-59.1666666666667,-58,-61,3
31,LR,1,50,3,-59.3333333333333,-59,-60,1
31,LR,1,50,3,-60,-59,-61,2
31,LR,1,50,6,-59,-58,-61,3
31,LR,1,50,3,-59,-58,-61,3
31,LR,0,50,1,-59,-59,-59,0
31,LR,0,50,2,-57,-57,-57,0
31,LR,0,50,1,-57,-57,-57,0
31,LR,1,50,7,-56.5714285714286,-56,-57,1
31,LR,0,50,1,-57,-57,-57,0
31,LR,1,50,6,-56.5,-56,-57,1
31,LR,1,50,4,-56.25,-56,-57,1
31,LR,1,50,7,-57.2857142857143,-56,-58,2
31,LR,1,50,3,-56.6666666666667,-56,-57,1
31,LR,1,50,4,-57.5,-57,-58,1
31,LR,1,50,4,-57.75,-57,-58,1
31,LR,1,50,4,-57,-56,-58,2
31,LR,1,50,6,-56.8333333333333,-56,-58,2
31,LR,1,50,4,-57.25,-57,-58,1
31,LR,1,50,6,-57.8333333333333,-57,-59,2
31,LR,1,50,6,-57.8333333333333,-57,-59,2
31,LR,1,50,7,-57.4285714285714,-56,-59,3
31,LR,1,50,10,-58.1,-56,-62,6
31,LR,1,50,8,-58.125,-56,-62,6
31,LR,1,50,8,-58,-56,-62,6
31,LR,1,50,7,-58,-56,-62,6
31,LR,1,50,5,-58.2,-56,-62,6
31,LR,1,50,5,-58.6,-56,-62,6
31,LR,1,50,5,-59,-56,-62,6
31,LR,1,50,5,-59.4,-58,-62,4
31,LR,1,50,7,-58.7142857142857,-58,-62,4
31,LR,1,50,9,-59,-58,-63,5
31,LR,1,50,7,-59.1428571428571,-58,-63,5
31,LR,1,50,7,-59.2857142857143,-58,-63,5
31,LR,1,50,5,-59.8,-58,-63,5
31,LR,1,50,3,-59,-58,-60,2
31,LR,1,50,10,-63.1,-58,-68,10
31,LR,1,50,9,-63.5555555555556,-58,-68,10
31,LR,0,50,2,-59.5,-58,-61,3
31,LR,0,50,2,-64,-61,-67,6
31,LR,0,50,1,-67,-67,-67,0
31,LR,1,50,10,-62.9,-59,-68,9
31,LR,0,50,2,-67.5,-67,-68,1
31,LR,1,50,6,-61.6666666666667,-59,-67,8
31,LR,1,50,7,-60.8571428571429,-59,-64,5
31,LR,1,50,6,-61.3333333333333,-59,-64,5
31,LR,0,50,2,-61.5,-61,-62,1
31,LR,0,50,2,-63,-62,-64,2
31,LR,1,50,8,-63.375,-62,-65,3
31,LR,1,50,8,-63.375,-62,-65,3
31,LR,0,50,1,-63,-63,-63,0
31,LR,1,50,5,-63.2,-62,-64,2
31,LR,1,50,5,-62.8,-62,-64,2
31,LR,0,50,1,-64,-64,-64,0
31,LR,1,50,7,-62.4285714285714,-62,-63,1
31,LR,1,50,4,-62.25,-62,-63,1
31,LR,1,50,4,-62.5,-62,-63,1
31,LR,1,50,7,-62.7142857142857,-62,-63,1
31,LR,1,50,4,-62.75,-62,-63,1
31,LR,1,50,9,-62.8888888888889,-62,-64,2
31,LR,0,50,1,-62,-62,-62,0
31,LR,1,50,6,-63,-62,-64,2
31,LR,0,50,1,-63,-63,-63,0
31,LR,1,50,8,-62.75,-62,-64,2
31,LR,1,50,5,-62.8,-62,-64,2
31,LR,1,50,5,-62.6,-62,-63,1
31,LR,0,50,2,-62.5,-62,-63,1
31,LR,1,50,9,-62,-61,-63,2
31,LR,1,50,8,-62,-61,-63,2
31,LR,1,50,4,-62.75,-62,-63,1
31,LR,1,50,3,-62.6666666666667,-62,-63,1
31,LR,1,50,8,-61.5,-61,-63,2
31,LR,1,50,7,-61.2857142857143,-61,-62,1
31,LR,1,50,10,-61.7,-61,-63,2
31,LR,1,50,5,-61.4,-61,-62,1
31,LR,0,50,2,-61,-61,-61,0
31,LR,1,50,10,-61.2,-59,-63,4
31,LR,1,50,5,-62.2,-62,-63,1
31,LR,1,50,7,-61.2857142857143,-59,-63,4
31,LR,0,50,1,-63,-63,-63,0
31,LR,1,50,8,-60.5,-59,-62,3
31,LR,1,50,5,-60.2,-59,-61,2
31,LR,1,50,8,-60,-59,-61,2
31,LR,1,50,4,-60,-59,-61,2
31,LR,1,50,6,-60.1666666666667,-59,-61,2
31,LR,1,50,6,-60.1666666666667,-59,-61,2
31,LR,1,50,8,-60,-59,-61,2
31,LR,1,50,7,-60,-59,-61,2
31,LR,1,50,8,-59.75,-59,-61,2
31,LR,1,50,8,-59.75,-59,-61,2
31,LR,1,50,8,-59.5,-59,-61,2
31,LR,1,50,7,-59.4285714285714,-59,-61,2
31,LR,1,50,9,-59.2222222222222,-59,-60,1
31,LR,0,50,2,-59.5,-59,-60,1
31,LR,1,50,10,-59.3,-59,-60,1
31,LR,1,50,9,-59.3333333333333,-59,-60,1
31,LR,1,50,7,-59.2857142857143,-59,-60,1
31,LR,1,50,8,-59.625,-59,-61,2
31,LR,1,50,3,-59.3333333333333,-59,-60,1
31,LR,1,50,7,-59.7142857142857,-59,-61,2
31,LR,1,50,7,-59.7142857142857,-59,-61,2
31,LR,0,50,1,-60,-60,-60,0
31,LR,1,50,10,-59.7,-59,-61,2
31,LR,1,50,5,-59.4,-59,-61,2
31,LR,1,50,7,-59.5714285714286,-59,-61,2
31,LR,1,50,4,-59.25,-59,-60,1
31,LR,1,50,4,-60,-59,-61,2
31,LR,1,50,4,-60.25,-60,-61,1
31,LR,0,50,1,-61,-61,-61,0
31,LR,1,50,3,-60,-60,-60,0
31,LR,0,50,2,-60,-60,-60,0
31,LR,1,50,7,-59.5714285714286,-59,-61,2
31,LR,1,50,10,-59.7,-59,-61,2
31,LR,1,50,4,-59.75,-59,-61,2
31,LR,1,50,10,-59.7,-58,-61,3
31,LR,1,50,5,-59.6,-59,-61,2
31,LR,1,50,6,-60,-59,-61,2
31,LR,0,50,1,-61,-61,-61,0
31,LR,1,50,6,-57.3333333333333,-56,-59,3
31,LR,1,50,6,-56.8333333333333,-56,-57,1
31,LR,1,50,5,-56.8,-56,-57,1
31,LR,1,50,4,-56.5,-56,-57,1
31,LR,1,50,3,-56.6666666666667,-56,-57,1
31,LR,1,50,6,-56.8333333333333,-56,-57,1
31,LR,1,50,10,-57.5,-56,-61,5
31,LR,0,50,2,-58.5,-54,-63,9
31,LR,1,50,6,-58.8333333333333,-54,-66,12
31,LR,1,50,5,-63.6,-54,-79,25
26,RL,1,50,3,-76.3333333333333,-66,-84,18
26,RL,1,50,7,-69.2857142857143,-64,-79,15
26,RL,1,50,8,-69.25,-64,-78,14
26,RL,1,50,7,-69.7142857142857,-64,-78,14
26,RL,1,50,8,-72.125,-66,-80,14
26,RL,1,50,5,-71.6,-66,-78,12
26,RL,1,50,9,-72.2222222222222,-67,-80,13
26,RL,1,50,4,-74,-68,-80,12
26,RL,1,50,8,-73.25,-67,-80,13
26,RL,0,50,1,-80,-80,-80,0
26,RL,1,50,9,-71.2222222222222,-67,-75,8
26,RL,1,50,6,-71.1666666666667,-67,-75,8
26,RL,1,50,4,-72,-70,-75,5
26,RL,1,50,7,-70.2857142857143,-68,-73,5
26,RL,0,50,2,-71.5,-70,-73,3
26,RL,1,50,6,-69.3333333333333,-67,-72,5
26,RL,1,50,6,-69,-67,-72,5
26,RL,1,50,5,-68.4,-67,-70,3
26,RL,1,50,3,-68,-67,-69,2
26,RL,1,50,7,-69.2857142857143,-67,-72,5
26,RL,1,50,10,-69.7,-67,-72,5
26,RL,1,50,10,-69.8,-68,-72,4
26,RL,1,50,6,-69.8333333333333,-68,-72,4
26,RL,1,50,6,-70,-68,-72,4
26,RL,1,50,4,-70,-69,-71,2
26,RL,1,50,10,-69.1,-67,-71,4
26,RL,1,50,6,-69,-68,-71,3
26,RL,1,50,10,-68.1,-66,-71,5
26,RL,0,50,2,-68.5,-68,-69,1
26,RL,1,50,4,-68.75,-68,-70,2
26,RL,1,50,9,-67.1111111111111,-66,-69,3
26,RL,1,50,3,-66.6666666666667,-66,-68,2
26,RL,1,50,9,-67.4444444444444,-65,-70,5
26,RL,1,50,10,-67.3,-65,-70,5
26,RL,1,50,7,-67.2857142857143,-65,-70,5
26,RL,1,50,10,-67.1,-66,-68,2
26,RL,1,50,7,-67,-66,-68,2
26,RL,1,50,7,-66.7142857142857,-66,-68,2
26,RL,1,50,9,-67.4444444444444,-66,-69,3
26,RL,1,50,10,-67.9,-66,-70,4
26,RL,1,50,10,-68.3,-66,-70,4
26,RL,1,50,5,-67.6,-66,-69,3
26,RL,1,50,9,-69,-67,-70,3
26,RL,1,50,6,-69.1666666666667,-68,-70,2
26,RL,1,50,8,-69.125,-68,-70,2
26,RL,1,50,4,-69,-68,-70,2
26,RL,1,50,9,-68.6666666666667,-67,-70,3
26,RL,0,50,1,-70,-70,-70,0
26,RL,0,50,2,-69,-68,-70,2
26,RL,1,50,4,-68.5,-67,-70,3
26,RL,0,50,1,-69,-69,-69,0
26,RL,1,50,8,-68.25,-67,-71,4
26,RL,1,50,5,-68.6,-68,-71,3
26,RL,1,50,7,-68.7142857142857,-68,-71,3
26,RL,0,50,2,-68,-68,-68,0
26,RL,1,50,7,-67.8571428571429,-66,-70,4
26,RL,1,50,7,-67.8571428571429,-66,-70,4
26,RL,0,50,1,-68,-68,-68,0
26,RL,1,50,10,-67.2,-66,-70,4
26,RL,0,50,1,-66,-66,-66,0
26,RL,0,50,2,-67.5,-67,-68,1
26,RL,1,50,6,-67,-66,-68,2
26,RL,0,50,2,-67,-66,-68,2
26,RL,1,50,3,-66.3333333333333,-66,-67,1
26,RL,1,50,9,-66.7777777777778,-64,-68,4
26,RL,1,50,8,-66.875,-64,-68,4
26,RL,1,50,4,-67.5,-67,-68,1
26,RL,0,50,1,-67,-67,-67,0
26,RL,1,50,10,-67.4,-64,-71,7
26,RL,1,50,7,-66.7142857142857,-64,-68,4
26,RL,1,50,5,-66.2,-64,-68,4
26,RL,1,50,9,-68,-65,-73,8
26,RL,1,50,10,-67.8,-65,-73,8
26,RL,1,50,3,-67,-66,-68,2
26,RL,1,50,6,-68.6666666666667,-65,-73,8
26,RL,1,50,10,-67.5,-65,-73,8
26,RL,1,50,3,-70.6666666666667,-68,-73,5
26,RL,1,50,4,-68.5,-65,-73,8
26,RL,1,50,10,-67.1,-65,-73,8
26,RL,1,50,6,-65.8333333333333,-65,-67,2
26,RL,1,50,9,-66.5555555555556,-65,-70,5
26,RL,1,50,4,-66.75,-65,-70,5
26,RL,1,50,5,-66.8,-65,-70,5
26,RL,1,50,5,-66.8,-65,-70,5
26,RL,1,50,9,-66.2222222222222,-65,-68,3
26,RL,1,50,4,-65.75,-65,-67,2
26,RL,1,50,5,-66,-65,-67,2
26,RL,1,50,6,-66.1666666666667,-65,-67,2
26,RL,1,50,4,-66.25,-65,-67,2
26,RL,1,50,10,-66.8,-65,-70,5
26,RL,0,50,2,-66,-65,-67,2
26,RL,1,50,3,-66.6666666666667,-66,-67,1
26,RL,0,50,1,-66,-66,-66,0
26,RL,1,50,7,-67.1428571428571,-66,-70,4
26,RL,1,50,10,-67,-66,-70,4
26,RL,1,50,7,-67,-66,-70,4
26,RL,1,50,6,-67.1666666666667,-66,-70,4
26,RL,1,50,6,-67,-66,-70,4
26,RL,1,50,8,-67.125,-66,-69,3
26,RL,0,50,2,-66,-66,-66,0
26,RL,1,50,7,-67.5714285714286,-66,-69,3
26,RL,1,50,9,-67,-64,-69,5
26,RL,0,50,2,-68,-68,-68,0
26,RL,1,50,7,-66.8571428571429,-64,-69,5
26,RL,1,50,9,-66.3333333333333,-64,-69,5
26,RL,1,50,6,-66.1666666666667,-64,-68,4
26,RL,1,50,5,-65.8,-64,-67,3
26,RL,1,50,3,-65.3333333333333,-64,-66,2
26,RL,1,50,7,-66,-64,-68,4
26,RL,1,50,7,-66.2857142857143,-64,-68,4
26,RL,1,50,7,-65.7142857142857,-62,-68,6
26,RL,0,50,2,-65.5,-64,-67,3
26,RL,0,50,1,-67,-67,-67,0
26,RL,0,50,2,-67.5,-67,-68,1
26,RL,1,50,5,-64.6,-62,-67,5
26,RL,1,50,6,-64.3333333333333,-62,-66,4
26,RL,1,50,5,-65.2,-62,-68,6
26,RL,1,50,5,-65.6,-64,-68,4
26,RL,1,50,9,-65.8888888888889,-64,-68,4
26,RL,1,50,5,-66.4,-64,-68,4
26,RL,1,50,10,-65.7,-64,-68,4
26,RL,1,50,10,-65.8,-64,-68,4
26,RL,1,50,4,-65.5,-64,-67,3
26,RL,0,50,1,-65,-65,-65,0
26,RL,1,50,10,-65.9,-61,-70,9
26,RL,1,50,5,-65.8,-65,-66,1
26,RL,0,50,1,-66,-66,-66,0
26,RL,1,50,6,-66.1666666666667,-61,-70,9
26,RL,1,50,6,-67.1666666666667,-61,-72,11
26,RL,1,50,3,-65,-61,-69,8
26,RL,1,50,10,-69.9,-65,-79,14
26,RL,1,50,8,-70.625,-67,-79,12
26,RL,1,50,9,-70.5555555555556,-67,-79,12
26,RL,1,50,6,-70.5,-67,-79,12
26,RL,1,50,5,-70.4,-67,-79,12
26,RL,0,50,1,-70,-70,-70,0
26,RL,1,50,7,-68,-66,-72,6
26,RL,1,50,4,-69.25,-68,-72,4
26,RL,1,50,3,-69,-66,-72,6
26,RL,1,50,7,-72.5714285714286,-66,-87,21
26,RL,0,50,2,-66,-66,-66,0
26,RL,1,50,6,-77.3333333333333,-69,-87,18
26,RL,1,50,4,-80,-70,-87,17
26,RL,0,50,2,-84,-81,-87,6
26,RL,1,50,8,-75,-70,-87,17
26,RL,1,50,9,-72.8888888888889,-70,-82,12
26,RL,1,50,8,-70.875,-68,-74,6
26,RL,1,50,5,-71.6,-70,-74,4
26,RL,1,50,6,-71.1666666666667,-68,-74,6
26,RL,1,50,4,-72.25,-71,-74,3
26,RL,1,50,4,-71.25,-68,-74,6
26,RL,1,50,6,-68.8333333333333,-66,-72,6
26,RL,1,50,6,-68.5,-66,-71,5
26,RL,1,50,10,-68.6,-66,-73,7
26,RL,1,50,9,-69.6666666666667,-67,-75,8
26,RL,1,50,3,-69.3333333333333,-68,-70,2
26,RL,0,50,1,-70,-70,-70,0
26,RL,1,50,5,-70.2,-67,-75,8
26,RL,1,50,10,-76.7,-68,-81,13
26,RL,1,50,6,-77,-75,-80,5
26,RL,1,50,3,-76.3333333333333,-75,-78,3
26,RL,1,50,7,-78,-75,-81,6
26,RL,1,50,6,-78.3333333333333,-75,-81,6
26,RL,1,50,8,-77,-73,-81,8
26,RL,1,50,7,-76.8571428571429,-73,-81,8
26,RL,1,50,5,-75.8,-73,-81,8
26,RL,1,50,9,-74.8888888888889,-73,-77,4
26,RL,1,50,8,-74.625,-73,-76,3
26,RL,1,50,6,-74.6666666666667,-73,-76,3
26,RL,0,50,2,-74.5,-74,-75,1
26,RL,0,50,2,-74.5,-74,-75,1
26,RL,1,50,5,-75.2,-74,-76,2
26,RL,1,50,5,-75.2,-74,-76,2
26,RL,1,50,10,-73.9,-72,-76,4
26,RL,1,50,7,-74,-72,-76,4
26,RL,1,50,8,-73.625,-72,-76,4
26,RL,0,50,2,-74,-73,-75,2
26,RL,1,50,7,-73.2857142857143,-72,-76,4
26,RL,1,50,8,-75.125,-72,-81,9
26,RL,1,50,8,-74.875,-71,-81,10
26,RL,1,50,7,-74.7142857142857,-71,-81,10
26,RL,1,50,8,-74.625,-71,-81,10
26,RL,1,50,4,-76,-71,-81,10
26,RL,1,50,3,-74.3333333333333,-71,-80,9
26,RL,1,50,8,-73.625,-70,-80,10
26,RL,1,50,5,-73,-71,-75,4
26,RL,1,50,8,-71.625,-66,-75,9
26,RL,1,50,10,-70.6,-65,-75,10
26,RL,1,50,10,-70.1,-65,-77,12
26,RL,1,50,8,-70.625,-65,-77,12
26,RL,1,50,5,-69,-65,-72,7
26,RL,1,50,6,-71.8333333333333,-68,-77,9
26,RL,1,50,7,-72.8571428571429,-68,-77,9
26,RL,0,50,1,-72,-72,-72,0
26,RL,1,50,3,-74.6666666666667,-73,-77,4
26,RL,0,50,2,-75,-73,-77,4
26,RL,1,50,9,-72.8888888888889,-69,-77,8
26,RL,1,50,5,-72,-69,-74,5
26,RL,1,50,7,-72.1428571428571,-69,-75,6
26,RL,1,50,7,-72.8571428571429,-69,-77,8
26,RL,1,50,9,-73.4444444444444,-70,-77,7
26,RL,1,50,6,-72.8333333333333,-70,-77,7
26,RL,1,50,9,-72,-67,-77,10
26,RL,1,50,5,-73.8,-70,-77,7
26,RL,0,50,1,-70,-70,-70,0
26,RL,0,50,1,-74,-74,-74,0
26,RL,1,50,9,-71.3333333333333,-67,-76,9
26,RL,1,50,9,-71.2222222222222,-67,-75,8
26,RL,1,50,5,-71.2,-67,-75,8
26,RL,1,50,4,-71.25,-67,-75,8
26,RL,1,50,3,-72.6666666666667,-70,-75,5
26,RL,1,50,3,-71.6666666666667,-67,-75,8
26,RL,1,50,10,-72.6,-67,-76,9
26,RL,1,50,7,-72.2857142857143,-67,-75,8
26,RL,1,50,8,-72.875,-70,-76,6
26,RL,1,50,3,-73,-72,-74,2
26,RL,0,50,2,-72.5,-72,-73,1
26,RL,1,50,7,-71.4285714285714,-67,-76,9
26,RL,1,50,5,-71.2,-67,-76,9
26,RL,1,50,3,-73,-71,-76,5
26,RL,1,50,10,-71.7,-67,-76,9
26,RL,1,50,5,-71.8,-67,-76,9
26,RL,1,50,5,-72.6,-67,-76,9
26,RL,1,50,8,-72.5,-69,-76,7
26,RL,1,50,5,-73,-69,-76,7
26,RL,0,50,2,-76,-76,-76,0
26,RL,1,50,9,-71.3333333333333,-68,-76,8
26,RL,0,50,2,-70.5,-69,-72,3
26,RL,1,50,5,-71.4,-69,-74,5
26,RL,1,50,6,-71.5,-68,-74,6
26,RL,1,50,10,-72.2,-68,-77,9
26,RL,1,50,10,-72.4,-67,-78,11
26,RL,0,50,2,-73,-72,-74,2
26,RL,1,50,4,-72.75,-70,-77,7
26,RL,1,50,10,-72.6,-67,-78,11
26,RL,0,50,2,-75.5,-74,-77,3
26,RL,1,50,10,-73,-67,-78,11
26,RL,1,50,10,-72.7,-67,-78,11
26,RL,1,50,4,-72.25,-67,-78,11
26,RL,1,50,7,-73.8571428571429,-71,-78,7
26,RL,1,50,5,-73.6,-72,-76,4
26,RL,1,50,6,-73,-71,-76,5
26,RL,1,50,10,-71.6,-68,-75,7
26,RL,1,50,5,-70.6,-68,-72,4
26,RL,1,50,5,-70.2,-68,-72,4
26,RL,1,50,3,-69.3333333333333,-68,-70,2
26,RL,1,50,9,-72.5555555555556,-68,-78,10
26,RL,1,50,7,-73,-70,-78,8
26,RL,0,50,2,-73,-72,-74,2
26,RL,1,50,4,-73.75,-70,-78,8
26,RL,1,50,4,-74.25,-70,-78,8
26,RL,1,50,10,-72.9,-66,-80,14
26,RL,0,50,1,-71,-71,-71,0
26,RL,1,50,5,-74,-69,-80,11
26,RL,0,50,2,-72,-69,-75,6
26,RL,1,50,9,-72.8888888888889,-66,-78,12
26,RL,0,50,2,-73,-72,-74,2
26,RL,1,50,3,-72,-66,-78,12
26,RL,1,50,8,-73.625,-70,-78,8
26,RL,1,50,7,-73,-70,-76,6
26,RL,0,50,2,-72,-70,-74,4
26,RL,1,50,7,-72.5714285714286,-68,-76,8
26,RL,1,50,6,-72.3333333333333,-68,-76,8
26,RL,0,50,1,-76,-76,-76,0
26,RL,1,50,9,-71.6666666666667,-68,-75,7
26,RL,0,50,2,-71.5,-68,-75,7
26,RL,1,50,5,-72.2,-70,-75,5
26,RL,1,50,4,-71.75,-70,-74,4
26,RL,1,50,3,-72,-70,-74,4
26,RL,1,50,8,-71.125,-69,-74,5
26,RL,1,50,10,-71.3,-68,-74,6
26,RL,1,50,6,-70.8333333333333,-69,-73,4
26,RL,1,50,8,-71.125,-68,-74,6
26,RL,0,50,2,-71,-69,-73,4
26,RL,1,50,4,-71.5,-70,-73,3
26,RL,1,50,3,-71,-70,-72,2
26,RL,1,50,8,-71.375,-68,-74,6
26,RL,1,50,9,-71.5555555555556,-68,-74,6
26,RL,1,50,5,-71.2,-68,-74,6
26,RL,1,50,7,-71.1428571428571,-68,-73,5
26,RL,1,50,5,-72,-69,-73,4
26,RL,1,50,3,-71.3333333333333,-69,-73,4
26,RL,1,50,10,-72.4,-69,-76,7
26,RL,1,50,9,-72.3333333333333,-69,-76,7
26,RL,1,50,10,-72.9,-69,-76,7
26,RL,1,50,8,-73.125,-69,-76,7
26,RL,1,50,9,-73.3333333333333,-69,-76,7
26,RL,0,50,2,-72.5,-71,-74,3
26,RL,1,50,3,-75.3333333333333,-74,-76,2
26,RL,1,50,5,-74.6,-73,-76,3
26,RL,1,50,10,-73.1,-68,-77,9
26,RL,1,50,7,-72.2857142857143,-68,-76,8
26,RL,1,50,3,-73.6666666666667,-73,-74,1
26,RL,1,50,5,-71.8,-68,-76,8
26,RL,1,50,6,-73,-68,-77,9
26,RL,1,50,6,-73,-68,-77,9
26,RL,0,50,2,-72.5,-68,-77,9
26,RL,1,50,3,-72,-68,-76,8
26,RL,0,50,1,-76,-76,-76,0
26,RL,1,50,8,-73.125,-68,-81,13
26,RL,1,50,5,-72.8,-68,-81,13
26,RL,1,50,5,-74,-69,-81,12
26,RL,1,50,9,-74.8888888888889,-70,-81,11
26,RL,0,50,1,-81,-81,-81,0
26,RL,1,50,7,-74.4285714285714,-70,-77,7
26,RL,1,50,3,-75.3333333333333,-74,-77,3
26,RL,1,50,4,-74.25,-70,-77,7
26,RL,1,50,5,-75,-70,-77,7
26,RL,1,50,9,-74,-70,-77,7
26,RL,1,50,5,-74.4,-72,-77,5
26,RL,1,50,4,-74.25,-72,-77,5
26,RL,1,50,8,-73.75,-70,-77,7
26,RL,1,50,6,-73,-70,-77,7
26,RL,1,50,8,-75.5,-70,-83,13
26,RL,1,50,8,-76.875,-70,-88,18
26,RL,0,50,2,-72.5,-70,-75,5
26,RL,1,50,7,-77.4285714285714,-70,-88,18
26,RL,0,50,1,-81,-81,-81,0
26,RL,1,50,8,-74.625,-67,-88,21
26,RL,0,50,1,-83,-83,-83,0
26,RL,1,50,3,-77.3333333333333,-70,-88,18
26,RL,1,50,8,-72,-67,-76,9
26,RL,1,50,8,-71.125,-67,-76,9
26,RL,1,50,9,-75.3333333333333,-67,-88,21
26,RL,1,50,9,-75.3333333333333,-67,-88,21
26,RL,1,50,4,-72.25,-68,-76,8
26,RL,1,50,5,-72,-67,-76,9
26,RL,1,50,7,-72.2857142857143,-67,-76,9
26,RL,0,50,2,-68.5,-68,-69,1
26,RL,0,50,2,-68.5,-68,-69,1
26,RL,1,50,9,-71.2222222222222,-67,-76,9
26,RL,1,50,4,-69.75,-68,-72,4
26,LR,1,50,9,-62.4444444444444,-55,-68,13
26,LR,0,50,1,-68,-68,-68,0
26,LR,1,50,10,-60.8,-55,-67,12
26,LR,0,50,2,-64.5,-62,-67,5
26,LR,1,50,8,-59.25,-55,-62,7
26,LR,1,50,9,-59.3333333333333,-59,-60,1
26,LR,1,50,4,-59.5,-59,-60,1
26,LR,1,50,5,-59.4,-59,-60,1
26,LR,1,50,3,-59.3333333333333,-59,-60,1
26,LR,0,50,2,-59,-59,-59,0
26,LR,0,50,2,-59,-59,-59,0
26,LR,0,50,1,-60,-60,-60,0
26,LR,0,50,1,-60,-60,-60,0
26,LR,1,50,7,-59.4285714285714,-59,-60,1
26,LR,1,50,8,-59.375,-59,-60,1
26,LR,0,50,1,-59,-59,-59,0
26,LR,1,50,6,-59.5,-59,-60,1
26,LR,0,50,1,-60,-60,-60,0
26,LR,1,50,10,-60.2,-59,-62,3
26,LR,0,50,1,-60,-60,-60,0
26,LR,1,50,5,-61,-60,-62,2
26,LR,1,50,4,-61.25,-60,-62,2
26,LR,1,50,3,-61.3333333333333,-60,-62,2
26,LR,1,50,3,-61.3333333333333,-60,-62,2
26,LR,1,50,3,-60.3333333333333,-59,-62,3
26,LR,1,50,3,-59.3333333333333,-59,-60,1
26,LR,1,50,4,-59.75,-58,-63,5
26,LR,1,50,6,-60.6666666666667,-58,-62,4
26,LR,1,50,7,-61.4285714285714,-58,-62,4
26,LR,1,50,3,-60.6666666666667,-58,-62,4
26,LR,1,50,10,-61,-58,-62,4
26,LR,0,50,1,-62,-62,-62,0
26,LR,0,50,1,-62,-62,-62,0
26,LR,1,50,4,-59.75,-58,-62,4
26,LR,0,50,2,-59.5,-58,-61,3
26,LR,1,50,6,-60.3333333333333,-58,-62,4
26,LR,0,50,1,-61,-61,-61,0
26,LR,1,50,3,-60.3333333333333,-58,-62,4
26,LR,1,50,4,-60.5,-58,-62,4
26,LR,1,50,3,-61.3333333333333,-61,-62,1
26,LR,1,50,3,-62,-61,-63,2
26,LR,1,50,4,-61,-59,-63,4
26,LR,0,50,2,-61,-59,-63,4
26,LR,1,50,3,-60.6666666666667,-59,-62,3
26,LR,0,50,1,-61,-61,-61,0
26,LR,1,50,9,-60.2222222222222,-58,-62,4
26,LR,1,50,4,-59.5,-58,-61,3
26,LR,1,50,10,-60.2,-57,-62,5
26,LR,1,50,7,-60.5714285714286,-58,-62,4
26,LR,1,50,6,-61,-58,-62,4
26,LR,0,50,2,-61.5,-61,-62,1
26,LR,1,50,5,-60.2,-57,-62,5
26,LR,1,50,10,-59.2,-57,-62,5
26,LR,1,50,9,-59.1111111111111,-57,-62,5
26,LR,1,50,10,-59.5,-57,-65,8
26,LR,1,50,5,-58.6,-57,-60,3
26,LR,1,50,6,-60.1666666666667,-57,-65,8
26,LR,1,50,7,-59.8571428571429,-57,-65,8
26,LR,0,50,1,-57,-57,-57,0
26,LR,1,50,4,-61.25,-60,-65,5
26,LR,1,50,5,-60.6,-58,-65,7
26,LR,1,50,4,-60.75,-58,-65,7
26,LR,0,50,1,-60,-60,-60,0
26,LR,1,50,9,-62.8888888888889,-60,-67,7
26,LR,1,50,5,-63.2,-60,-67,7
26,LR,1,50,9,-63.2222222222222,-60,-67,7
26,LR,1,50,4,-63.75,-62,-66,4
26,LR,1,50,6,-63,-60,-66,6
26,LR,1,50,5,-62.8,-60,-66,6
26,LR,1,50,8,-62.125,-57,-66,9
26,LR,1,50,8,-61.375,-57,-64,7
26,LR,1,50,10,-60.7,-57,-64,7
26,LR,1,50,10,-60.4,-57,-64,7
26,LR,1,50,10,-60.1,-56,-64,8
26,LR,1,50,9,-59.6666666666667,-56,-63,7
26,LR,1,50,5,-59.8,-58,-62,4
26,LR,1,50,10,-59.4,-56,-61,5
26,LR,1,50,9,-59.3333333333333,-56,-61,5
26,LR,1,50,3,-57.6666666666667,-56,-59,3
26,LR,1,50,3,-58,-56,-59,3
26,LR,0,50,2,-57.5,-56,-59,3
26,LR,1,50,4,-60.25,-59,-61,2
26,LR,1,50,3,-60.6666666666667,-60,-61,1
26,LR,1,50,8,-58.5,-56,-60,4
26,LR,1,50,6,-58.6666666666667,-57,-60,3
26,LR,1,50,7,-58.2857142857143,-56,-60,4
26,LR,1,50,5,-57.8,-56,-59,3
26,LR,1,50,4,-57.5,-56,-59,3
26,LR,1,50,7,-57.1428571428571,-56,-59,3
26,LR,1,50,6,-56.8333333333333,-56,-58,2
26,LR,1,50,3,-56.6666666666667,-56,-58,2
26,LR,1,50,4,-56.5,-56,-58,2
26,LR,1,50,5,-56.6,-56,-58,2
26,LR,1,50,8,-57,-56,-58,2
26,LR,1,50,7,-57.1428571428571,-56,-58,2
26,LR,0,50,1,-57,-57,-57,0
26,LR,1,50,7,-56.8571428571429,-56,-58,2
26,LR,1,50,7,-56.8571428571429,-56,-58,2
26,LR,1,50,5,-57,-56,-58,2
26,LR,1,50,10,-56.8,-56,-58,2
26,LR,1,50,7,-57,-56,-58,2
26,LR,0,50,1,-56,-56,-56,0
26,LR,0,50,1,-58,-58,-58,0
26,LR,1,50,8,-57,-56,-59,3
26,LR,1,50,6,-57.1666666666667,-56,-59,3
26,LR,1,50,5,-57,-56,-59,3
26,LR,1,50,9,-57,-56,-59,3
26,LR,1,50,9,-57.3333333333333,-56,-59,3
26,LR,1,50,5,-57.2,-56,-59,3
26,LR,1,50,10,-57.7,-56,-59,3
26,LR,1,50,6,-57.3333333333333,-56,-59,3
26,LR,1,50,10,-57.6,-56,-59,3
26,LR,1,50,9,-57.7777777777778,-56,-59,3
26,LR,1,50,6,-57.8333333333333,-56,-59,3
26,LR,1,50,10,-57.8,-56,-59,3
26,LR,1,50,5,-57.6,-56,-59,3
26,LR,1,50,9,-57.6666666666667,-56,-59,3
26,LR,1,50,5,-57.2,-56,-59,3
26,LR,1,50,10,-57.5,-56,-59,3
26,LR,1,50,7,-57.7142857142857,-56,-59,3
26,LR,1,50,4,-57.5,-56,-59,3
26,LR,1,50,8,-57.5,-56,-59,3
26,LR,0,50,2,-58.5,-58,-59,1
26,LR,1,50,3,-57.6666666666667,-57,-58,1
26,LR,0,50,2,-57.5,-57,-58,1
26,LR,1,50,4,-57.25,-56,-58,2
26,LR,1,50,7,-58.2857142857143,-56,-60,4
26,LR,1,50,3,-58.3333333333333,-56,-60,4
26,LR,1,50,7,-59.8571428571429,-58,-62,4
26,LR,1,50,3,-59.3333333333333,-58,-60,2
26,LR,0,50,2,-59,-58,-60,2
26,LR,1,50,3,-60.6666666666667,-60,-62,2
26,LR,1,50,8,-60.625,-59,-63,4
26,LR,1,50,5,-60,-59,-61,2
26,LR,1,50,6,-61,-59,-63,4
26,LR,1,50,9,-61.4444444444444,-59,-63,4
26,LR,1,50,9,-61.6666666666667,-59,-63,4
26,LR,1,50,8,-61.875,-59,-63,4
26,LR,1,50,9,-62.3333333333333,-61,-63,2
26,LR,0,50,2,-62,-62,-62,0
26,LR,1,50,3,-62,-61,-63,2
26,LR,1,50,3,-62,-61,-63,2
26,LR,0,50,2,-62.5,-62,-63,1
26,LR,1,50,9,-61.3333333333333,-57,-64,7
26,LR,1,50,6,-62.5,-61,-64,3
26,LR,1,50,10,-60.6,-57,-64,7
26,LR,1,50,5,-61.4,-57,-64,7
26,LR,0,50,1,-64,-64,-64,0
26,LR,0,50,1,-62,-62,-62,0
26,LR,1,50,10,-58.5,-57,-60,3
26,LR,0,50,1,-58,-58,-58,0
26,LR,1,50,4,-59.25,-58,-60,2
26,LR,1,50,5,-58.8,-58,-60,2
26,LR,1,50,3,-58.6666666666667,-58,-59,1
26,LR,1,50,9,-58.8888888888889,-57,-61,4
26,LR,1,50,5,-58.4,-57,-59,2
26,LR,1,50,3,-58,-57,-59,2
26,LR,1,50,9,-59.1111111111111,-57,-61,4
26,LR,1,50,9,-59.8888888888889,-57,-62,5
26,LR,1,50,5,-60,-58,-61,3
26,LR,1,50,6,-59.8333333333333,-57,-62,5
26,LR,0,50,1,-61,-61,-61,0
26,LR,1,50,9,-59.8888888888889,-57,-62,5
26,LR,1,50,5,-59.6,-57,-62,5
26,LR,1,50,8,-60.375,-58,-62,4
26,LR,0,50,1,-61,-61,-61,0
26,LR,1,50,10,-60.3,-58,-62,4
26,LR,1,50,10,-60.5,-58,-62,4
26,LR,1,50,4,-60.25,-58,-61,3
26,LR,1,50,6,-60.3333333333333,-58,-61,3
26,LR,0,50,1,-61,-61,-61,0
26,LR,0,50,2,-61,-61,-61,0
26,LR,1,50,4,-60,-58,-62,4
26,LR,1,50,6,-60,-58,-62,4
26,LR,1,50,8,-59.25,-56,-62,6
26,LR,1,50,9,-58.5555555555556,-56,-62,6
26,LR,0,50,1,-58,-58,-58,0
26,LR,0,50,1,-60,-60,-60,0
26,LR,1,50,4,-57,-56,-58,2
26,LR,1,50,7,-56.7142857142857,-55,-58,3
26,LR,1,50,6,-56.6666666666667,-55,-58,3
26,LR,1,50,10,-57.5,-55,-60,5
26,LR,1,50,5,-58.2,-55,-60,5
26,LR,0,50,1,-55,-55,-55,0
26,LR,0,50,1,-59,-59,-59,0
26,LR,1,50,6,-58,-56,-60,4
26,LR,1,50,7,-57.1428571428571,-55,-60,5
26,LR,1,50,9,-56.3333333333333,-54,-58,4
26,LR,1,50,4,-56.5,-55,-58,3
26,LR,1,50,9,-56,-54,-58,4
26,LR,1,50,5,-56,-55,-57,2
26,LR,1,50,8,-55.75,-54,-57,3
26,LR,1,50,9,-55.8888888888889,-54,-57,3
26,LR,1,50,5,-55.8,-54,-57,3
26,LR,1,50,6,-55.6666666666667,-54,-56,2
26,LR,1,50,5,-56,-56,-56,0
26,LR,1,50,7,-55.8571428571429,-55,-56,1
26,LR,1,50,10,-55.3,-54,-56,2
26,LR,1,50,4,-55.75,-55,-56,1
26,LR,1,50,8,-55.125,-54,-56,2
26,LR,0,50,2,-56,-56,-56,0
26,LR,1,50,6,-55,-54,-56,2
26,LR,1,50,5,-55.2,-54,-57,3
26,LR,1,50,5,-55.8,-54,-57,3
26,LR,1,50,9,-56.5555555555556,-54,-59,5
26,LR,0,50,1,-57,-57,-57,0
26,LR,1,50,7,-56.4285714285714,-54,-59,5
26,LR,1,50,10,-57.3,-54,-60,6
26,LR,1,50,3,-54.3333333333333,-54,-55,1
26,LR,1,50,7,-58,-54,-60,6
26,LR,1,50,8,-58.75,-57,-60,3
26,LR,0,50,1,-59,-59,-59,0
26,LR,1,50,7,-58.4285714285714,-57,-60,3
26,LR,1,50,10,-58.3,-56,-62,6
26,LR,1,50,9,-58.4444444444444,-56,-62,6
26,LR,1,50,10,-58.1,-56,-62,6
26,LR,1,50,4,-58.5,-57,-59,2
26,LR,1,50,4,-59.75,-59,-62,3
26,LR,1,50,6,-58.5,-56,-62,6
26,LR,0,50,2,-60.5,-59,-62,3
26,LR,1,50,3,-58.6666666666667,-56,-62,6
26,LR,1,50,9,-59.7777777777778,-56,-66,10
26,LR,0,50,2,-57.5,-57,-58,1
26,LR,1,50,10,-60.6,-56,-66,10
26,LR,1,50,9,-61,-56,-66,10
26,LR,1,50,8,-61.625,-57,-66,9
26,LR,1,50,7,-62,-57,-66,9
26,LR,1,50,10,-61.2,-57,-66,9
26,LR,1,50,5,-60.8,-57,-65,8
26,LR,1,50,10,-60.7,-57,-64,7
26,LR,1,50,9,-60.5555555555556,-57,-64,7
26,LR,1,50,5,-59.2,-57,-62,5
26,LR,1,50,10,-60.9,-57,-64,7
26,LR,0,50,2,-59,-59,-59,0
26,LR,1,50,5,-61.8,-59,-64,5
26,LR,1,50,7,-62,-61,-64,3
26,LR,1,50,6,-62,-61,-64,3
26,LR,1,50,9,-62.4444444444444,-61,-64,3
26,LR,1,50,8,-62.25,-61,-64,3
26,LR,1,50,4,-62,-61,-64,3
26,LR,0,50,1,-62,-62,-62,0
26,LR,1,50,4,-62.75,-61,-64,3
26,LR,1,50,10,-62.2,-61,-63,2
26,LR,1,50,8,-62.125,-61,-63,2
26,LR,1,50,8,-62,-61,-63,2
26,LR,1,50,3,-61.6666666666667,-61,-62,1
26,LR,0,50,1,-62,-62,-62,0
26,LR,1,50,8,-61.875,-61,-63,2
26,LR,1,50,7,-61.8571428571429,-61,-63,2
26,LR,0,50,1,-63,-63,-63,0
26,LR,0,50,1,-62,-62,-62,0
26,LR,1,50,6,-61.1666666666667,-61,-62,1
26,LR,1,50,5,-61.2,-61,-62,1
26,LR,1,50,8,-60.875,-60,-62,2
26,LR,1,50,5,-60.8,-60,-62,2
26,LR,1,50,4,-60.5,-60,-61,1
26,LR,0,50,1,-61,-61,-61,0
26,LR,0,50,2,-60,-60,-60,0
26,LR,1,50,4,-60.25,-60,-61,1
26,LR,1,50,9,-58.8888888888889,-58,-60,2
26,LR,0,50,2,-60,-60,-60,0
26,LR,1,50,9,-58.3333333333333,-58,-59,1
26,LR,1,50,9,-58.2222222222222,-58,-59,1
26,LR,1,50,4,-58.5,-58,-59,1
26,LR,1,50,10,-58.3,-58,-59,1
26,LR,1,50,3,-58.3333333333333,-58,-59,1
26,LR,1,50,5,-58.2,-58,-59,1
26,LR,1,50,8,-58.125,-58,-59,1
26,LR,0,50,2,-58,-58,-58,0
26,LR,1,50,8,-58.625,-58,-60,2
26,LR,1,50,5,-58.2,-58,-59,1
26,LR,1,50,7,-58.7142857142857,-58,-60,2
26,LR,0,50,1,-58,-58,-58,0
26,LR,0,50,2,-59,-58,-60,2
26,LR,0,50,1,-60,-60,-60,0
26,LR,1,50,10,-58.4,-58,-60,2
26,LR,1,50,5,-58.2,-58,-59,1
26,LR,1,50,3,-58.3333333333333,-58,-59,1
26,LR,1,50,4,-58.25,-58,-59,1
26,LR,1,50,7,-58.2857142857143,-57,-60,3
26,LR,1,50,8,-58.25,-57,-60,3
26,LR,1,50,10,-58.3,-57,-60,3
26,LR,0,50,1,-60,-60,-60,0
26,LR,1,50,10,-58.3,-57,-60,3
26,LR,0,50,2,-57.5,-57,-58,1
26,LR,1,50,10,-58.4,-57,-60,3
26,LR,1,50,3,-58.3333333333333,-58,-59,1
26,LR,1,50,10,-58.6,-57,-60,3
26,LR,1,50,4,-58.75,-58,-60,2
26,LR,1,50,3,-58.6666666666667,-58,-60,2
26,LR,1,50,7,-58.7142857142857,-57,-60,3
26,LR,1,50,10,-59,-57,-60,3
26,LR,1,50,10,-59,-57,-60,3
26,LR,1,50,5,-59,-58,-60,2
26,LR,1,50,6,-59.5,-58,-60,2
26,LR,1,50,9,-59.2222222222222,-58,-60,2
26,LR,1,50,4,-59.75,-59,-60,1
26,LR,1,50,7,-59.2857142857143,-58,-60,2
26,LR,1,50,7,-59.1428571428571,-58,-60,2
26,LR,1,50,6,-59,-58,-60,2
26,LR,1,50,3,-58.6666666666667,-58,-60,2
26,LR,1,50,6,-58.3333333333333,-56,-60,4
26,LR,1,50,6,-58.3333333333333,-56,-60,4
26,LR,1,50,10,-56.5,-55,-60,5
26,LR,1,50,4,-57.5,-56,-60,4
26,LR,1,50,3,-57.3333333333333,-56,-60,4
26,LR,1,50,3,-57,-55,-60,5
26,LR,1,50,9,-55.4444444444444,-55,-57,2
26,LR,1,50,9,-56.2222222222222,-55,-63,8
26,LR,1,50,7,-55.4285714285714,-55,-57,2
26,LR,1,50,10,-57.3,-55,-60,5
26,LR,1,50,6,-56.5,-55,-63,8
26,LR,1,50,6,-55.5,-55,-57,2
26,LR,1,50,8,-56,-55,-60,5
26,LR,0,50,2,-55.5,-55,-56,1
26,LR,1,50,4,-55.25,-55,-56,1
26,LR,1,50,5,-56.8,-55,-63,8
26,LR,0,50,2,-66.5,-63,-70,7
26,LR,1,50,8,-60.125,-55,-72,17
31,RL,1,100,8,-73.375,-64,-87,23
31,RL,1,100,8,-74.125,-65,-87,22
31,RL,1,100,9,-72.4444444444444,-66,-79,13
31,RL,0,100,2,-74.5,-71,-78,7
31,RL,1,100,7,-73.2857142857143,-66,-79,13
31,RL,0,100,1,-77,-77,-77,0
31,RL,1,100,6,-72.5,-66,-79,13
31,RL,1,100,5,-73,-66,-79,13
31,RL,1,100,10,-71.7,-67,-76,9
31,RL,1,100,3,-71,-71,-71,0
31,RL,1,100,7,-71.8571428571429,-70,-75,5
31,RL,1,100,4,-72.25,-70,-75,5
31,RL,0,100,1,-70,-70,-70,0
31,RL,0,100,2,-73.5,-72,-75,3
31,RL,1,100,10,-73,-67,-80,13
31,RL,1,100,7,-72.2857142857143,-67,-79,12
31,RL,1,100,4,-73,-67,-77,10
31,RL,1,100,10,-75.9,-67,-91,24
31,RL,1,100,6,-76.8333333333333,-68,-91,23
31,RL,1,100,8,-74.875,-67,-91,24
31,RL,0,100,2,-81.5,-72,-91,19
31,RL,1,100,6,-74.5,-67,-91,24
31,RL,1,100,9,-73.2222222222222,-67,-79,12
31,RL,1,100,3,-70.3333333333333,-67,-72,5
31,RL,1,100,4,-70.5,-68,-72,4
31,RL,1,100,3,-70,-68,-72,4
31,RL,1,100,7,-79.4285714285714,-70,-88,18
31,RL,1,100,10,-78.2,-72,-88,16
31,RL,1,100,9,-77.1111111111111,-66,-88,22
31,RL,1,100,7,-78.4285714285714,-72,-88,16
31,RL,1,100,8,-74.75,-66,-88,22
31,RL,1,100,4,-78,-72,-88,16
31,RL,1,100,9,-71,-66,-77,11
31,RL,1,100,7,-69.5714285714286,-66,-75,9
31,RL,0,100,1,-66,-66,-66,0
31,RL,0,100,1,-66,-66,-66,0
31,RL,1,100,9,-69,-64,-76,12
31,RL,0,100,1,-67,-67,-67,0
31,RL,1,100,4,-72.5,-67,-76,9
31,RL,1,100,10,-72.5,-64,-91,27
31,RL,1,100,3,-65,-64,-67,3
31,RL,1,100,4,-66.25,-64,-67,3
31,RL,1,100,7,-79.4285714285714,-67,-91,24
31,RL,1,100,10,-76.6,-66,-91,25
31,RL,0,100,2,-83,-78,-88,10
31,RL,1,100,9,-72.2222222222222,-63,-80,17
31,RL,1,100,8,-71.5,-63,-80,17
31,RL,1,100,4,-75.25,-67,-80,13
31,RL,1,100,3,-73.6666666666667,-67,-77,10
31,RL,1,100,8,-71.625,-63,-85,22
31,RL,1,100,4,-70.25,-63,-85,22
31,RL,1,100,10,-70.9,-63,-85,22
31,RL,1,100,5,-72.6,-63,-85,22
31,RL,0,100,1,-69,-69,-69,0
31,RL,1,100,4,-72.5,-67,-79,12
31,RL,0,100,2,-68.5,-67,-70,3
31,RL,0,100,2,-71,-68,-74,6
31,RL,1,100,3,-68.3333333333333,-67,-70,3
31,RL,1,100,7,-69.7142857142857,-65,-77,12
31,RL,1,100,4,-69.75,-68,-72,4
31,RL,0,100,2,-68.5,-68,-69,1
31,RL,0,100,1,-77,-77,-77,0
31,RL,1,100,4,-74,-65,-82,17
31,RL,0,100,2,-81.5,-81,-82,1
31,RL,0,100,1,-82,-82,-82,0
31,RL,1,100,8,-73.625,-66,-81,15
31,RL,1,100,10,-75.3,-68,-81,13
31,RL,1,100,4,-74.25,-71,-78,7
31,RL,1,100,3,-75.3333333333333,-72,-78,6
31,RL,1,100,9,-75.2222222222222,-68,-81,13
31,RL,1,100,5,-79,-76,-81,5
31,RL,1,100,5,-77.4,-68,-81,13
31,RL,1,100,8,-73.875,-68,-81,13
31,RL,0,100,2,-81,-81,-81,0
31,RL,1,100,5,-70.6,-68,-81,13
31,RL,1,100,3,-68,-68,-68,0
31,RL,0,100,2,-68,-68,-68,0
31,RL,1,100,10,-70.9,-65,-79,14
31,RL,1,100,6,-72.5,-65,-79,14
31,RL,0,100,2,-72,-65,-79,14
31,RL,1,100,7,-74.1428571428571,-68,-87,19
31,RL,1,100,10,-75.1,-67,-90,23
31,RL,0,100,1,-79,-79,-79,0
31,RL,1,100,8,-75.5,-67,-90,23
31,RL,1,100,8,-75.75,-67,-90,23
31,RL,1,100,10,-74,-64,-90,26
31,RL,1,100,10,-71.9,-64,-90,26
31,RL,0,100,2,-77,-77,-77,0
31,RL,1,100,8,-69,-64,-77,13
31,RL,1,100,6,-68.1666666666667,-64,-70,6
31,RL,1,100,4,-68,-64,-70,6
31,RL,1,100,6,-67.6666666666667,-64,-70,6
31,RL,1,100,9,-71.2222222222222,-64,-81,17
31,RL,1,100,3,-66.6666666666667,-64,-70,6
31,RL,1,100,7,-73.2857142857143,-66,-81,15
31,RL,1,100,6,-74.5,-66,-81,15
31,RL,1,100,5,-76.2,-72,-81,9
31,RL,1,100,6,-77.3333333333333,-72,-81,9
31,RL,1,100,4,-78.25,-76,-81,5
31,RL,1,100,9,-74.6666666666667,-67,-80,13
31,RL,1,100,4,-77.5,-76,-79,3
31,RL,1,100,4,-77.25,-75,-79,4
31,RL,1,100,3,-74.6666666666667,-70,-79,9
31,RL,0,100,2,-72.5,-70,-75,5
31,RL,1,100,6,-68,-66,-70,4
31,RL,1,100,6,-67,-66,-68,2
31,RL,1,100,3,-67.6666666666667,-67,-68,1
31,RL,1,100,6,-67.6666666666667,-65,-71,6
31,RL,1,100,3,-66.3333333333333,-65,-68,3
31,RL,1,100,3,-66.6666666666667,-65,-69,4
31,RL,1,100,5,-69.4,-67,-71,4
31,RL,0,100,1,-67,-67,-67,0
31,RL,0,100,2,-70,-70,-70,0
31,RL,0,100,1,-70,-70,-70,0
31,RL,1,100,6,-73.6666666666667,-67,-77,10
31,RL,0,100,1,-77,-77,-77,0
31,RL,1,100,4,-72.75,-67,-75,8
31,RL,1,100,5,-71.4,-67,-75,8
31,RL,1,100,9,-70.4444444444444,-67,-77,10
31,RL,1,100,7,-69,-67,-71,4
31,RL,1,100,3,-70.6666666666667,-70,-71,1
31,RL,1,100,5,-69.2,-68,-71,3
31,RL,1,100,3,-68,-68,-68,0
31,RL,1,100,10,-68.5,-65,-77,12
31,RL,1,100,10,-68.8,-65,-77,12
31,RL,0,100,2,-77,-77,-77,0
31,RL,1,100,3,-65.6666666666667,-65,-67,2
31,RL,0,100,1,-65,-65,-65,0
31,RL,1,100,10,-73.2,-66,-85,19
31,RL,1,100,7,-70.8571428571429,-66,-79,13
31,RL,1,100,3,-74.3333333333333,-72,-79,7
31,RL,1,100,5,-75.4,-67,-85,18
31,RL,1,100,6,-77.6666666666667,-67,-85,18
31,RL,1,100,6,-80.1666666666667,-69,-85,16
31,RL,1,100,8,-81.75,-72,-90,18
31,RL,1,100,7,-81.4285714285714,-72,-90,18
31,RL,1,100,6,-80.8333333333333,-72,-90,18
31,RL,1,100,4,-83,-80,-90,10
31,RL,0,100,2,-81,-72,-90,18
31,RL,1,100,6,-70.5,-68,-72,4
31,RL,0,100,2,-70,-70,-70,0
31,RL,1,100,5,-72,-70,-76,6
31,RL,1,100,3,-71.3333333333333,-71,-72,1
31,RL,1,100,3,-73.6666666666667,-71,-76,5
31,RL,0,100,1,-76,-76,-76,0
31,RL,1,100,10,-72.5,-68,-80,12
31,RL,1,100,10,-72.3,-68,-80,12
31,RL,1,100,9,-72.7777777777778,-68,-80,12
31,RL,1,100,8,-73.375,-70,-80,10
31,RL,0,100,2,-75.5,-71,-80,9
31,RL,1,100,10,-75.1,-70,-81,11
31,RL,1,100,5,-73,-70,-80,10
31,RL,1,100,9,-74.5555555555556,-70,-81,11
31,RL,1,100,3,-75.3333333333333,-72,-81,9
31,RL,1,100,8,-76.5,-70,-81,11
31,RL,1,100,6,-78.1666666666667,-73,-81,8
31,RL,1,100,3,-79,-77,-80,3
31,RL,1,100,5,-75.6,-70,-80,10
31,RL,1,100,4,-73,-70,-78,8
31,RL,1,100,5,-69.2,-66,-71,5
31,RL,0,100,1,-71,-71,-71,0
31,RL,1,100,10,-69.6,-63,-75,12
31,RL,1,100,9,-69.5555555555556,-63,-75,12
31,RL,1,100,9,-70.6666666666667,-63,-75,12
31,RL,0,100,2,-69,-66,-72,6
31,RL,1,100,8,-74.25,-70,-80,10
31,RL,1,100,8,-75.375,-70,-81,11
31,RL,1,100,5,-74.2,-70,-80,10
31,RL,0,100,2,-74.5,-73,-76,3
31,RL,1,100,8,-78.625,-70,-84,14
31,RL,0,100,2,-80,-80,-80,0
31,RL,1,100,7,-77.5714285714286,-70,-84,14
31,RL,1,100,10,-74.7,-69,-84,15
31,RL,1,100,10,-73,-69,-84,15
31,RL,0,100,1,-81,-81,-81,0
31,RL,1,100,4,-70.5,-69,-74,5
31,RL,1,100,3,-70.6666666666667,-69,-74,5
31,RL,1,100,8,-71,-69,-74,5
31,RL,1,100,3,-71,-69,-72,3
31,RL,0,100,1,-72,-72,-72,0
31,RL,1,100,4,-71.75,-70,-74,4
31,RL,1,100,8,-70.625,-67,-74,7
31,RL,0,100,1,-74,-74,-74,0
31,RL,1,100,6,-69.6666666666667,-67,-71,4
31,RL,1,100,7,-69.5714285714286,-67,-71,4
31,RL,1,100,8,-70.125,-67,-75,8
31,RL,1,100,5,-69,-67,-70,3
31,RL,1,100,3,-69.3333333333333,-69,-70,1
31,RL,1,100,4,-71,-69,-75,6
31,RL,1,100,4,-72.25,-70,-75,5
31,RL,1,100,4,-72.25,-70,-75,5
31,RL,1,100,3,-73,-70,-75,5
31,RL,1,100,6,-77.3333333333333,-70,-86,16
31,RL,1,100,7,-78,-70,-86,16
31,RL,1,100,4,-81.25,-77,-86,9
31,RL,1,100,7,-81.5714285714286,-77,-88,11
31,RL,1,100,9,-81.1111111111111,-76,-88,12
31,RL,1,100,8,-81,-74,-88,14
31,RL,1,100,6,-82.3333333333333,-76,-88,12
31,RL,0,100,1,-88,-88,-88,0
31,RL,1,100,4,-80.5,-76,-86,10
31,RL,1,100,9,-72.8888888888889,-66,-80,14
31,RL,0,100,2,-75,-74,-76,2
31,RL,0,100,2,-70.5,-67,-74,7
31,RL,1,100,7,-70,-66,-77,11
31,RL,1,100,6,-70,-67,-73,6
31,RL,1,100,7,-70,-67,-73,6
31,RL,1,100,8,-69.75,-67,-73,6
31,RL,1,100,9,-69.1111111111111,-66,-73,7
31,RL,1,100,9,-68.5555555555556,-66,-70,4
31,RL,1,100,6,-68.3333333333333,-66,-70,4
31,RL,0,100,2,-68.5,-68,-69,1
31,RL,1,100,9,-71.1111111111111,-66,-87,21
31,RL,1,100,6,-69,-66,-70,4
31,RL,1,100,6,-72.6666666666667,-68,-87,19
31,RL,1,100,3,-69.6666666666667,-68,-71,3
31,RL,1,100,10,-76.4,-68,-87,19
31,RL,1,100,10,-76.8,-71,-87,16
31,RL,1,100,9,-77.4444444444444,-72,-87,15
31,RL,1,100,8,-76.25,-72,-85,13
31,RL,1,100,7,-77.8571428571429,-72,-92,20
31,RL,0,100,2,-82,-82,-82,0
31,RL,1,100,10,-74.9,-70,-92,22
31,RL,1,100,3,-72.3333333333333,-72,-73,1
31,RL,1,100,10,-73,-68,-92,24
31,RL,1,100,7,-74,-68,-92,24
31,RL,0,100,1,-72,-72,-72,0
31,RL,0,100,1,-72,-72,-72,0
31,RL,1,100,3,-70,-68,-72,4
31,RL,0,100,1,-70,-70,-70,0
31,RL,1,100,4,-70.25,-68,-73,5
31,RL,0,100,1,-70,-70,-70,0
31,RL,0,100,1,-73,-73,-73,0
31,RL,1,100,8,-71.75,-66,-78,12
31,RL,0,100,1,-71,-71,-71,0
31,RL,1,100,6,-72.6666666666667,-66,-78,12
31,RL,0,100,2,-72,-68,-76,8
31,RL,1,100,8,-70.75,-66,-78,12
31,RL,1,100,6,-70,-66,-78,12
31,RL,1,100,9,-69.1111111111111,-66,-78,12
31,RL,1,100,9,-68.2222222222222,-66,-70,4
31,RL,1,100,7,-68.2857142857143,-66,-70,4
31,RL,1,100,7,-68.8571428571429,-67,-70,3
31,RL,1,100,6,-72.6666666666667,-68,-88,20
31,RL,1,100,5,-73.2,-68,-88,20
31,RL,1,100,7,-75.7142857142857,-68,-88,20
31,RL,1,100,9,-77.6666666666667,-70,-88,18
31,RL,0,100,2,-81,-74,-88,14
31,RL,1,100,10,-75.5,-69,-82,13
31,RL,1,100,9,-75.6666666666667,-69,-82,13
31,RL,1,100,8,-75.125,-69,-82,13
31,RL,0,100,2,-81.5,-81,-82,1
31,RL,0,100,1,-82,-82,-82,0
31,RL,0,100,1,-74,-74,-74,0
31,RL,1,100,8,-70.875,-67,-77,10
31,RL,1,100,4,-70.75,-69,-75,6
31,RL,1,100,8,-71.125,-67,-77,10
31,RL,1,100,6,-71.8333333333333,-67,-77,10
31,RL,1,100,9,-72.3333333333333,-67,-77,10
31,RL,1,100,5,-73.4,-70,-77,7
31,RL,0,100,2,-73.5,-70,-77,7
31,RL,0,100,1,-70,-70,-70,0
31,RL,1,100,10,-72.9,-70,-76,6
31,RL,1,100,7,-73.2857142857143,-70,-76,6
31,RL,1,100,4,-72.75,-70,-74,4
31,RL,1,100,7,-73.1428571428571,-70,-76,6
31,RL,0,100,2,-72,-70,-74,4
31,RL,0,100,2,-73.5,-73,-74,1
31,RL,0,100,2,-74.5,-73,-76,3
31,RL,1,100,10,-72.3,-70,-76,6
31,RL,1,100,7,-71.5714285714286,-70,-76,6
31,RL,1,100,4,-71.25,-70,-75,5
31,RL,1,100,3,-71.6666666666667,-70,-75,5
31,RL,1,100,8,-72.25,-70,-75,5
31,RL,1,100,9,-72.7777777777778,-70,-78,8
31,RL,0,100,1,-70,-70,-70,0
31,RL,1,100,7,-73.5714285714286,-71,-78,7
31,RL,0,100,2,-72,-71,-73,2
31,RL,1,100,6,-74.5,-71,-78,7
31,RL,1,100,8,-75.75,-73,-80,7
31,RL,0,100,2,-73.5,-73,-74,1
31,RL,1,100,5,-76,-74,-78,4
31,RL,0,100,1,-78,-78,-78,0
31,RL,0,100,2,-76.5,-75,-78,3
31,RL,1,100,5,-79.6,-78,-81,3
31,RL,0,100,2,-79.5,-78,-81,3
31,RL,0,100,1,-81,-81,-81,0
31,RL,0,100,2,-73,-73,-73,0
31,RL,0,100,2,-82,-73,-91,18
31,RL,1,100,10,-71.6,-67,-91,24
31,RL,0,100,2,-67.5,-67,-68,1
31,RL,1,100,4,-70.25,-68,-72,4
31,RL,1,100,7,-69.2857142857143,-66,-72,6
31,RL,0,100,1,-69,-69,-69,0
31,RL,1,100,4,-68,-66,-70,4
31,RL,1,100,5,-68.8,-66,-74,8
31,RL,1,100,8,-69,-66,-74,8
31,RL,1,100,5,-69.2,-66,-74,8
31,RL,1,100,7,-70,-66,-74,8
31,RL,1,100,8,-69.5,-66,-72,6
31,RL,1,100,5,-69.8,-69,-70,1
31,RL,1,100,5,-69.6,-69,-70,1
31,RL,1,100,9,-75.1111111111111,-69,-94,25
31,RL,1,100,5,-70.8,-69,-72,3
31,RL,1,100,8,-76.75,-69,-94,25
31,RL,1,100,8,-76.75,-70,-94,24
31,RL,1,100,7,-77.4285714285714,-70,-94,24
31,RL,1,100,6,-78.3333333333333,-70,-94,24
31,RL,1,100,7,-76.7142857142857,-70,-94,24
31,RL,0,100,2,-85.5,-77,-94,17
31,RL,1,100,7,-71.1428571428571,-70,-77,7
31,RL,1,100,5,-70.2,-70,-71,1
31,RL,1,100,8,-69.5,-67,-70,3
31,RL,1,100,4,-70,-70,-70,0
31,RL,1,100,5,-69.4,-67,-70,3
31,RL,1,100,8,-69.25,-66,-71,5
31,RL,1,100,10,-68.4,-66,-71,5
31,RL,1,100,9,-68.2222222222222,-66,-71,5
31,RL,1,100,10,-68.6,-66,-71,5
31,RL,1,100,7,-68.1428571428571,-66,-71,5
31,RL,1,100,3,-68,-66,-71,5
31,RL,1,100,10,-70.4,-66,-80,14
31,RL,1,100,10,-71.8,-66,-80,14
31,RL,1,100,7,-70.1428571428571,-66,-79,13
31,RL,1,100,5,-69.2,-67,-70,3
31,RL,0,100,1,-69,-69,-69,0
31,RL,0,100,2,-70,-70,-70,0
31,RL,1,100,10,-79.1,-70,-88,18
31,RL,0,100,1,-80,-80,-80,0
31,RL,1,100,5,-82.4,-76,-88,12
31,RL,1,100,6,-82,-76,-88,12
31,RL,1,100,8,-78.375,-71,-88,17
31,RL,1,100,7,-76.4285714285714,-71,-88,17
31,RL,1,100,5,-75,-71,-80,9
31,RL,1,100,7,-73.1428571428571,-69,-80,11
31,RL,1,100,3,-71.6666666666667,-71,-72,1
31,RL,1,100,4,-73,-69,-76,7
31,RL,0,100,2,-72.5,-69,-76,7
31,RL,1,100,7,-68.8571428571429,-66,-76,10
31,RL,1,100,5,-68,-66,-75,9
31,RL,0,100,1,-66,-66,-66,0
31,RL,1,100,6,-68.3333333333333,-66,-73,7
31,RL,0,100,1,-66,-66,-66,0
31,RL,0,100,1,-67,-67,-67,0
31,RL,1,100,6,-72,-66,-76,10
31,RL,1,100,3,-75,-73,-76,3
31,RL,1,100,8,-73.5,-69,-76,7
31,RL,1,100,3,-71.3333333333333,-69,-76,7
31,RL,1,100,7,-72.5714285714286,-69,-75,6
31,RL,0,100,2,-71,-69,-73,4
31,RL,1,100,6,-75,-72,-77,5
31,RL,1,100,6,-77.6666666666667,-72,-86,14
31,RL,1,100,8,-78.125,-72,-86,14
31,RL,1,100,7,-78.4285714285714,-72,-86,14
31,RL,1,100,7,-76.5714285714286,-72,-86,14
31,RL,0,100,1,-86,-86,-86,0
31,RL,0,100,1,-72,-72,-72,0
31,RL,1,100,8,-72.625,-70,-75,5
31,RL,1,100,3,-72,-72,-72,0
31,RL,1,100,6,-71,-67,-75,8
31,RL,1,100,7,-69.7142857142857,-67,-75,8
31,RL,0,100,2,-72.5,-70,-75,5
31,RL,1,100,7,-69.1428571428571,-67,-76,9
31,RL,1,100,6,-69,-67,-76,9
31,RL,1,100,10,-71,-67,-77,10
31,RL,1,100,7,-72.7142857142857,-67,-77,10
31,RL,1,100,4,-72.25,-70,-75,5
31,RL,1,100,3,-75.3333333333333,-74,-77,3
31,RL,1,100,4,-73.75,-66,-77,11
31,RL,0,100,1,-77,-77,-77,0
31,RL,1,100,10,-75.5,-66,-82,16
31,RL,0,100,2,-70,-66,-74,8
31,RL,1,100,5,-76.8,-73,-80,7
31,RL,1,100,5,-78,-73,-80,7
31,RL,1,100,5,-80.4,-79,-82,3
31,RL,1,100,5,-79.6,-77,-82,5
31,RL,0,100,1,-82,-82,-82,0
31,RL,1,100,3,-78,-77,-79,2
31,RL,1,100,5,-75.8,-73,-78,5
31,RL,1,100,7,-73.7142857142857,-68,-77,9
31,RL,1,100,4,-71.75,-68,-74,6
31,RL,0,100,2,-72.5,-72,-73,1
31,RL,1,100,8,-68.875,-65,-75,10
31,RL,1,100,5,-69.8,-68,-75,7
31,RL,1,100,7,-69.1428571428571,-65,-75,10
31,RL,1,100,6,-68.1666666666667,-65,-73,8
31,RL,1,100,7,-68.4285714285714,-65,-73,8
31,RL,1,100,6,-68.3333333333333,-65,-73,8
31,RL,1,100,4,-69.25,-65,-73,8
31,RL,1,100,3,-70.6666666666667,-69,-73,4
31,RL,0,100,1,-69,-69,-69,0
31,RL,1,100,3,-71.3333333333333,-70,-74,4
31,RL,1,100,3,-71,-69,-74,5
31,RL,0,100,2,-69.5,-69,-70,1
31,RL,1,100,7,-74.1428571428571,-71,-78,7
31,RL,1,100,6,-75,-73,-78,5
31,RL,1,100,5,-75.2,-73,-78,5
31,RL,1,100,7,-72,-69,-78,9
31,RL,1,100,10,-70.6,-68,-73,5
31,RL,1,100,7,-69.8571428571429,-68,-73,5
31,RL,1,100,7,-69.7142857142857,-68,-72,4
31,RL,1,100,8,-70.125,-68,-72,4
31,RL,1,100,6,-70.1666666666667,-68,-72,4
31,RL,1,100,9,-72.3333333333333,-68,-82,14
31,RL,1,100,3,-70.6666666666667,-68,-72,4
31,RL,0,100,2,-72,-72,-72,0
31,RL,1,100,10,-73.3,-70,-82,12
31,RL,0,100,1,-71,-71,-71,0
31,RL,1,100,4,-75.25,-71,-82,11
31,RL,1,100,5,-72.6,-70,-74,4
31,RL,1,100,8,-75.75,-70,-90,20
31,RL,1,100,7,-76.5714285714286,-74,-90,16
31,RL,1,100,10,-79.2,-74,-90,16
31,RL,1,100,10,-81.4,-74,-96,22
31,RL,1,100,5,-79.6,-74,-90,16
31,RL,0,100,1,-75,-75,-75,0
31,RL,1,100,3,-85.3333333333333,-82,-90,8
31,RL,1,100,10,-78.9,-67,-96,29
31,RL,1,100,10,-77.2,-67,-96,29
31,RL,1,100,4,-83.25,-73,-96,23
31,RL,0,100,1,-80,-80,-80,0
31,RL,1,100,7,-75.1428571428571,-67,-96,29
31,RL,1,100,8,-71,-67,-75,8
31,RL,1,100,10,-71.1,-67,-75,8
31,RL,1,100,3,-68,-67,-70,3
31,RL,1,100,6,-70.1666666666667,-67,-73,6
31,RL,1,100,6,-75.1666666666667,-71,-80,9
31,RL,1,100,4,-75.5,-73,-80,7
31,RL,0,100,1,-76,-76,-76,0
31,RL,1,100,8,-73.125,-70,-78,8
31,RL,1,100,3,-73,-72,-74,2
31,RL,0,100,2,-72.5,-72,-73,1
31,RL,0,100,1,-72,-72,-72,0
31,RL,1,100,5,-74.4,-70,-84,14
31,RL,1,100,3,-70.3333333333333,-70,-71,1
31,RL,1,100,5,-72.6,-68,-84,16
31,RL,1,100,8,-74.125,-68,-84,16
31,RL,1,100,3,-74,-68,-84,16
31,RL,1,100,7,-73.4285714285714,-68,-83,15
31,RL,0,100,2,-75.5,-68,-83,15
31,RL,1,100,9,-77.5555555555556,-72,-84,12
31,RL,0,100,1,-74,-74,-74,0
31,RL,1,100,7,-77.2857142857143,-72,-84,12
31,RL,1,100,8,-78.125,-72,-84,12
31,RL,0,100,1,-72,-72,-72,0
31,RL,1,100,3,-78,-76,-82,6
31,RL,1,100,7,-80.5714285714286,-78,-84,6
31,RL,1,100,4,-81.25,-79,-84,5
31,RL,1,100,6,-79.3333333333333,-78,-81,3
31,RL,1,100,3,-79.6666666666667,-79,-81,2
31,RL,0,100,2,-78.5,-78,-79,1
31,RL,1,100,10,-74.3,-70,-79,9
31,RL,0,100,1,-75,-75,-75,0
31,RL,1,100,9,-72.4444444444444,-69,-76,7
31,RL,1,100,3,-73.6666666666667,-71,-76,5
31,RL,1,100,10,-73.3,-69,-78,9
31,RL,0,100,1,-70,-70,-70,0
31,RL,0,100,1,-72,-72,-72,0
31,RL,1,100,5,-73,-69,-78,9
31,RL,1,100,7,-75.8571428571429,-69,-83,14
31,RL,0,100,2,-74.5,-72,-77,5
31,RL,0,100,1,-77,-77,-77,0
31,RL,0,100,2,-77,-76,-78,2
31,RL,1,100,9,-76.1111111111111,-71,-83,12
31,RL,1,100,4,-80,-78,-83,5
31,RL,1,100,4,-77,-71,-80,9
31,RL,1,100,7,-72.2857142857143,-66,-79,13
31,RL,1,100,5,-72.4,-70,-79,9
31,RL,1,100,6,-69.1666666666667,-66,-71,5
31,RL,1,100,4,-68.25,-66,-71,5
31,RL,1,100,6,-68.3333333333333,-66,-70,4
31,RL,1,100,9,-69.8888888888889,-66,-72,6
31,RL,1,100,3,-69.3333333333333,-69,-70,1
31,RL,1,100,8,-73.5,-69,-82,13
31,RL,1,100,9,-73.8888888888889,-70,-82,12
31,RL,1,100,10,-74.2,-70,-82,12
31,RL,1,100,9,-74.6666666666667,-71,-82,11
31,RL,1,100,9,-75.1111111111111,-71,-82,11
31,RL,0,100,2,-82,-82,-82,0
31,RL,1,100,10,-73.9,-71,-82,11
31,RL,1,100,5,-72.8,-71,-74,3
31,RL,0,100,2,-73,-73,-73,0
31,RL,0,100,2,-73.5,-73,-74,1
31,RL,1,100,6,-73,-71,-76,5
31,RL,0,100,2,-73.5,-71,-76,5
31,RL,1,100,3,-74,-71,-76,5
31,RL,1,100,8,-78,-71,-86,15
31,RL,1,100,10,-79.4,-71,-86,15
31,RL,1,100,7,-79.8571428571429,-71,-86,15
31,RL,1,100,3,-78.6666666666667,-74,-82,8
31,RL,0,100,2,-81,-80,-82,2
31,RL,0,100,1,-80,-80,-80,0
31,RL,0,100,2,-83,-81,-85,4
31,RL,0,100,1,-81,-81,-81,0
31,RL,1,100,7,-75,-68,-83,15
31,RL,1,100,5,-72.8,-68,-81,13
31,RL,1,100,9,-70.4444444444444,-67,-78,11
31,RL,0,100,1,-72,-72,-72,0
31,RL,1,100,4,-71.75,-67,-78,11
31,RL,1,100,4,-70.5,-67,-78,11
31,RL,1,100,6,-68.5,-67,-70,3
31,RL,1,100,5,-68.8,-68,-70,2
31,RL,1,100,8,-72.75,-68,-79,11
31,RL,1,100,7,-73.2857142857143,-68,-79,11
31,RL,1,100,5,-75.2,-70,-79,9
31,RL,1,100,5,-78.2,-75,-85,10
31,RL,1,100,10,-80.5,-76,-85,9
31,RL,1,100,9,-79.6666666666667,-76,-84,8
31,RL,1,100,7,-79.5714285714286,-76,-84,8
31,RL,0,100,2,-82.5,-82,-83,1
31,RL,0,100,2,-79.5,-76,-83,7
31,RL,1,100,4,-77,-76,-78,2
31,RL,1,100,8,-74.125,-72,-78,6
31,RL,1,100,8,-73.375,-72,-78,6
31,RL,1,100,8,-72.125,-72,-73,1
31,RL,1,100,9,-71.7777777777778,-71,-72,1
31,RL,1,100,7,-71.7142857142857,-71,-72,1
31,RL,0,100,1,-72,-72,-72,0
31,RL,0,100,2,-72,-72,-72,0
31,RL,1,100,8,-70.75,-69,-72,3
31,RL,1,100,4,-71.25,-71,-72,1
31,RL,1,100,9,-71,-69,-75,6
31,RL,0,100,2,-70,-69,-71,2
31,RL,1,100,9,-71.1111111111111,-69,-75,6
31,RL,1,100,3,-70,-70,-70,0
31,RL,1,100,9,-71.6666666666667,-70,-75,5
31,RL,1,100,10,-71.5,-70,-75,5
31,RL,0,100,2,-73.5,-72,-75,3
31,RL,1,100,4,-71.5,-71,-72,1
31,RL,1,100,7,-71.1428571428571,-70,-73,3
31,RL,1,100,5,-71.2,-70,-73,3
31,RL,0,100,2,-72,-71,-73,2
31,RL,1,100,7,-77.1428571428571,-70,-87,17
31,RL,1,100,3,-70.3333333333333,-70,-71,1
31,RL,1,100,9,-81.2222222222222,-70,-87,17
31,RL,1,100,7,-83.2857142857143,-78,-87,9
31,RL,0,100,1,-87,-87,-87,0
31,RL,1,100,6,-81.8333333333333,-78,-86,8
31,RL,1,100,10,-82.4,-78,-88,10
31,RL,1,100,4,-80,-78,-86,8
31,RL,1,100,9,-82,-77,-88,11
31,RL,0,100,1,-86,-86,-86,0
31,RL,1,100,10,-80.6,-72,-88,16
31,RL,1,100,4,-82.25,-77,-86,9
31,RL,1,100,6,-79.5,-72,-85,13
31,RL,1,100,6,-78.3333333333333,-72,-85,13
31,RL,1,100,10,-77,-72,-85,13
31,RL,1,100,3,-78,-72,-85,13
31,RL,1,100,7,-77.1428571428571,-72,-85,13
31,RL,1,100,6,-78,-74,-85,11
31,RL,1,100,3,-76,-74,-78,4
31,RL,1,100,4,-82,-76,-87,11
31,RL,0,100,2,-87,-87,-87,0
31,RL,0,100,2,-82.5,-78,-87,9
31,RL,0,100,1,-78,-78,-78,0
31,RL,1,100,3,-83.3333333333333,-80,-86,6
31,RL,1,100,6,-78,-73,-84,11
31,RL,1,100,5,-76.8,-73,-80,7
31,RL,0,100,2,-73.5,-73,-74,1
31,RL,1,100,4,-78,-74,-81,7
31,RL,1,100,7,-78.7142857142857,-76,-81,5
31,RL,1,100,10,-76.4,-68,-81,13
31,RL,1,100,10,-75.4,-68,-81,13
31,RL,1,100,3,-79,-77,-80,3
31,RL,1,100,3,-77,-74,-80,6
31,RL,1,100,9,-73.1111111111111,-68,-77,9
31,RL,1,100,10,-73,-68,-77,9
31,RL,0,100,1,-74,-74,-74,0
31,RL,1,100,5,-71.8,-68,-75,7
31,RL,0,100,2,-71,-70,-72,2
31,RL,1,100,4,-74.5,-72,-77,5
31,RL,1,100,9,-74.8888888888889,-66,-85,19
31,RL,1,100,7,-73.5714285714286,-66,-83,17
31,RL,0,100,1,-72,-72,-72,0
31,RL,0,100,2,-68.5,-66,-71,5
31,RL,1,100,7,-80.4285714285714,-69,-90,21
31,RL,1,100,5,-80.4,-69,-88,19
31,RL,0,100,1,-69,-69,-69,0
31,RL,1,100,9,-85.4444444444444,-80,-90,10
31,RL,1,100,4,-87.5,-85,-90,5
31,RL,1,100,4,-85,-80,-90,10
31,RL,1,100,7,-84.4285714285714,-80,-89,9
31,RL,1,100,7,-84,-80,-89,9
31,RL,1,100,6,-84.1666666666667,-80,-89,9
31,RL,1,100,6,-84,-82,-86,4
31,RL,1,100,5,-84,-82,-86,4
31,RL,1,100,6,-84.6666666666667,-82,-88,6
31,RL,1,100,9,-83.7777777777778,-74,-94,20
31,RL,1,100,5,-84.4,-82,-88,6
31,RL,1,100,5,-86.8,-82,-94,12
31,RL,1,100,6,-83.6666666666667,-74,-94,20
31,RL,0,100,1,-84,-84,-84,0
31,RL,0,100,1,-82,-82,-82,0
31,RL,1,100,3,-82.6666666666667,-74,-94,20
31,RL,1,100,8,-75.25,-72,-84,12
31,RL,1,100,8,-74.5,-72,-84,12
31,RL,0,100,1,-74,-74,-74,0
31,RL,1,100,3,-72.3333333333333,-72,-73,1
31,RL,1,100,7,-73.8571428571429,-70,-80,10
31,RL,1,100,8,-72.875,-69,-80,11
31,RL,1,100,7,-72,-69,-80,11
31,RL,1,100,7,-70.2857142857143,-68,-72,4
31,RL,1,100,9,-72.3333333333333,-68,-84,16
31,RL,0,100,1,-70,-70,-70,0
31,RL,1,100,9,-73.1111111111111,-68,-84,16
31,RL,1,100,5,-72.2,-68,-84,16
31,RL,1,100,9,-73.3333333333333,-68,-84,16
31,RL,1,100,9,-73.3333333333333,-68,-84,16
31,RL,1,100,3,-78.3333333333333,-75,-84,9
31,RL,0,100,1,-76,-76,-76,0
31,RL,0,100,1,-75,-75,-75,0
31,RL,1,100,8,-72.625,-66,-84,18
31,RL,1,100,9,-73.1111111111111,-66,-84,18
31,RL,1,100,8,-74,-66,-84,18
31,RL,1,100,7,-74.5714285714286,-66,-84,18
31,RL,1,100,4,-76.25,-73,-84,11
31,RL,1,100,4,-74.75,-74,-77,3
31,RL,1,100,7,-77.2857142857143,-74,-85,11
31,RL,1,100,7,-78.5714285714286,-74,-85,11
31,RL,1,100,4,-79,-77,-85,8
31,RL,1,100,4,-79,-77,-85,8
31,RL,1,100,4,-80.5,-77,-85,8
31,RL,1,100,8,-81,-76,-88,12
31,RL,0,100,2,-80,-77,-83,6
31,RL,1,100,7,-81.4285714285714,-76,-88,12
31,RL,1,100,10,-80.7,-76,-88,12
31,RL,1,100,3,-83.6666666666667,-76,-88,12
31,RL,1,100,6,-79.8333333333333,-76,-87,11
31,RL,1,100,6,-78.6666666666667,-76,-81,5
31,RL,1,100,4,-80,-78,-81,3
31,RL,0,100,2,-81,-81,-81,0
31,RL,1,100,3,-78.3333333333333,-74,-81,7
31,RL,1,100,7,-76.4285714285714,-74,-80,6
31,RL,1,100,6,-75.8333333333333,-74,-79,5
31,RL,1,100,4,-76.5,-74,-79,5
31,RL,1,100,9,-78.7777777777778,-74,-90,16
31,RL,1,100,4,-75.25,-74,-78,4
31,RL,1,100,3,-75.6666666666667,-74,-78,4
31,RL,0,100,1,-75,-75,-75,0
31,RL,0,100,2,-76.5,-75,-78,3
31,RL,1,100,3,-80,-75,-90,15
31,RL,1,100,9,-76.3333333333333,-66,-90,24
31,RL,1,100,7,-78,-68,-90,22
31,RL,1,100,10,-72.2,-66,-89,23
31,RL,1,100,10,-70.6,-66,-78,12
31,RL,1,100,5,-72,-66,-78,12
31,RL,1,100,6,-69.3333333333333,-66,-76,10
31,RL,0,100,1,-72,-72,-72,0
31,RL,1,100,4,-66.5,-66,-67,1
31,RL,1,100,5,-69.2,-66,-73,7
31,RL,1,100,7,-70.7142857142857,-66,-76,10
31,RL,1,100,6,-71.3333333333333,-66,-76,10
31,RL,1,100,4,-73,-70,-76,6
31,RL,1,100,8,-75.75,-70,-81,11
31,RL,1,100,10,-75.3,-68,-81,13
31,RL,1,100,5,-76,-70,-81,11
31,RL,1,100,6,-77.6666666666667,-75,-81,6
31,RL,1,100,7,-76.2857142857143,-68,-81,13
31,RL,0,100,1,-75,-75,-75,0
31,RL,1,100,5,-74.2,-68,-80,12
31,RL,1,100,4,-72.75,-68,-79,11
31,RL,1,100,9,-69.7777777777778,-67,-79,12
31,RL,1,100,6,-68.1666666666667,-67,-70,3
31,RL,1,100,7,-68.7142857142857,-67,-73,6
31,RL,1,100,3,-68.6666666666667,-68,-70,2
31,RL,1,100,3,-70,-67,-73,6
31,RL,1,100,7,-73.4285714285714,-67,-85,18
31,RL,1,100,7,-75.4285714285714,-67,-85,18
31,RL,1,100,8,-78.625,-70,-85,15
31,RL,1,100,9,-81.5555555555556,-77,-85,8
31,RL,1,100,8,-81.125,-77,-85,8
31,RL,1,100,8,-80.125,-77,-85,8
31,RL,0,100,1,-78,-78,-78,0
31,RL,1,100,8,-77.75,-74,-84,10
31,RL,0,100,1,-77,-77,-77,0
31,RL,0,100,2,-79,-74,-84,10
31,RL,1,100,9,-78.8888888888889,-74,-94,20
31,RL,1,100,3,-78.6666666666667,-77,-80,3
31,RL,0,100,1,-77,-77,-77,0
31,RL,1,100,3,-77.3333333333333,-76,-80,4
31,RL,1,100,4,-81.5,-76,-94,18
31,RL,0,100,1,-76,-76,-76,0
31,RL,1,100,8,-83.25,-76,-94,18
31,RL,1,100,3,-83,-80,-88,8
31,RL,1,100,3,-86.3333333333333,-81,-90,9
31,RL,1,100,3,-85.6666666666667,-79,-90,11
31,RL,1,100,6,-79.5,-76,-90,14
31,RL,1,100,5,-77.4,-76,-79,3
31,RL,1,100,8,-77.5,-76,-80,4
31,RL,1,100,10,-78.2,-76,-82,6
31,RL,0,100,2,-77,-76,-78,2
31,RL,1,100,8,-78.75,-76,-82,6
31,RL,0,100,1,-76,-76,-76,0
31,RL,1,100,6,-79.8333333333333,-78,-82,4
31,RL,0,100,2,-78,-78,-78,0
31,RL,0,100,1,-78,-78,-78,0
31,RL,0,100,1,-82,-82,-82,0
31,RL,0,100,2,-63,-63,-63,0
31,RL,1,100,5,-73.8,-63,-82,19
31,RL,0,100,1,-66,-66,-66,0
31,RL,1,100,8,-73.125,-63,-82,19
31,RL,1,100,4,-68.25,-63,-72,9
31,RL,0,100,2,-74,-74,-74,0
31,LR,1,100,6,-72,-64,-77,13
31,LR,0,100,2,-76,-75,-77,2
31,LR,1,100,3,-72.3333333333333,-68,-77,9
31,LR,1,100,8,-67.125,-64,-71,7
31,LR,1,100,10,-67.7,-64,-71,7
31,LR,1,100,7,-68.1428571428571,-64,-71,7
31,LR,1,100,4,-68.5,-68,-70,2
31,LR,1,100,3,-68,-66,-70,4
31,LR,1,100,6,-68.6666666666667,-66,-70,4
31,LR,1,100,10,-69,-66,-72,6
31,LR,0,100,2,-69,-68,-70,2
31,LR,0,100,2,-70,-68,-72,4
31,LR,1,100,8,-68.625,-66,-72,6
31,LR,1,100,3,-69.3333333333333,-68,-71,3
31,LR,0,100,1,-68,-68,-68,0
31,LR,1,100,9,-68,-66,-70,4
31,LR,0,100,2,-66.5,-66,-67,1
31,LR,1,100,9,-67.8888888888889,-66,-70,4
31,LR,1,100,6,-68.3333333333333,-66,-70,4
31,LR,1,100,5,-68.8,-66,-70,4
31,LR,0,100,2,-69,-68,-70,2
31,LR,1,100,5,-67.4,-66,-70,4
31,LR,1,100,9,-66.8888888888889,-65,-68,3
31,LR,0,100,1,-67,-67,-67,0
31,LR,1,100,7,-67,-65,-68,3
31,LR,0,100,2,-67.5,-67,-68,1
31,LR,1,100,5,-66.8,-65,-68,3
31,LR,1,100,6,-65.8333333333333,-64,-68,4
31,LR,1,100,9,-65.6666666666667,-64,-67,3
31,LR,0,100,1,-65,-65,-65,0
31,LR,1,100,9,-65.5555555555556,-64,-67,3
31,LR,1,100,4,-65,-64,-66,2
31,LR,0,100,2,-64.5,-64,-65,1
31,LR,1,100,7,-65.1428571428571,-62,-67,5
31,LR,1,100,3,-66.3333333333333,-66,-67,1
31,LR,1,100,5,-65,-62,-67,5
31,LR,1,100,5,-64.6,-62,-66,4
31,LR,1,100,9,-63.2222222222222,-61,-66,5
31,LR,1,100,8,-62.875,-61,-65,4
31,LR,0,100,2,-63.5,-62,-65,3
31,LR,1,100,8,-63.5,-61,-66,5
31,LR,1,100,6,-63,-61,-66,5
31,LR,1,100,8,-63.125,-61,-66,5
31,LR,1,100,4,-63.25,-61,-66,5
31,LR,1,100,10,-63.8,-62,-66,4
31,LR,1,100,6,-64,-62,-66,4
31,LR,1,100,8,-64,-62,-66,4
31,LR,0,100,1,-65,-65,-65,0
31,LR,1,100,3,-63,-62,-64,2
31,LR,1,100,8,-63.625,-62,-65,3
31,LR,1,100,5,-64,-63,-65,2
31,LR,1,100,3,-64,-63,-65,2
31,LR,0,100,1,-63,-63,-63,0
31,LR,1,100,10,-63.9,-63,-66,3
31,LR,1,100,3,-64.3333333333333,-63,-66,3
31,LR,1,100,10,-63.8,-63,-66,3
31,LR,1,100,10,-63.6,-63,-64,1
31,LR,1,100,7,-63.4285714285714,-63,-64,1
31,LR,1,100,7,-63.4285714285714,-63,-64,1
31,LR,1,100,3,-63,-63,-63,0
31,LR,1,100,4,-63.25,-63,-64,1
31,LR,1,100,5,-64,-63,-66,3
31,LR,1,100,5,-64.8,-63,-67,4
31,LR,1,100,9,-65.4444444444444,-64,-67,3
31,LR,1,100,5,-65.6,-64,-67,3
31,LR,1,100,10,-64.7,-63,-67,4
31,LR,0,100,1,-64,-64,-64,0
31,LR,1,100,6,-64.5,-63,-67,4
31,LR,1,100,8,-64.75,-63,-67,4
31,LR,1,100,4,-64,-63,-66,3
31,LR,1,100,4,-63.75,-63,-65,2
31,LR,0,100,2,-63.5,-63,-64,1
31,LR,0,100,2,-64,-63,-65,2
31,LR,0,100,2,-64.5,-64,-65,1
31,LR,1,100,3,-65.3333333333333,-64,-66,2
31,LR,1,100,3,-66.6666666666667,-66,-68,2
31,LR,1,100,6,-68,-66,-70,4
31,LR,1,100,9,-66.8888888888889,-64,-70,6
31,LR,1,100,5,-67.6,-64,-70,6
31,LR,1,100,4,-67.25,-64,-70,6
31,LR,1,100,3,-66.3333333333333,-64,-69,5
31,LR,0,100,1,-64,-64,-64,0
31,LR,1,100,4,-68.25,-65,-75,10
31,LR,0,100,2,-66.5,-66,-67,1
31,LR,1,100,7,-72.8571428571429,-67,-79,12
31,LR,1,100,5,-73.6,-68,-79,11
31,LR,1,100,10,-73.9,-68,-90,22
31,LR,1,100,5,-74.4,-68,-90,22
31,LR,1,100,10,-73.1,-68,-90,22
31,LR,1,100,5,-74.4,-68,-90,22
31,LR,0,100,1,-69,-69,-69,0
31,LR,1,100,8,-73.375,-69,-87,18
31,LR,1,100,6,-74.5,-69,-87,18
31,LR,0,100,1,-70,-70,-70,0
31,LR,1,100,7,-77,-69,-89,20
31,LR,1,100,5,-78,-69,-89,20
31,LR,1,100,3,-82,-70,-89,19
31,LR,1,100,4,-77,-70,-89,19
31,LR,1,100,4,-77,-70,-89,19
31,LR,1,100,4,-76.25,-70,-86,16
31,LR,1,100,6,-76.5,-70,-86,16
31,LR,1,100,3,-76.3333333333333,-70,-86,16
31,LR,0,100,1,-73,-73,-73,0
31,LR,1,100,3,-71.3333333333333,-70,-74,4
31,LR,1,100,4,-79.5,-70,-88,18
31,LR,1,100,9,-76.3333333333333,-69,-88,19
31,LR,1,100,6,-76.5,-69,-88,19
31,LR,1,100,4,-78.5,-69,-88,19
31,LR,1,100,9,-74.3333333333333,-69,-88,19
31,LR,1,100,5,-73.2,-69,-84,15
31,LR,1,100,10,-75.8,-69,-90,21
31,LR,1,100,8,-74.875,-69,-88,19
31,LR,1,100,6,-76.3333333333333,-69,-88,19
31,LR,1,100,5,-77.2,-69,-88,19
31,LR,1,100,5,-81.6,-69,-90,21
31,LR,1,100,3,-82,-69,-90,21
31,LR,1,100,8,-76.75,-67,-90,23
31,LR,1,100,9,-71,-67,-89,22
31,LR,1,100,3,-69.3333333333333,-67,-71,4
31,LR,1,100,5,-68.2,-67,-73,6
31,LR,1,100,5,-68.4,-67,-73,6
31,LR,1,100,8,-67.125,-65,-68,3
31,LR,1,100,10,-67.1,-65,-68,3
31,LR,1,100,5,-67.2,-65,-68,3
31,LR,1,100,3,-67,-65,-68,3
31,LR,0,100,2,-68,-68,-68,0
31,LR,1,100,8,-66.875,-65,-68,3
31,LR,1,100,10,-66.3,-65,-68,3
31,LR,1,100,8,-66.625,-65,-68,3
31,LR,1,100,10,-65.7,-62,-67,5
31,LR,0,100,1,-67,-67,-67,0
31,LR,1,100,4,-65.5,-65,-66,1
31,LR,1,100,8,-64.5,-62,-66,4
31,LR,1,100,5,-64,-62,-65,3
31,LR,1,100,8,-64.75,-62,-68,6
31,LR,1,100,4,-64.5,-63,-66,3
31,LR,0,100,2,-64.5,-63,-66,3
31,LR,1,100,10,-66.3,-64,-68,4
31,LR,1,100,4,-65.5,-64,-68,4
31,LR,1,100,10,-66.6,-64,-68,4
31,LR,1,100,3,-66.3333333333333,-66,-67,1
31,LR,1,100,10,-67.5,-65,-71,6
31,LR,1,100,7,-67.7142857142857,-65,-71,6
31,LR,1,100,7,-67.8571428571429,-65,-71,6
31,LR,1,100,4,-68,-65,-71,6
31,LR,1,100,7,-67.7142857142857,-64,-71,7
31,LR,1,100,6,-68.1666666666667,-64,-71,7
31,LR,1,100,3,-69,-68,-71,3
31,LR,0,100,2,-66,-64,-68,4
31,LR,1,100,7,-67.4285714285714,-64,-70,6
31,LR,0,100,2,-69,-68,-70,2
31,LR,1,100,9,-67.7777777777778,-64,-70,6
31,LR,1,100,4,-67.5,-64,-70,6
31,LR,1,100,8,-68,-64,-70,6
31,LR,1,100,9,-68.8888888888889,-64,-70,6
31,LR,1,100,9,-69.1111111111111,-64,-70,6
31,LR,1,100,10,-68.7,-64,-70,6
31,LR,1,100,9,-69.2222222222222,-65,-70,5
31,LR,1,100,5,-69.6,-68,-70,2
31,LR,1,100,3,-70,-70,-70,0
31,LR,1,100,5,-69,-65,-70,5
31,LR,0,100,2,-67.5,-65,-70,5
31,LR,1,100,4,-68.75,-65,-70,5
31,LR,1,100,4,-69,-66,-70,4
31,LR,1,100,5,-68.6,-66,-70,4
31,LR,1,100,3,-67.6666666666667,-66,-70,4
31,LR,1,100,7,-67.5714285714286,-66,-70,4
31,LR,1,100,3,-66.6666666666667,-66,-68,2
31,LR,1,100,5,-68.8,-66,-70,4
31,LR,0,100,2,-68,-66,-70,4
31,LR,1,100,7,-69.4285714285714,-66,-70,4
31,LR,0,100,1,-70,-70,-70,0
31,LR,1,100,6,-69.8333333333333,-66,-74,8
31,LR,1,100,8,-67.75,-63,-74,11
31,LR,1,100,8,-67.75,-63,-74,11
31,LR,0,100,2,-71.5,-69,-74,5
31,LR,1,100,4,-67,-63,-74,11
31,LR,1,100,3,-64.6666666666667,-63,-67,4
31,LR,1,100,8,-66.375,-64,-70,6
31,LR,1,100,3,-66.3333333333333,-64,-70,6
31,LR,1,100,3,-68.6666666666667,-68,-70,2
31,LR,1,100,7,-66.4285714285714,-64,-68,4
31,LR,1,100,8,-66.25,-64,-68,4
31,LR,1,100,10,-66.1,-64,-68,4
31,LR,1,100,8,-66,-64,-68,4
31,LR,1,100,4,-66.5,-65,-68,3
31,LR,1,100,7,-66.7142857142857,-64,-68,4
31,LR,0,100,1,-67,-67,-67,0
31,LR,0,100,1,-66,-66,-66,0
31,LR,1,100,7,-66.5714285714286,-64,-68,4
31,LR,0,100,1,-66,-66,-66,0
31,LR,1,100,5,-67.6,-66,-69,3
31,LR,1,100,6,-67.6666666666667,-66,-69,3
31,LR,1,100,5,-66.8,-65,-68,3
31,LR,1,100,4,-66.5,-65,-68,3
31,LR,1,100,4,-66.25,-65,-68,3
31,LR,1,100,9,-67.2222222222222,-65,-70,5
31,LR,1,100,8,-67.25,-66,-70,4
31,LR,1,100,5,-67.2,-66,-69,3
31,LR,1,100,7,-67.4285714285714,-66,-70,4
31,LR,1,100,10,-68.9,-66,-71,5
31,LR,1,100,7,-68.7142857142857,-66,-71,5
31,LR,1,100,7,-69.1428571428571,-66,-71,5
31,LR,1,100,10,-68.9,-66,-71,5
31,LR,1,100,7,-69.5714285714286,-66,-71,5
31,LR,1,100,8,-69.875,-66,-72,6
31,LR,0,100,2,-71,-71,-71,0
31,LR,1,100,3,-69.3333333333333,-66,-71,5
31,LR,1,100,7,-68.5714285714286,-66,-73,7
31,LR,1,100,7,-69.4285714285714,-66,-73,7
31,LR,1,100,9,-68.8888888888889,-65,-73,8
31,LR,1,100,3,-68.3333333333333,-66,-73,7
31,LR,1,100,3,-70.3333333333333,-66,-73,7
31,LR,1,100,6,-70,-65,-73,8
31,LR,1,100,10,-69.1,-65,-72,7
31,LR,1,100,10,-68.7,-65,-70,5
31,LR,0,100,2,-67.5,-65,-70,5
31,LR,1,100,3,-70,-70,-70,0
31,LR,1,100,6,-68.5,-66,-70,4
31,LR,1,100,10,-68.3,-66,-70,4
31,LR,0,100,1,-69,-69,-69,0
31,LR,1,100,5,-68.4,-68,-70,2
31,LR,1,100,5,-68.4,-68,-70,2
31,LR,1,100,4,-68,-68,-68,0
31,LR,1,100,7,-67.2857142857143,-65,-68,3
31,LR,1,100,4,-67.75,-67,-68,1
31,LR,1,100,8,-66.375,-64,-68,4
31,LR,0,100,1,-67,-67,-67,0
31,LR,0,100,2,-67.5,-67,-68,1
31,LR,1,100,4,-65.25,-64,-66,2
31,LR,0,100,1,-66,-66,-66,0
31,LR,0,100,2,-68.5,-66,-71,5
31,LR,1,100,4,-66.5,-65,-68,3
31,LR,1,100,4,-66.5,-65,-68,3
31,LR,1,100,8,-68.125,-65,-76,11
31,LR,1,100,7,-72.1428571428571,-66,-92,26
31,LR,1,100,10,-72.3,-66,-92,26
31,LR,0,100,2,-67,-66,-68,2
31,LR,1,100,5,-75,-68,-92,24
31,LR,1,100,9,-73.2222222222222,-68,-92,24
31,LR,0,100,1,-76,-76,-76,0
31,LR,1,100,9,-69.8888888888889,-66,-74,8
31,LR,0,100,2,-69,-68,-70,2
31,LR,1,100,6,-69.1666666666667,-66,-72,6
31,LR,1,100,8,-68.875,-66,-72,6
31,LR,1,100,3,-70.3333333333333,-69,-72,3
31,LR,1,100,9,-68.3333333333333,-66,-72,6
31,LR,1,100,5,-67.8,-66,-70,4
31,LR,1,100,6,-68,-66,-70,4
31,LR,1,100,10,-68.1,-65,-70,5
31,LR,0,100,1,-69,-69,-69,0
31,LR,1,100,10,-67.7,-65,-69,4
31,LR,1,100,8,-67.75,-65,-69,4
31,LR,1,100,5,-67.6,-65,-69,4
31,LR,1,100,3,-67.6666666666667,-67,-68,1
31,LR,1,100,7,-68.2857142857143,-67,-72,5
31,LR,1,100,9,-68.6666666666667,-67,-72,5
31,LR,1,100,9,-68.3333333333333,-65,-72,7
31,LR,1,100,3,-69.3333333333333,-68,-72,4
31,LR,0,100,1,-68,-68,-68,0
31,LR,1,100,5,-68.6,-67,-72,5
31,LR,1,100,10,-68.6,-65,-77,12
31,LR,1,100,8,-69,-65,-77,12
31,LR,1,100,5,-67.8,-65,-72,7
31,LR,1,100,6,-69.3333333333333,-65,-77,12
31,LR,1,100,3,-66.6666666666667,-65,-68,3
31,LR,0,100,2,-67.5,-67,-68,1
31,LR,1,100,6,-69,-66,-77,11
31,LR,1,100,7,-70.2857142857143,-66,-81,15
31,LR,1,100,9,-70.3333333333333,-66,-81,15
31,LR,1,100,8,-70.375,-66,-81,15
31,LR,1,100,5,-72.8,-67,-81,14
31,LR,1,100,3,-69.3333333333333,-67,-73,6
31,LR,1,100,6,-71.3333333333333,-66,-84,18
31,LR,0,100,2,-67.5,-67,-68,1
31,LR,0,100,2,-66.5,-66,-67,1
31,LR,1,100,5,-75.6,-66,-84,18
31,LR,1,100,7,-77.5714285714286,-74,-84,10
31,LR,1,100,5,-77.8,-74,-84,10
31,LR,1,100,4,-76.25,-74,-78,4
31,LR,1,100,10,-73.4,-66,-84,18
31,LR,1,100,7,-74.2857142857143,-66,-84,18
31,LR,1,100,3,-78.3333333333333,-78,-79,1
31,LR,1,100,3,-76,-74,-79,5
31,LR,1,100,5,-77,-75,-79,4
31,LR,0,100,1,-79,-79,-79,0
31,LR,1,100,6,-76.3333333333333,-73,-79,6
26,RL,1,100,3,-63.6666666666667,-62,-65,3
26,RL,1,100,6,-71.5,-62,-92,30
26,RL,1,100,7,-71.4285714285714,-66,-74,8
26,RL,1,100,9,-71.1111111111111,-66,-74,8
26,RL,1,100,9,-71.1111111111111,-66,-74,8
26,RL,0,100,1,-74,-74,-74,0
26,RL,0,100,2,-72,-70,-74,4
26,RL,1,100,9,-70.4444444444444,-66,-74,8
26,RL,0,100,1,-73,-73,-73,0
26,RL,0,100,2,-68.5,-68,-69,1
26,RL,0,100,1,-68,-68,-68,0
26,RL,1,100,8,-69.625,-66,-75,9
26,RL,0,100,2,-69.5,-66,-73,7
26,RL,1,100,9,-73.4444444444444,-67,-88,21
26,RL,1,100,6,-71.8333333333333,-67,-79,12
26,RL,1,100,8,-73.375,-67,-88,21
26,RL,1,100,6,-75,-68,-88,20
26,RL,0,100,1,-68,-68,-68,0
26,RL,1,100,3,-79.3333333333333,-71,-88,17
26,RL,0,100,2,-83.5,-79,-88,9
26,RL,1,100,7,-71.2857142857143,-63,-88,25
26,RL,1,100,7,-68,-63,-73,10
26,RL,0,100,1,-63,-63,-63,0
26,RL,1,100,10,-70.4,-66,-76,10
26,RL,1,100,7,-70.4285714285714,-66,-76,10
26,RL,1,100,4,-71,-68,-76,8
26,RL,1,100,10,-72,-64,-82,18
26,RL,0,100,1,-76,-76,-76,0
26,RL,1,100,5,-73.6,-66,-82,16
26,RL,1,100,7,-70.7142857142857,-64,-82,18
26,RL,1,100,6,-69.5,-64,-82,18
26,RL,0,100,2,-69,-66,-72,6
26,RL,1,100,8,-67.875,-64,-81,17
26,RL,1,100,4,-66,-64,-67,3
26,RL,0,100,1,-66,-66,-66,0
26,RL,1,100,6,-68.5,-64,-81,17
26,RL,1,100,4,-70,-65,-81,16
26,RL,1,100,3,-66.3333333333333,-65,-67,2
26,RL,1,100,9,-68.8888888888889,-64,-74,10
26,RL,1,100,4,-68.25,-64,-72,8
26,RL,1,100,5,-71,-67,-74,7
26,RL,0,100,2,-69.5,-67,-72,5
26,RL,1,100,7,-72,-65,-78,13
26,RL,1,100,6,-72,-65,-78,13
26,RL,1,100,10,-71.6,-65,-82,17
26,RL,1,100,5,-74.2,-65,-82,17
26,RL,1,100,8,-72.25,-65,-82,17
26,RL,1,100,8,-72.375,-66,-82,16
26,RL,1,100,5,-71.6,-66,-82,16
26,RL,1,100,5,-68.4,-66,-77,11
26,RL,0,100,1,-66,-66,-66,0
26,RL,1,100,4,-67.5,-66,-70,4
26,RL,1,100,7,-70.2857142857143,-66,-75,9
26,RL,1,100,6,-71,-66,-75,9
26,RL,0,100,1,-67,-67,-67,0
26,RL,0,100,1,-75,-75,-75,0
26,RL,1,100,7,-70.4285714285714,-66,-77,11
26,RL,1,100,10,-70.9,-66,-81,15
26,RL,1,100,6,-69.1666666666667,-66,-77,11
26,RL,1,100,8,-69.875,-66,-81,15
26,RL,1,100,3,-68,-66,-70,4
26,RL,1,100,4,-69,-66,-71,5
26,RL,1,100,5,-73,-69,-81,12
26,RL,1,100,8,-73.625,-66,-81,15
26,RL,1,100,3,-75.3333333333333,-71,-81,10
26,RL,1,100,10,-72.4,-66,-81,15
26,RL,1,100,7,-72.2857142857143,-66,-81,15
26,RL,0,100,2,-71.5,-66,-77,11
26,RL,1,100,3,-70.6666666666667,-70,-72,2
26,RL,1,100,10,-70.6,-66,-76,10
26,RL,1,100,6,-69.6666666666667,-66,-73,7
26,RL,0,100,2,-71.5,-71,-72,1
26,RL,1,100,5,-68.6,-66,-72,6
26,RL,1,100,4,-67.75,-66,-69,3
26,RL,1,100,4,-69,-66,-73,7
26,RL,1,100,8,-73.5,-68,-78,10
26,RL,1,100,7,-74.2857142857143,-69,-78,9
26,RL,1,100,3,-75.3333333333333,-73,-77,4
26,RL,1,100,10,-72.8,-64,-78,14
26,RL,1,100,3,-77.3333333333333,-77,-78,1
26,RL,1,100,5,-73.4,-70,-78,8
26,RL,1,100,5,-73,-70,-77,7
26,RL,0,100,1,-70,-70,-70,0
26,RL,1,100,10,-71.3,-64,-77,13
26,RL,1,100,9,-71.2222222222222,-64,-77,13
26,RL,1,100,3,-69.3333333333333,-64,-76,12
26,RL,1,100,7,-73,-68,-80,12
26,RL,0,100,2,-70.5,-68,-73,5
26,RL,1,100,8,-72.5,-68,-80,12
26,RL,0,100,2,-72.5,-71,-74,3
26,RL,1,100,5,-73.4,-68,-80,12
26,RL,1,100,3,-73.3333333333333,-68,-80,12
26,RL,1,100,4,-69,-67,-71,4
26,RL,0,100,1,-67,-67,-67,0
26,RL,1,100,3,-70,-67,-72,5
26,RL,1,100,9,-72.5555555555556,-67,-82,15
26,RL,1,100,8,-72.625,-67,-82,15
26,RL,1,100,9,-71.8888888888889,-67,-82,15
26,RL,0,100,1,-82,-82,-82,0
26,RL,1,100,3,-67.6666666666667,-67,-68,1
26,RL,1,100,10,-70.9,-66,-86,20
26,RL,1,100,10,-71.3,-66,-86,20
26,RL,1,100,7,-69.7142857142857,-66,-72,6
26,RL,1,100,10,-73.8,-66,-86,20
26,RL,1,100,6,-72,-66,-86,20
26,RL,1,100,4,-69.75,-66,-72,6
26,RL,1,100,4,-73.25,-66,-86,20
26,RL,1,100,7,-75.4285714285714,-68,-86,18
26,RL,1,100,4,-80,-72,-86,14
26,RL,1,100,5,-74.2,-68,-86,18
26,RL,1,100,7,-72.7142857142857,-68,-86,18
26,RL,0,100,2,-68.5,-68,-69,1
26,RL,1,100,8,-70.5,-66,-74,8
26,RL,1,100,10,-71.8,-66,-83,17
26,RL,0,100,1,-73,-73,-73,0
26,RL,1,100,9,-72.2222222222222,-66,-83,17
26,RL,1,100,9,-75.4444444444444,-68,-95,27
26,RL,1,100,3,-70,-68,-74,6
26,RL,1,100,7,-76.1428571428571,-68,-95,27
26,RL,0,100,1,-68,-68,-68,0
26,RL,1,100,9,-80.6666666666667,-70,-95,25
26,RL,1,100,9,-79.1111111111111,-69,-95,26
26,RL,1,100,7,-81.2857142857143,-70,-95,25
26,RL,1,100,7,-77.5714285714286,-69,-88,19
26,RL,1,100,5,-80,-70,-88,18
26,RL,1,100,9,-74.3333333333333,-68,-83,15
26,RL,1,100,7,-73.2857142857143,-68,-83,15
26,RL,1,100,9,-72.2222222222222,-65,-81,16
26,RL,1,100,7,-71.2857142857143,-65,-78,13
26,RL,1,100,10,-71.2,-65,-80,15
26,RL,1,100,7,-71.7142857142857,-65,-80,15
26,RL,1,100,3,-70.6666666666667,-65,-77,12
26,RL,1,100,8,-71.75,-65,-80,15
26,RL,1,100,5,-72,-65,-80,15
26,RL,0,100,1,-80,-80,-80,0
26,RL,1,100,7,-70,-66,-75,9
26,RL,1,100,6,-69.5,-66,-75,9
26,RL,1,100,10,-69.2,-66,-73,7
26,RL,1,100,4,-68.75,-66,-71,5
26,RL,1,100,6,-69.8333333333333,-66,-73,7
26,RL,1,100,6,-69.3333333333333,-66,-73,7
26,RL,1,100,8,-72.75,-68,-81,13
26,RL,1,100,7,-76.1428571428571,-67,-92,25
26,RL,1,100,10,-72.6,-65,-92,27
26,RL,0,100,2,-86.5,-81,-92,11
26,RL,1,100,4,-75.25,-67,-92,25
26,RL,1,100,4,-69,-67,-72,5
26,RL,1,100,8,-67.375,-65,-70,5
26,RL,1,100,8,-67.625,-65,-72,7
26,RL,1,100,3,-67.3333333333333,-67,-68,1
26,RL,1,100,3,-66.6666666666667,-65,-68,3
26,RL,1,100,10,-72.3,-65,-88,23
26,RL,1,100,10,-72.9,-65,-88,23
26,RL,0,100,2,-67.5,-67,-68,1
26,RL,1,100,10,-74.1,-68,-88,20
26,RL,1,100,9,-74.7777777777778,-70,-88,18
26,RL,1,100,7,-75.4285714285714,-70,-88,18
26,RL,1,100,8,-73.625,-65,-88,23
26,RL,0,100,1,-88,-88,-88,0
26,RL,1,100,8,-70.375,-65,-80,15
26,RL,1,100,10,-68.7,-65,-73,8
26,RL,1,100,6,-68.3333333333333,-65,-73,8
26,RL,1,100,7,-68.2857142857143,-65,-73,8
26,RL,1,100,6,-67.5,-65,-73,8
26,RL,1,100,3,-66.6666666666667,-66,-68,2
26,RL,1,100,5,-68.6,-65,-73,8
26,RL,1,100,5,-68.8,-65,-71,6
26,RL,1,100,6,-74.1666666666667,-68,-84,16
26,RL,1,100,8,-73.625,-67,-84,17
26,RL,0,100,1,-70,-70,-70,0
26,RL,0,100,2,-81.5,-79,-84,5
26,RL,1,100,7,-73.7142857142857,-67,-84,17
26,RL,1,100,3,-70.6666666666667,-67,-74,7
26,RL,1,100,5,-70.4,-67,-73,6
26,RL,1,100,10,-69.3,-65,-74,9
26,RL,0,100,1,-68,-68,-68,0
26,RL,1,100,7,-70.7142857142857,-67,-74,7
26,RL,1,100,5,-70.8,-68,-74,6
26,RL,0,100,2,-74,-74,-74,0
26,RL,1,100,3,-70.6666666666667,-68,-74,6
26,RL,1,100,4,-71,-68,-74,6
26,RL,1,100,8,-73.875,-68,-90,22
26,RL,0,100,2,-73,-72,-74,2
26,RL,1,100,6,-74.8333333333333,-68,-90,22
26,RL,1,100,9,-81,-68,-92,24
26,RL,0,100,1,-69,-69,-69,0
26,RL,0,100,1,-76,-76,-76,0
26,RL,0,100,2,-82,-74,-90,16
26,RL,1,100,3,-87,-80,-92,12
26,RL,1,100,3,-86.6666666666667,-80,-91,11
26,RL,1,100,10,-78.7,-68,-93,25
26,RL,1,100,7,-76.1428571428571,-68,-93,25
26,RL,1,100,5,-71.2,-68,-78,10
26,RL,1,100,8,-74.5,-68,-93,25
26,RL,1,100,10,-74.7,-68,-93,25
26,RL,0,100,2,-68.5,-68,-69,1
26,RL,1,100,8,-76.125,-70,-93,23
26,RL,1,100,4,-74.5,-73,-76,3
26,RL,1,100,8,-73.25,-67,-77,10
26,RL,1,100,7,-72.8571428571429,-67,-77,10
26,RL,1,100,10,-74.6,-67,-82,15
26,RL,1,100,3,-73.6666666666667,-70,-77,7
26,RL,1,100,10,-77.1,-67,-86,19
26,RL,1,100,4,-76.75,-67,-82,15
26,RL,1,100,10,-76.7,-67,-86,19
26,RL,1,100,10,-76.9,-69,-86,17
26,RL,1,100,8,-77.375,-71,-86,15
26,RL,1,100,9,-75.1111111111111,-69,-86,17
26,RL,1,100,10,-74.3,-68,-86,18
26,RL,1,100,5,-75.4,-69,-86,17
26,RL,1,100,8,-72,-68,-78,10
26,RL,0,100,1,-69,-69,-69,0
26,RL,1,100,9,-73.3333333333333,-68,-78,10
26,RL,1,100,7,-74.4285714285714,-68,-78,10
26,RL,1,100,10,-73.6,-68,-81,13
26,RL,1,100,4,-74,-68,-78,10
26,RL,1,100,8,-74,-68,-81,13
26,RL,1,100,10,-76.2,-69,-85,16
26,RL,1,100,3,-71.6666666666667,-71,-73,2
26,RL,1,100,6,-77.3333333333333,-71,-85,14
26,RL,1,100,9,-76.1111111111111,-66,-85,19
26,RL,1,100,7,-78,-69,-85,16
26,RL,1,100,3,-82.6666666666667,-81,-85,4
26,RL,1,100,4,-77,-69,-82,13
26,RL,1,100,10,-76,-66,-80,14
26,RL,1,100,8,-75.75,-66,-80,14
26,RL,0,100,1,-77,-77,-77,0
26,RL,1,100,5,-76.2,-66,-80,14
26,RL,1,100,8,-76.5,-72,-80,8
26,RL,0,100,1,-76,-76,-76,0
26,RL,1,100,3,-79.3333333333333,-79,-80,1
26,RL,1,100,5,-75.4,-72,-80,8
26,RL,1,100,9,-72.4444444444444,-69,-79,10
26,RL,1,100,9,-71.1111111111111,-67,-74,7
26,RL,1,100,8,-70.5,-67,-73,6
26,RL,1,100,8,-74.375,-67,-89,22
26,RL,1,100,4,-70.25,-67,-73,6
26,RL,0,100,2,-68.5,-67,-70,3
26,RL,1,100,3,-75.6666666666667,-71,-81,10
26,RL,1,100,10,-80,-68,-90,22
26,RL,1,100,10,-81.2,-68,-90,22
26,RL,1,100,5,-86.6,-83,-90,7
26,RL,0,100,1,-87,-87,-87,0
26,RL,1,100,9,-80.5555555555556,-68,-92,24
26,RL,1,100,9,-79.5555555555556,-68,-92,24
26,RL,0,100,1,-70,-70,-70,0
26,RL,1,100,7,-80.4285714285714,-68,-92,24
26,RL,1,100,4,-82.5,-73,-92,19
26,RL,1,100,9,-81,-75,-92,17
26,RL,1,100,9,-79.8888888888889,-75,-92,17
26,RL,1,100,8,-76.75,-72,-84,12
26,RL,1,100,5,-76.8,-75,-80,5
26,RL,1,100,8,-77.125,-72,-82,10
26,RL,1,100,8,-75.75,-66,-82,16
26,RL,1,100,3,-75.3333333333333,-74,-77,3
26,RL,1,100,10,-77.4,-66,-89,23
26,RL,1,100,9,-77.7777777777778,-66,-89,23
26,RL,0,100,2,-81,-80,-82,2
26,RL,1,100,6,-79.3333333333333,-66,-89,23
26,RL,1,100,3,-77.3333333333333,-66,-84,18
26,RL,1,100,9,-76.4444444444444,-70,-89,19
26,RL,1,100,8,-75.5,-70,-89,19
26,RL,1,100,8,-73.875,-69,-89,20
26,RL,1,100,10,-72.2,-67,-79,12
26,RL,1,100,6,-71.5,-69,-76,7
26,RL,0,100,2,-74,-72,-76,4
26,RL,1,100,6,-70.3333333333333,-67,-74,7
26,RL,1,100,10,-71.8,-67,-79,12
26,RL,1,100,7,-72.2857142857143,-67,-79,12
26,RL,1,100,9,-76.4444444444444,-67,-96,29
26,RL,0,100,2,-76.5,-74,-79,5
26,RL,1,100,8,-77.25,-70,-96,26
26,RL,1,100,8,-78,-70,-96,26
26,RL,1,100,5,-80.2,-71,-96,25
26,RL,1,100,9,-78.7777777777778,-71,-96,25
26,RL,1,100,4,-81.5,-71,-96,25
26,RL,0,100,2,-79.5,-79,-80,1
26,RL,1,100,4,-76.5,-73,-80,7
26,RL,1,100,9,-75.2222222222222,-66,-83,17
26,RL,1,100,4,-73.75,-73,-75,2
26,RL,0,100,1,-75,-75,-75,0
26,RL,1,100,7,-74,-66,-83,17
26,RL,1,100,10,-71.8,-65,-83,18
26,RL,1,100,3,-76,-66,-83,17
26,RL,1,100,6,-70.5,-65,-79,14
26,RL,0,100,1,-66,-66,-66,0
26,RL,1,100,9,-69.8888888888889,-65,-75,10
26,RL,1,100,8,-70.25,-65,-75,10
26,RL,1,100,4,-68.25,-65,-72,7
26,RL,0,100,2,-68.5,-65,-72,7
26,RL,1,100,9,-72.8888888888889,-65,-85,20
26,RL,1,100,5,-75.2,-69,-85,16
26,RL,1,100,3,-74,-71,-76,5
26,RL,1,100,3,-77.3333333333333,-71,-85,14
26,RL,0,100,1,-76,-76,-76,0
26,RL,1,100,8,-69.625,-64,-74,10
26,RL,1,100,7,-69,-64,-72,8
26,RL,1,100,9,-73.1111111111111,-64,-80,16
26,RL,1,100,3,-71,-69,-72,3
26,RL,1,100,8,-75.125,-64,-83,19
26,RL,0,100,1,-64,-64,-64,0
26,RL,1,100,4,-79.25,-76,-83,7
26,RL,0,100,1,-78,-78,-78,0
26,RL,1,100,5,-78.2,-71,-83,12
26,RL,1,100,4,-78.75,-71,-83,12
26,RL,1,100,7,-79,-71,-87,16
26,RL,1,100,6,-79,-71,-87,16
26,RL,1,100,10,-76.4,-64,-83,19
26,RL,0,100,2,-83,-79,-87,8
26,RL,1,100,4,-78.5,-78,-79,1
26,RL,0,100,2,-78.5,-78,-79,1
26,RL,1,100,4,-80.75,-78,-87,9
26,RL,0,100,1,-78,-78,-78,0
26,RL,1,100,8,-79,-73,-87,14
26,RL,1,100,10,-77.5,-71,-87,16
26,RL,1,100,7,-75.7142857142857,-71,-79,8
26,LR,1,100,4,-72.5,-69,-76,7
26,LR,1,100,4,-71.25,-69,-74,5
26,LR,1,100,9,-68.2222222222222,-60,-71,11
26,LR,1,100,4,-70,-67,-71,4
26,LR,1,100,6,-66.6666666666667,-60,-71,11
26,LR,1,100,3,-67.3333333333333,-60,-71,11
26,LR,0,100,1,-71,-71,-71,0
26,LR,1,100,9,-64.5555555555556,-60,-69,9
26,LR,0,100,1,-63,-63,-63,0
26,LR,1,100,3,-64.3333333333333,-64,-65,1
26,LR,1,100,10,-66.3,-64,-69,5
26,LR,0,100,1,-68,-68,-68,0
26,LR,1,100,10,-67.3,-65,-70,5
26,LR,1,100,4,-66.5,-65,-68,3
26,LR,1,100,5,-66.2,-65,-68,3
26,LR,1,100,6,-66.5,-65,-70,5
26,LR,1,100,8,-67.25,-65,-70,5
26,LR,0,100,1,-66,-66,-66,0
26,LR,1,100,6,-67.1666666666667,-66,-70,4
26,LR,0,100,2,-66.5,-66,-67,1
26,LR,1,100,6,-66.8333333333333,-66,-68,2
26,LR,0,100,1,-66,-66,-66,0
26,LR,1,100,3,-67,-66,-68,2
26,LR,1,100,5,-67.8,-66,-70,4
26,LR,1,100,7,-66.1428571428571,-61,-70,9
26,LR,0,100,2,-69,-68,-70,2
26,LR,1,100,10,-65.3,-61,-68,7
26,LR,0,100,2,-65,-64,-66,2
26,LR,1,100,4,-64.25,-61,-66,5
26,LR,1,100,4,-64.75,-61,-66,5
26,LR,1,100,8,-65,-63,-67,4
26,LR,1,100,3,-65.3333333333333,-64,-66,2
26,LR,1,100,5,-64.2,-63,-66,3
26,LR,1,100,10,-64.5,-63,-67,4
26,LR,0,100,1,-63,-63,-63,0
26,LR,1,100,8,-64.5,-63,-67,4
26,LR,1,100,6,-64.1666666666667,-63,-66,3
26,LR,1,100,10,-63.5,-61,-66,5
26,LR,0,100,1,-63,-63,-63,0
26,LR,1,100,4,-64,-63,-65,2
26,LR,1,100,10,-62.9,-61,-64,3
26,LR,0,100,1,-64,-64,-64,0
26,LR,1,100,7,-62.4285714285714,-61,-64,3
26,LR,1,100,3,-62.6666666666667,-61,-64,3
26,LR,1,100,6,-61.8333333333333,-59,-65,6
26,LR,1,100,5,-62,-59,-65,6
26,LR,1,100,6,-61.3333333333333,-59,-65,6
26,LR,0,100,2,-59.5,-59,-60,1
26,LR,1,100,9,-61.8888888888889,-59,-64,5
26,LR,1,100,3,-62.3333333333333,-61,-64,3
26,LR,1,100,3,-63,-62,-64,2
26,LR,1,100,9,-62.4444444444444,-62,-63,1
26,LR,1,100,5,-62.4,-62,-63,1
26,LR,1,100,4,-62.25,-62,-63,1
26,LR,1,100,10,-62.5,-61,-65,4
26,LR,1,100,5,-62.6,-62,-63,1
26,LR,1,100,5,-62.8,-61,-65,4
26,LR,1,100,3,-63,-61,-65,4
26,LR,1,100,6,-62.5,-61,-65,4
26,LR,1,100,6,-62.8333333333333,-62,-65,3
26,LR,1,100,6,-62.8333333333333,-62,-65,3
26,LR,1,100,7,-63.4285714285714,-62,-65,3
26,LR,1,100,9,-63.5555555555556,-62,-65,3
26,LR,1,100,5,-63.6,-62,-65,3
26,LR,1,100,7,-63.4285714285714,-62,-65,3
26,LR,1,100,9,-63.2222222222222,-61,-65,4
26,LR,0,100,1,-62,-62,-62,0
26,LR,1,100,7,-63.2857142857143,-61,-65,4
26,LR,1,100,3,-63,-61,-65,4
26,LR,0,100,2,-62,-61,-63,2
26,LR,1,100,6,-64.5,-62,-66,4
26,LR,1,100,8,-64.75,-63,-66,3
26,LR,0,100,1,-66,-66,-66,0
26,LR,1,100,3,-65.6666666666667,-65,-66,1
26,LR,1,100,7,-64.8571428571429,-63,-67,4
26,LR,1,100,10,-64.5,-63,-67,4
26,LR,1,100,8,-64.5,-63,-67,4
26,LR,1,100,5,-64.2,-63,-67,4
26,LR,0,100,2,-64,-64,-64,0
26,LR,0,100,2,-65.5,-64,-67,3
26,LR,1,100,7,-64.2857142857143,-63,-67,4
26,LR,0,100,1,-63,-63,-63,0
26,LR,1,100,4,-64.25,-63,-66,3
26,LR,1,100,7,-64,-63,-67,4
26,LR,1,100,10,-64.4,-63,-67,4
26,LR,1,100,5,-64,-63,-67,4
26,LR,1,100,3,-63.3333333333333,-63,-64,1
26,LR,1,100,3,-65,-63,-67,4
26,LR,1,100,7,-66,-65,-67,2
26,LR,1,100,4,-65.25,-65,-66,1
26,LR,1,100,10,-65.7,-64,-67,3
26,LR,1,100,8,-65.875,-64,-67,3
26,LR,1,100,6,-65.6666666666667,-64,-67,3
26,LR,1,100,9,-66.6666666666667,-64,-73,9
26,LR,1,100,7,-65.7142857142857,-64,-67,3
26,LR,1,100,10,-68.8,-64,-88,24
26,LR,0,100,2,-65.5,-65,-66,1
26,LR,0,100,1,-66,-66,-66,0
26,LR,1,100,8,-75.375,-67,-94,27
26,LR,0,100,1,-88,-88,-88,0
26,LR,1,100,9,-77.2222222222222,-67,-94,27
26,LR,1,100,8,-78.5,-67,-94,27
26,LR,1,100,7,-80.1428571428571,-67,-94,27
26,LR,1,100,10,-79.9,-68,-94,26
26,LR,1,100,5,-80.4,-68,-93,25
26,LR,1,100,8,-78.875,-68,-93,25
26,LR,1,100,5,-71.8,-68,-75,7
26,LR,1,100,5,-75.4,-68,-87,19
26,LR,1,100,7,-75.1428571428571,-68,-87,19
26,LR,1,100,10,-73.4,-68,-87,19
26,LR,1,100,9,-71.8888888888889,-68,-87,19
26,LR,1,100,4,-72.75,-68,-87,19
26,LR,1,100,6,-69.6666666666667,-68,-73,5
26,LR,0,100,1,-68,-68,-68,0
26,LR,1,100,6,-74.6666666666667,-68,-84,16
26,LR,1,100,3,-75,-68,-84,16
26,LR,1,100,10,-75.4,-67,-87,20
26,LR,0,100,1,-84,-84,-84,0
26,LR,1,100,5,-75.2,-67,-83,16
26,LR,1,100,10,-74.3,-67,-88,21
26,LR,0,100,2,-77.5,-72,-83,11
26,LR,1,100,5,-72.2,-67,-87,20
26,LR,0,100,1,-72,-72,-72,0
26,LR,1,100,3,-74,-67,-87,20
26,LR,1,100,10,-69.5,-65,-88,23
26,LR,0,100,2,-78,-68,-88,20
26,LR,1,100,6,-71,-65,-88,23
26,LR,1,100,6,-67.5,-65,-73,8
26,LR,1,100,6,-67.5,-65,-73,8
26,LR,1,100,10,-67.7,-65,-73,8
26,LR,1,100,4,-66.5,-65,-67,2
26,LR,1,100,10,-66.5,-63,-68,5
26,LR,1,100,8,-66.625,-63,-68,5
26,LR,1,100,10,-65.4,-61,-68,7
26,LR,0,100,2,-67,-67,-67,0
26,LR,1,100,10,-64.4,-61,-67,6
26,LR,1,100,10,-64.3,-61,-67,6
26,LR,1,100,10,-65.4,-61,-67,6
26,LR,1,100,9,-65.8888888888889,-62,-67,5
26,LR,1,100,8,-65.875,-62,-67,5
26,LR,1,100,5,-65.4,-62,-67,5
26,LR,0,100,1,-67,-67,-67,0
26,LR,1,100,6,-66,-64,-67,3
26,LR,1,100,7,-66.4285714285714,-64,-68,4
26,LR,1,100,4,-66.25,-64,-68,4
26,LR,0,100,1,-66,-66,-66,0
26,LR,1,100,8,-67.625,-64,-70,6
26,LR,1,100,7,-67,-63,-70,7
26,LR,0,100,2,-67,-64,-70,6
26,LR,0,100,2,-69,-68,-70,2
26,LR,0,100,1,-68,-68,-68,0
26,LR,1,100,6,-66.5,-63,-70,7
26,LR,1,100,4,-66.25,-63,-70,7
26,LR,1,100,9,-66.6666666666667,-63,-70,7
26,LR,0,100,2,-69.5,-69,-70,1
26,LR,1,100,3,-65.6666666666667,-63,-67,4
26,LR,1,100,6,-66.5,-63,-70,7
26,LR,1,100,6,-66.6666666666667,-63,-70,7
26,LR,1,100,3,-68.3333333333333,-67,-70,3
26,LR,1,100,3,-66.3333333333333,-64,-68,4
26,LR,1,100,6,-67.8333333333333,-64,-70,6
26,LR,1,100,6,-67.5,-64,-70,6
26,LR,0,100,1,-68,-68,-68,0
26,LR,1,100,5,-68.8,-66,-70,4
26,LR,1,100,7,-68.2857142857143,-64,-70,6
26,LR,0,100,1,-66,-66,-66,0
26,LR,1,100,3,-67.6666666666667,-64,-70,6
26,LR,1,100,7,-68,-64,-70,6
26,LR,1,100,8,-67.5,-63,-69,6
26,LR,1,100,8,-66.75,-63,-69,6
26,LR,1,100,5,-66.8,-63,-69,6
26,LR,1,100,9,-66.2222222222222,-63,-68,5
26,LR,1,100,3,-64.6666666666667,-63,-68,5
26,LR,1,100,4,-65.75,-63,-68,5
26,LR,1,100,10,-64.9,-61,-68,7
26,LR,1,100,10,-65.2,-61,-68,7
26,LR,0,100,2,-67,-67,-67,0
26,LR,1,100,7,-64.4285714285714,-61,-67,6
26,LR,1,100,3,-62,-61,-64,3
26,LR,1,100,9,-64.6666666666667,-61,-67,6
26,LR,0,100,2,-63.5,-61,-66,5
26,LR,1,100,8,-65.875,-64,-67,3
26,LR,1,100,7,-65.8571428571429,-64,-67,3
26,LR,1,100,7,-65.8571428571429,-64,-67,3
26,LR,1,100,9,-66.3333333333333,-64,-69,5
26,LR,0,100,1,-67,-67,-67,0
26,LR,1,100,5,-66.8,-65,-69,4
26,LR,1,100,8,-66.375,-63,-69,6
26,LR,1,100,10,-65.9,-63,-69,6
26,LR,1,100,5,-66.8,-64,-69,5
26,LR,0,100,1,-65,-65,-65,0
26,LR,1,100,10,-65.4,-63,-68,5
26,LR,1,100,7,-65.5714285714286,-64,-68,4
26,LR,1,100,6,-65.5,-64,-68,4
26,LR,0,100,2,-65,-64,-66,2
26,LR,1,100,8,-66.625,-64,-69,5
26,LR,1,100,6,-67.5,-64,-69,5
26,LR,1,100,6,-67.8333333333333,-64,-70,6
26,LR,1,100,7,-67.4285714285714,-64,-70,6
26,LR,1,100,5,-68.2,-64,-70,6
26,LR,1,100,4,-68,-64,-70,6
26,LR,1,100,5,-67.4,-64,-70,6
26,LR,1,100,6,-68.8333333333333,-64,-70,6
26,LR,1,100,9,-68,-64,-71,7
26,LR,1,100,4,-68.5,-64,-70,6
26,LR,1,100,8,-67.875,-64,-71,7
26,LR,1,100,3,-66.3333333333333,-64,-71,7
26,LR,1,100,8,-68.125,-64,-72,8
26,LR,1,100,5,-68,-64,-72,8
26,LR,0,100,2,-71,-70,-72,2
26,LR,1,100,4,-66.5,-63,-70,7
26,LR,1,100,7,-68.7142857142857,-63,-72,9
26,LR,1,100,6,-69.5,-63,-72,9
26,LR,1,100,3,-71.3333333333333,-70,-72,2
26,LR,1,100,8,-68.25,-63,-72,9
26,LR,1,100,7,-68,-63,-72,9
26,LR,0,100,1,-63,-63,-63,0
26,LR,0,100,2,-67,-67,-67,0
26,LR,1,100,5,-67.8,-67,-68,1
26,LR,1,100,10,-67.3,-66,-68,2
26,LR,1,100,6,-67.1666666666667,-66,-68,2
26,LR,1,100,7,-67,-66,-68,2
26,LR,0,100,2,-66,-66,-66,0
26,LR,1,100,8,-66.125,-64,-67,3
26,LR,1,100,8,-66.125,-64,-67,3
26,LR,1,100,3,-67,-67,-67,0
26,LR,1,100,5,-65.8,-64,-67,3
26,LR,1,100,3,-66,-64,-67,3
26,LR,1,100,10,-66.3,-64,-70,6
26,LR,0,100,1,-64,-64,-64,0
26,LR,1,100,4,-66.5,-64,-70,6
26,LR,0,100,2,-66,-66,-66,0
26,LR,1,100,6,-67,-64,-70,6
26,LR,1,100,3,-67.3333333333333,-66,-70,4
26,LR,0,100,2,-66,-66,-66,0
26,LR,1,100,3,-66.6666666666667,-64,-70,6
26,LR,0,100,1,-66,-66,-66,0
26,LR,0,100,1,-70,-70,-70,0
26,LR,1,100,10,-70.2,-66,-93,27
26,LR,1,100,4,-67.75,-66,-71,5
26,LR,1,100,6,-67.3333333333333,-66,-70,4
26,LR,0,100,1,-68,-68,-68,0
26,LR,0,100,1,-66,-66,-66,0
26,LR,1,100,3,-68,-66,-70,4
26,LR,1,100,10,-71.3,-66,-93,27
26,LR,1,100,4,-74.75,-68,-93,25
26,LR,0,100,1,-68,-68,-68,0
26,LR,1,100,9,-69.3333333333333,-66,-73,7
26,LR,1,100,5,-69,-67,-71,4
26,LR,1,100,5,-68.8,-66,-71,5
26,LR,1,100,10,-67.8,-65,-70,5
26,LR,0,100,2,-68.5,-68,-69,1
26,LR,1,100,8,-67.5,-65,-70,5
26,LR,1,100,3,-67,-66,-68,2
26,LR,1,100,8,-67.25,-65,-70,5
26,LR,1,100,3,-68,-65,-70,5
26,LR,1,100,8,-66.5,-64,-69,5
26,LR,1,100,4,-66.75,-65,-68,3
26,LR,1,100,8,-65.875,-64,-68,4
26,LR,1,100,7,-66,-64,-68,4
26,LR,1,100,9,-66.7777777777778,-64,-71,7
26,LR,1,100,9,-66.5555555555556,-64,-71,7
26,LR,1,100,8,-66.875,-66,-71,5
26,LR,1,100,4,-67.25,-66,-71,5
26,LR,0,100,1,-66,-66,-66,0
26,LR,1,100,3,-66.6666666666667,-66,-68,2
26,LR,1,100,10,-67.2,-65,-70,5
26,LR,0,100,2,-67.5,-66,-69,3
26,LR,1,100,10,-67.6,-65,-70,5
26,LR,0,100,1,-66,-66,-66,0
26,LR,1,100,7,-67.7142857142857,-65,-70,5
26,LR,1,100,3,-68,-65,-70,5
26,LR,1,100,3,-67.6666666666667,-65,-70,5
26,LR,1,100,10,-69.3,-64,-84,20
26,LR,1,100,3,-68.3333333333333,-68,-69,1
26,LR,1,100,3,-68,-67,-69,2
26,LR,1,100,6,-69.8333333333333,-64,-84,20
26,LR,1,100,6,-69.6666666666667,-64,-84,20
26,LR,0,100,1,-64,-64,-64,0
26,LR,0,100,1,-67,-67,-67,0
26,LR,1,100,10,-69.3,-65,-84,19
26,LR,1,100,8,-68.375,-65,-72,7
26,LR,1,100,9,-69.6666666666667,-65,-74,9
26,LR,1,100,8,-67.625,-65,-72,7
26,LR,1,100,8,-68.125,-65,-72,7
26,LR,1,100,7,-68.8571428571429,-66,-72,6
26,LR,1,100,4,-69.25,-65,-72,7
26,LR,0,100,1,-74,-74,-74,0
26,LR,1,100,7,-71.4285714285714,-65,-77,12
26,LR,1,100,9,-71.8888888888889,-65,-77,12
26,LR,1,100,5,-76,-72,-81,9
31,RL,1,150,10,-71.9,-64,-81,17
31,RL,1,150,5,-68.4,-64,-75,11
31,RL,1,150,9,-72.6666666666667,-67,-81,14
31,RL,1,150,8,-72.375,-67,-81,14
31,RL,1,150,9,-74.8888888888889,-67,-81,14
31,RL,1,150,3,-74.3333333333333,-71,-76,5
31,RL,1,150,8,-76.375,-71,-81,10
31,RL,0,150,2,-73.5,-72,-75,3
31,RL,0,150,1,-79,-79,-79,0
31,RL,1,150,3,-77.6666666666667,-75,-81,6
31,RL,1,150,10,-78.6,-68,-94,26
31,RL,0,150,1,-74,-74,-74,0
31,RL,1,150,9,-80.6666666666667,-68,-95,27
31,RL,1,150,9,-81.3333333333333,-70,-95,25
31,RL,1,150,4,-81.5,-74,-94,20
31,RL,1,150,4,-80,-74,-94,20
31,RL,1,150,5,-86.4,-76,-95,19
31,RL,1,150,9,-79.5555555555556,-71,-95,24
31,RL,1,150,7,-78.7142857142857,-71,-95,24
31,RL,1,150,9,-79.7777777777778,-71,-95,24
31,RL,0,150,2,-71.5,-71,-72,1
31,RL,1,150,7,-80,-72,-90,18
31,RL,1,150,4,-81.5,-76,-90,14
31,RL,1,150,3,-82.3333333333333,-76,-90,14
31,RL,1,150,5,-78.2,-73,-81,8
31,RL,1,150,10,-76.4,-72,-81,9
31,RL,1,150,8,-75.375,-72,-81,9
31,RL,0,150,2,-72.5,-72,-73,1
31,RL,1,150,10,-75.6,-72,-81,9
31,RL,1,150,8,-75.625,-72,-81,9
31,RL,1,150,9,-77,-72,-86,14
31,RL,0,150,1,-80,-80,-80,0
31,RL,1,150,5,-78.2,-72,-86,14
31,RL,1,150,3,-74.6666666666667,-72,-78,6
31,RL,1,150,9,-81.3333333333333,-73,-92,19
31,RL,1,150,5,-85.6,-78,-92,14
31,RL,1,150,10,-81.1,-73,-92,19
31,RL,1,150,10,-80.3,-73,-92,19
31,RL,1,150,4,-81.25,-73,-92,19
31,RL,1,150,5,-78.8,-73,-92,19
31,RL,1,150,10,-78.8,-73,-86,13
31,RL,1,150,3,-76,-73,-79,6
31,RL,1,150,8,-82.5,-76,-88,12
31,RL,1,150,4,-79.5,-76,-85,9
31,RL,1,150,8,-81.5,-76,-88,12
31,RL,0,150,1,-79,-79,-79,0
31,RL,1,150,7,-82.2857142857143,-76,-88,12
31,RL,1,150,5,-83.8,-79,-88,9
31,RL,1,150,6,-83.3333333333333,-79,-88,9
31,RL,1,150,9,-81.8888888888889,-78,-88,10
31,RL,1,150,10,-81.4,-78,-87,9
31,RL,1,150,5,-81.4,-78,-86,8
31,RL,1,150,7,-81.1428571428571,-78,-86,8
31,RL,1,150,7,-79.1428571428571,-75,-87,12
31,RL,1,150,6,-79.1666666666667,-75,-87,12
31,RL,1,150,5,-78.2,-75,-84,9
31,RL,1,150,10,-82.5,-75,-91,16
31,RL,1,150,10,-82.6,-76,-91,15
31,RL,1,150,3,-82.6666666666667,-77,-90,13
31,RL,1,150,8,-82.625,-76,-91,15
31,RL,1,150,3,-82,-77,-88,11
31,RL,1,150,10,-82.1,-76,-96,20
31,RL,1,150,8,-83.5,-76,-96,20
31,RL,1,150,6,-82.8333333333333,-76,-96,20
31,RL,1,150,7,-83.1428571428571,-76,-96,20
31,RL,0,150,2,-86.5,-77,-96,19
31,RL,1,150,9,-79.4444444444444,-75,-90,15
31,RL,1,150,6,-80.3333333333333,-75,-90,15
31,RL,1,150,9,-81.2222222222222,-75,-90,15
31,RL,0,150,2,-75.5,-75,-76,1
31,RL,0,150,1,-75,-75,-75,0
31,RL,0,150,2,-82.5,-75,-90,15
31,RL,1,150,3,-82,-78,-90,12
31,RL,1,150,6,-79.8333333333333,-77,-85,8
31,RL,1,150,9,-80.8888888888889,-75,-88,13
31,RL,0,150,1,-85,-85,-85,0
31,RL,1,150,3,-79.3333333333333,-77,-84,7
31,RL,1,150,6,-80.1666666666667,-75,-88,13
31,RL,1,150,6,-82.3333333333333,-75,-90,15
31,RL,1,150,10,-80.1,-75,-90,15
31,RL,1,150,3,-80.6666666666667,-75,-90,15
31,RL,1,150,4,-82.75,-77,-90,13
31,RL,1,150,7,-79.2857142857143,-75,-83,8
31,RL,1,150,3,-77.6666666666667,-75,-82,7
31,RL,1,150,5,-78.2,-75,-83,8
31,RL,1,150,4,-80.25,-78,-83,5
31,RL,1,150,7,-84.5714285714286,-78,-92,14
31,RL,1,150,7,-83.5714285714286,-76,-92,16
31,RL,1,150,8,-83.125,-75,-92,17
31,RL,1,150,3,-88.6666666666667,-86,-92,6
31,RL,1,150,5,-81.2,-75,-92,17
31,RL,0,150,2,-84,-76,-92,16
31,RL,1,150,5,-79.8,-75,-87,12
31,RL,1,150,10,-84.4,-75,-100,25
31,RL,1,150,3,-82.6666666666667,-75,-87,12
31,RL,1,150,5,-89,-75,-100,25
31,RL,1,150,7,-86.8571428571429,-75,-100,25
31,RL,1,150,5,-86.8,-75,-100,25
31,RL,1,150,4,-83.5,-75,-97,22
31,RL,1,150,6,-79.1666666666667,-74,-87,13
31,RL,1,150,10,-80.3,-74,-87,13
31,RL,1,150,10,-79.2,-74,-87,13
31,RL,0,150,2,-76,-76,-76,0
31,RL,1,150,7,-79,-74,-86,12
31,RL,1,150,9,-78.1111111111111,-74,-86,12
31,RL,1,150,9,-78.2222222222222,-74,-86,12
31,RL,1,150,5,-80.8,-74,-86,12
31,RL,1,150,3,-80.6666666666667,-74,-84,10
31,RL,0,150,2,-84,-84,-84,0
31,RL,1,150,3,-78.3333333333333,-75,-84,9
31,RL,1,150,8,-77.875,-75,-96,21
31,RL,1,150,4,-75,-75,-75,0
31,RL,0,150,2,-75,-75,-75,0
31,RL,1,150,3,-75.3333333333333,-75,-76,1
31,RL,1,150,6,-81.1666666666667,-75,-96,21
31,RL,1,150,10,-83.1,-75,-96,21
31,RL,1,150,5,-85.4,-75,-96,21
31,RL,0,150,1,-75,-75,-75,0
31,RL,1,150,7,-83.4285714285714,-75,-91,16
31,RL,1,150,4,-81,-75,-87,12
31,RL,1,150,8,-77.25,-75,-87,12
31,RL,1,150,4,-79.5,-75,-87,12
31,RL,1,150,10,-77.6,-75,-89,14
31,RL,1,150,5,-75.8,-75,-78,3
31,RL,0,150,2,-75,-75,-75,0
31,RL,1,150,10,-78.5,-75,-89,14
31,RL,1,150,9,-78.8888888888889,-75,-89,14
31,RL,1,150,7,-78.7142857142857,-75,-89,14
31,RL,0,150,1,-75,-75,-75,0
31,RL,1,150,8,-82.75,-76,-95,19
31,RL,1,150,8,-81.125,-76,-95,19
31,RL,1,150,5,-80.4,-77,-84,7
31,RL,0,150,2,-78,-77,-79,2
31,RL,1,150,3,-81.3333333333333,-77,-84,7
31,RL,1,150,4,-84.5,-76,-95,19
31,RL,1,150,3,-83.6666666666667,-76,-95,19
31,RL,1,150,3,-79,-76,-81,5
31,RL,0,150,1,-81,-81,-81,0
31,RL,0,150,1,-73,-73,-73,0
31,RL,0,150,1,-73,-73,-73,0
31,RL,1,150,10,-77.5,-70,-82,12
31,RL,1,150,7,-76,-70,-81,11
31,RL,1,150,7,-77.4285714285714,-72,-81,9
31,RL,1,150,7,-76.5714285714286,-72,-81,9
31,RL,1,150,6,-77.1666666666667,-72,-81,9
31,RL,1,150,3,-80.3333333333333,-80,-81,1
31,RL,1,150,7,-79.5714285714286,-74,-84,10
31,RL,1,150,4,-77.5,-74,-81,7
31,RL,1,150,3,-76.3333333333333,-74,-79,5
31,RL,0,150,1,-76,-76,-76,0
31,RL,1,150,10,-80.5,-72,-93,21
31,RL,1,150,8,-80.25,-72,-93,21
31,RL,1,150,5,-81.2,-72,-93,21
31,RL,1,150,5,-79.8,-72,-93,21
31,RL,1,150,9,-78.8888888888889,-72,-93,21
31,RL,1,150,7,-77.1428571428571,-72,-84,12
31,RL,0,150,1,-72,-72,-72,0
31,RL,1,150,10,-74.9,-71,-78,7
31,RL,1,150,5,-75,-72,-77,5
31,RL,1,150,4,-74.5,-72,-77,5
31,RL,1,150,10,-72.7,-70,-76,6
31,RL,1,150,5,-72.6,-71,-74,3
31,RL,1,150,8,-72.25,-70,-74,4
31,RL,1,150,4,-73,-71,-74,3
31,RL,1,150,8,-72.375,-70,-74,4
31,RL,0,150,2,-73.5,-73,-74,1
31,RL,1,150,3,-72.6666666666667,-70,-74,4
31,RL,1,150,7,-71.4285714285714,-69,-74,5
31,RL,1,150,3,-70,-70,-70,0
31,RL,1,150,5,-71.2,-69,-74,5
31,RL,1,150,7,-71.5714285714286,-69,-74,5
31,RL,0,150,1,-74,-74,-74,0
31,RL,1,150,7,-71.4285714285714,-69,-74,5
31,RL,1,150,5,-71.8,-69,-74,5
31,RL,1,150,10,-72.8,-72,-75,3
31,RL,1,150,7,-72.7142857142857,-72,-75,3
31,RL,1,150,6,-73.3333333333333,-72,-75,3
31,RL,0,150,1,-72,-72,-72,0
31,RL,1,150,10,-73.6,-72,-78,6
31,RL,1,150,4,-73.25,-72,-74,2
31,RL,1,150,4,-74.25,-72,-78,6
31,RL,1,150,9,-73.4444444444444,-72,-78,6
31,RL,1,150,6,-73.8333333333333,-72,-78,6
31,RL,0,150,1,-78,-78,-78,0
31,RL,1,150,10,-73.2,-72,-75,3
31,RL,0,150,2,-73.5,-72,-75,3
31,RL,1,150,4,-73.25,-72,-75,3
31,RL,1,150,10,-74.7,-72,-81,9
31,RL,1,150,10,-75.3,-72,-81,9
31,RL,1,150,5,-75,-73,-81,8
31,RL,1,150,9,-75.1111111111111,-72,-81,9
31,RL,1,150,3,-78,-73,-81,8
31,RL,1,150,5,-77,-72,-81,9
31,RL,1,150,4,-76,-72,-80,8
31,RL,0,150,2,-76,-73,-79,6
31,RL,1,150,3,-74.6666666666667,-72,-79,7
31,RL,0,150,1,-76,-76,-76,0
31,RL,1,150,10,-76,-72,-80,8
31,RL,0,150,2,-74.5,-73,-76,3
31,RL,1,150,4,-75,-72,-79,7
31,RL,0,150,1,-76,-76,-76,0
31,RL,1,150,6,-76.5,-72,-80,8
31,RL,1,150,4,-77.75,-76,-80,4
31,RL,1,150,7,-76.4285714285714,-72,-80,8
31,RL,1,150,8,-75.125,-72,-79,7
31,RL,1,150,9,-74.5555555555556,-72,-79,7
31,RL,0,150,2,-76,-76,-76,0
31,RL,0,150,1,-76,-76,-76,0
31,RL,1,150,10,-74.1,-72,-79,7
31,RL,1,150,10,-74.3,-72,-81,9
31,RL,1,150,4,-73,-72,-74,2
31,RL,1,150,8,-74.875,-72,-81,9
31,RL,0,150,1,-74,-74,-74,0
31,RL,1,150,9,-76.2222222222222,-72,-81,9
31,RL,1,150,8,-76.75,-74,-81,7
31,RL,1,150,7,-77.1428571428571,-74,-81,7
31,RL,1,150,6,-77.6666666666667,-74,-81,7
31,RL,1,150,7,-78.1428571428571,-76,-81,5
31,RL,1,150,6,-78.5,-76,-81,5
31,RL,1,150,6,-77,-72,-80,8
31,RL,0,150,1,-79,-79,-79,0
31,RL,1,150,4,-74.75,-72,-79,7
31,RL,1,150,8,-76.625,-72,-83,11
31,RL,1,150,5,-74.6,-72,-81,9
31,RL,1,150,8,-78.5,-72,-87,15
31,RL,0,150,2,-74,-74,-74,0
31,RL,1,150,6,-81.3333333333333,-76,-87,11
31,RL,1,150,8,-80.375,-76,-87,11
31,RL,1,150,6,-80.6666666666667,-76,-87,11
31,RL,1,150,6,-79.8333333333333,-76,-87,11
31,RL,0,150,1,-87,-87,-87,0
31,RL,1,150,10,-78.6,-74,-83,9
31,RL,1,150,3,-79.3333333333333,-78,-82,4
31,RL,1,150,7,-78.2857142857143,-74,-83,9
31,RL,1,150,8,-77.5,-74,-83,9
31,RL,0,150,1,-83,-83,-83,0
31,RL,1,150,6,-75.8333333333333,-74,-78,4
31,RL,1,150,8,-75.125,-74,-77,3
31,RL,1,150,6,-75.5,-74,-77,3
31,RL,0,150,2,-75,-74,-76,2
31,RL,1,150,4,-75.5,-74,-77,3
31,RL,1,150,6,-76.8333333333333,-74,-80,6
31,RL,1,150,4,-76,-74,-79,5
31,RL,1,150,7,-77.2857142857143,-74,-80,6
31,RL,1,150,10,-77.4,-73,-80,7
31,RL,1,150,10,-77.4,-73,-80,7
31,RL,1,150,8,-77.625,-73,-80,7
31,RL,1,150,6,-78,-75,-80,5
31,RL,0,150,1,-79,-79,-79,0
31,RL,1,150,7,-75.1428571428571,-71,-80,9
31,RL,1,150,9,-74.5555555555556,-70,-80,10
31,RL,0,150,2,-73.5,-73,-74,1
31,RL,1,150,10,-76,-70,-84,14
31,RL,1,150,9,-76.2222222222222,-70,-84,14
31,RL,1,150,3,-71,-70,-72,2
31,RL,1,150,6,-76.1666666666667,-70,-84,14
31,RL,1,150,7,-78.4285714285714,-70,-84,14
31,RL,1,150,3,-77,-76,-78,2
31,RL,0,150,2,-80,-76,-84,8
31,RL,1,150,7,-78.5714285714286,-73,-86,13
31,RL,1,150,7,-77.7142857142857,-73,-86,13
31,RL,1,150,4,-79.5,-73,-86,13
31,RL,1,150,9,-76.8888888888889,-73,-86,13
31,RL,1,150,7,-75.5714285714286,-73,-80,7
31,RL,1,150,3,-74.6666666666667,-73,-77,4
31,RL,1,150,10,-76.6,-74,-80,6
31,RL,0,150,2,-77.5,-77,-78,1
31,RL,0,150,1,-74,-74,-74,0
31,RL,1,150,5,-76.6,-76,-77,1
31,RL,1,150,10,-75.9,-74,-77,3
31,RL,1,150,6,-75.6666666666667,-74,-77,3
31,RL,1,150,7,-75.8571428571429,-74,-77,3
31,RL,1,150,3,-76,-75,-77,2
31,RL,1,150,9,-76.1111111111111,-74,-79,5
31,RL,0,150,2,-75,-74,-76,2
31,RL,1,150,7,-76.2857142857143,-74,-79,5
31,RL,0,150,2,-75,-75,-75,0
31,RL,1,150,8,-74.875,-72,-79,7
31,RL,1,150,5,-75.2,-72,-79,7
31,RL,1,150,8,-74.375,-72,-79,7
31,RL,1,150,6,-74,-73,-75,2
31,RL,1,150,7,-74.2857142857143,-73,-75,2
31,RL,1,150,3,-74.3333333333333,-74,-75,1
31,RL,0,150,1,-75,-75,-75,0
31,RL,1,150,10,-75.9,-73,-80,7
31,RL,0,150,2,-74,-73,-75,2
31,RL,1,150,9,-76.7777777777778,-73,-81,8
31,RL,1,150,7,-76.4285714285714,-73,-80,7
31,RL,1,150,10,-76.9,-73,-81,8
31,RL,1,150,6,-76.8333333333333,-73,-81,8
31,RL,1,150,9,-76.2222222222222,-72,-81,9
31,RL,1,150,4,-75.25,-73,-81,8
31,RL,1,150,7,-76.1428571428571,-72,-81,9
31,RL,1,150,7,-76.2857142857143,-72,-81,9
31,RL,0,150,2,-77,-74,-80,6
31,RL,1,150,10,-75,-72,-80,8
31,RL,1,150,5,-73.8,-72,-75,3
31,RL,1,150,9,-76.1111111111111,-73,-82,9
31,RL,1,150,4,-74,-73,-75,2
31,RL,1,150,10,-76.2,-73,-82,9
31,RL,1,150,7,-76.8571428571429,-73,-82,9
31,RL,1,150,6,-77.5,-75,-82,7
31,RL,0,150,2,-75,-75,-75,0
31,RL,1,150,7,-77,-74,-82,8
31,RL,0,150,2,-82,-82,-82,0
31,RL,1,150,9,-76.6666666666667,-74,-82,8
31,RL,1,150,6,-75.6666666666667,-74,-77,3
31,RL,1,150,8,-76,-74,-77,3
31,RL,1,150,8,-76.25,-74,-78,4
31,RL,1,150,7,-76.8571428571429,-76,-78,2
31,RL,1,150,6,-76.8333333333333,-76,-78,2
31,RL,0,150,1,-77,-77,-77,0
31,RL,1,150,6,-76.3333333333333,-76,-78,2
31,RL,1,150,3,-76.6666666666667,-76,-78,2
31,RL,1,150,5,-76.2,-76,-77,1
31,RL,1,150,5,-76,-75,-77,2
31,RL,1,150,7,-76.4285714285714,-75,-78,3
31,RL,1,150,4,-75.75,-75,-77,2
31,RL,1,150,5,-76.8,-75,-78,3
31,RL,1,150,8,-76.375,-75,-78,3
31,RL,1,150,10,-75.9,-72,-78,6
31,RL,1,150,8,-76.125,-73,-78,5
31,RL,1,150,8,-75.375,-72,-78,6
31,RL,0,150,2,-75.5,-75,-76,1
31,RL,1,150,9,-75.6666666666667,-72,-80,8
31,RL,1,150,10,-75.3,-72,-80,8
31,RL,1,150,9,-75,-72,-80,8
31,RL,1,150,9,-75.3333333333333,-72,-80,8
31,RL,1,150,10,-76.1,-73,-80,7
31,RL,1,150,4,-77,-74,-80,6
31,RL,1,150,9,-76.8888888888889,-74,-82,8
31,RL,0,150,2,-81,-80,-82,2
31,RL,1,150,9,-76.1111111111111,-73,-82,9
31,RL,1,150,5,-76.2,-74,-78,4
31,RL,1,150,10,-74.6,-72,-77,5
31,RL,1,150,7,-74.7142857142857,-72,-77,5
31,RL,0,150,2,-75.5,-74,-77,3
31,RL,1,150,10,-75.5,-72,-80,8
31,RL,1,150,5,-73.6,-72,-76,4
31,RL,1,150,7,-75.7142857142857,-72,-80,8
31,RL,1,150,6,-76.3333333333333,-73,-80,7
31,RL,1,150,8,-77.25,-73,-81,8
31,RL,1,150,8,-77.375,-74,-81,7
31,RL,1,150,7,-77.8571428571429,-74,-81,7
31,RL,1,150,6,-77.3333333333333,-74,-81,7
31,RL,1,150,3,-78.6666666666667,-74,-81,7
31,RL,1,150,5,-73,-70,-74,4
31,RL,0,150,1,-74,-74,-74,0
31,RL,1,150,10,-73.7,-70,-80,10
31,RL,1,150,9,-74.1111111111111,-70,-80,10
31,RL,1,150,9,-74,-70,-80,10
31,RL,1,150,10,-73.9,-70,-80,10
31,RL,1,150,4,-75,-72,-78,6
31,RL,1,150,5,-73.8,-70,-80,10
31,RL,1,150,3,-74,-70,-80,10
31,RL,1,150,9,-78.3333333333333,-72,-98,26
31,RL,1,150,8,-79.375,-72,-98,26
31,RL,1,150,5,-78.6,-72,-98,26
31,RL,1,150,3,-74,-72,-76,4
31,RL,1,150,7,-81.8571428571429,-72,-98,26
31,RL,1,150,4,-84.75,-76,-98,22
31,RL,1,150,9,-84.1111111111111,-77,-98,21
31,RL,1,150,8,-82.375,-77,-88,11
31,RL,1,150,7,-82.2857142857143,-77,-88,11
31,RL,1,150,9,-79.1111111111111,-70,-88,18
31,RL,0,150,1,-88,-88,-88,0
31,RL,0,150,1,-77,-77,-77,0
31,RL,1,150,10,-75.5,-69,-84,15
31,RL,0,150,1,-84,-84,-84,0
31,RL,1,150,4,-74.75,-70,-82,12
31,RL,1,150,7,-72.5714285714286,-69,-76,7
31,RL,1,150,10,-72.5,-69,-76,7
31,RL,1,150,3,-71,-69,-74,5
31,RL,1,150,6,-72.6666666666667,-70,-76,6
31,RL,1,150,4,-73.5,-72,-76,4
31,RL,1,150,5,-73.2,-72,-76,4
31,RL,1,150,9,-75.8888888888889,-72,-92,20
31,RL,1,150,10,-75.6,-71,-92,21
31,RL,1,150,4,-74.75,-72,-77,5
31,RL,1,150,9,-76.1111111111111,-71,-92,21
31,RL,0,150,1,-77,-77,-77,0
31,RL,0,150,1,-76,-76,-76,0
31,RL,1,150,9,-74.4444444444444,-69,-92,23
31,RL,1,150,9,-73.7777777777778,-69,-92,23
31,RL,1,150,7,-71.7142857142857,-69,-75,6
31,RL,1,150,4,-72,-69,-75,6
31,RL,0,150,1,-75,-75,-75,0
31,RL,1,150,4,-70,-69,-71,2
31,RL,1,150,10,-78.7,-69,-95,26
31,RL,1,150,5,-76,-70,-82,12
31,RL,1,150,10,-80.7,-70,-95,25
31,RL,1,150,3,-79,-73,-82,9
31,RL,1,150,3,-81,-79,-82,3
31,RL,0,150,2,-80.5,-79,-82,3
31,RL,1,150,6,-82.8333333333333,-70,-95,25
31,RL,1,150,3,-91.3333333333333,-86,-95,9
31,RL,1,150,6,-77.6666666666667,-69,-93,24
31,RL,1,150,7,-73.5714285714286,-69,-86,17
31,RL,1,150,6,-71.5,-69,-74,5
31,RL,1,150,9,-73.1111111111111,-69,-79,10
31,RL,1,150,10,-75,-69,-79,10
31,RL,1,150,8,-74.75,-69,-79,10
31,RL,1,150,8,-75.375,-69,-79,10
31,RL,1,150,10,-76.6,-71,-79,8
31,RL,1,150,3,-73.3333333333333,-71,-75,4
31,RL,1,150,7,-76.7142857142857,-74,-78,4
31,RL,0,150,1,-78,-78,-78,0
31,RL,1,150,10,-76,-70,-78,8
31,RL,1,150,7,-75.1428571428571,-70,-78,8
31,RL,1,150,8,-75.5,-70,-78,8
31,RL,1,150,10,-73.3,-67,-78,11
31,RL,1,150,9,-72.8888888888889,-67,-78,11
31,RL,1,150,7,-72.5714285714286,-67,-78,11
31,RL,1,150,6,-72.3333333333333,-67,-78,11
31,RL,0,150,1,-67,-67,-67,0
31,RL,1,150,10,-72.3,-69,-77,8
31,RL,0,150,2,-72,-72,-72,0
31,RL,1,150,5,-70.8,-69,-72,3
31,RL,1,150,3,-71.6666666666667,-71,-72,1
31,RL,1,150,8,-73.875,-69,-77,8
31,RL,1,150,6,-74.1666666666667,-69,-77,8
31,RL,1,150,7,-74,-69,-77,8
31,RL,1,150,8,-74.5,-71,-77,6
31,RL,1,150,4,-75.5,-74,-77,3
31,RL,0,150,2,-75.5,-74,-77,3
31,RL,0,150,1,-74,-74,-74,0
31,RL,1,150,8,-71.5,-69,-76,7
31,RL,1,150,6,-71.5,-69,-76,7
31,RL,1,150,8,-71.125,-69,-76,7
31,RL,1,150,9,-71.5555555555556,-69,-76,7
31,RL,0,150,1,-69,-69,-69,0
31,RL,0,150,1,-71,-71,-71,0
31,RL,1,150,7,-74.5714285714286,-72,-78,6
31,RL,1,150,4,-73.5,-72,-76,4
31,RL,1,150,8,-72,-68,-78,10
31,RL,1,150,7,-71.1428571428571,-68,-76,8
31,RL,0,150,2,-72,-72,-72,0
31,RL,0,150,1,-72,-72,-72,0
31,RL,0,150,2,-68.5,-68,-69,1
31,RL,1,150,9,-70.3333333333333,-69,-72,3
31,RL,1,150,3,-70.6666666666667,-69,-72,3
31,RL,1,150,10,-72.2,-70,-83,13
31,RL,1,150,8,-72.375,-70,-83,13
31,RL,1,150,9,-71.8888888888889,-69,-83,14
31,RL,1,150,3,-75.3333333333333,-71,-83,12
31,RL,1,150,10,-71.5,-68,-83,15
31,RL,0,150,2,-77.5,-72,-83,11
31,RL,1,150,3,-69.6666666666667,-69,-71,2
31,RL,1,150,5,-69.4,-68,-71,3
31,RL,1,150,10,-71.7,-68,-76,8
31,RL,1,150,5,-70.2,-68,-76,8
31,RL,1,150,7,-72.2857142857143,-68,-76,8
31,RL,0,150,1,-70,-70,-70,0
31,RL,1,150,6,-73.5,-69,-76,7
31,RL,1,150,3,-74.3333333333333,-71,-76,5
31,RL,1,150,5,-72.4,-70,-76,6
31,RL,1,150,5,-71.4,-70,-73,3
31,RL,1,150,5,-70.8,-70,-72,2
31,RL,1,150,8,-70.75,-69,-77,8
31,RL,0,150,1,-70,-70,-70,0
31,RL,1,150,6,-71,-69,-77,8
31,RL,1,150,7,-70.4285714285714,-69,-77,8
31,RL,1,150,7,-70.4285714285714,-69,-77,8
31,RL,1,150,6,-70.6666666666667,-69,-77,8
31,RL,1,150,9,-72.4444444444444,-69,-77,8
31,RL,1,150,4,-71.5,-69,-77,8
31,RL,1,150,4,-69.75,-69,-70,1
31,RL,0,150,2,-70,-70,-70,0
31,RL,1,150,10,-73,-70,-77,7
31,RL,1,150,10,-73.5,-70,-77,7
31,RL,1,150,5,-74.2,-72,-77,5
31,RL,1,150,3,-74,-72,-76,4
31,RL,1,150,9,-72.8888888888889,-71,-75,4
31,RL,1,150,5,-73.2,-72,-75,3
31,RL,1,150,8,-73.125,-71,-75,4
31,RL,1,150,5,-73.2,-72,-75,3
31,RL,1,150,7,-73,-71,-75,4
31,RL,1,150,6,-72.3333333333333,-70,-75,5
31,RL,1,150,8,-72.25,-70,-75,5
31,RL,1,150,9,-72.6666666666667,-70,-75,5
31,RL,1,150,6,-72,-70,-75,5
31,RL,0,150,2,-73,-71,-75,4
31,RL,0,150,1,-71,-71,-71,0
31,RL,1,150,9,-73.7777777777778,-71,-81,10
31,RL,1,150,7,-73,-71,-75,4
31,RL,1,150,7,-74.1428571428571,-71,-81,10
31,RL,0,150,1,-74,-74,-74,0
31,RL,1,150,5,-76.6,-71,-84,13
31,RL,1,150,4,-78,-72,-84,12
31,RL,1,150,3,-79,-72,-84,12
31,RL,0,150,1,-81,-81,-81,0
31,RL,1,150,9,-74.7777777777778,-70,-86,16
31,RL,1,150,4,-76,-72,-86,14
31,RL,1,150,3,-72.6666666666667,-72,-74,2
31,RL,0,150,1,-72,-72,-72,0
31,RL,1,150,5,-71.8,-70,-74,4
31,RL,1,150,5,-71,-70,-72,2
31,RL,1,150,10,-74.6,-70,-88,18
31,RL,1,150,9,-75.7777777777778,-70,-88,18
31,RL,0,150,1,-72,-72,-72,0
31,RL,1,150,8,-76.875,-72,-88,16
31,RL,0,150,2,-82,-76,-88,12
31,RL,0,150,2,-83.5,-79,-88,9
31,RL,1,150,10,-74.3,-69,-81,12
31,RL,1,150,6,-74.6666666666667,-71,-81,10
31,RL,0,150,2,-76,-75,-77,2
31,RL,1,150,4,-73.25,-69,-81,12
31,RL,1,150,3,-73.6666666666667,-69,-81,12
31,RL,1,150,4,-74.25,-69,-81,12
31,RL,1,150,4,-72.25,-69,-77,8
31,RL,1,150,8,-74.875,-71,-79,8
31,RL,1,150,5,-74.6,-71,-79,8
31,RL,1,150,9,-75.6666666666667,-71,-79,8
31,RL,1,150,6,-74.6666666666667,-71,-78,7
31,RL,1,150,9,-74.8888888888889,-71,-78,7
31,RL,1,150,3,-75.6666666666667,-74,-78,4
31,RL,1,150,3,-76,-74,-78,4
31,RL,0,150,1,-78,-78,-78,0
31,RL,1,150,7,-75.8571428571429,-72,-80,8
31,RL,1,150,5,-75,-72,-78,6
31,RL,1,150,9,-75.1111111111111,-70,-80,10
31,RL,0,150,2,-73.5,-72,-75,3
31,RL,0,150,1,-75,-75,-75,0
31,RL,1,150,4,-77.25,-74,-80,6
31,RL,1,150,10,-72.9,-70,-78,8
31,RL,1,150,5,-72.6,-70,-78,8
31,RL,1,150,8,-73.25,-70,-78,8
31,RL,0,150,1,-74,-74,-74,0
31,RL,1,150,9,-74.5555555555556,-71,-82,11
31,RL,1,150,8,-75,-71,-82,11
31,RL,1,150,8,-75.25,-71,-82,11
31,RL,1,150,6,-75.6666666666667,-71,-82,11
31,RL,1,150,8,-75.625,-71,-85,14
31,RL,1,150,8,-76.875,-71,-85,14
31,RL,1,150,8,-78.25,-71,-85,14
31,RL,1,150,9,-79.1111111111111,-71,-85,14
31,RL,0,150,1,-71,-71,-71,0
31,RL,1,150,9,-75.8888888888889,-71,-82,11
31,RL,0,150,2,-81,-81,-81,0
31,RL,1,150,9,-75.6666666666667,-71,-81,10
31,RL,0,150,1,-74,-74,-74,0
31,RL,1,150,5,-73,-71,-75,4
31,RL,1,150,4,-72.75,-71,-75,4
31,RL,1,150,5,-75.8,-71,-81,10
31,RL,0,150,1,-71,-71,-71,0
31,RL,1,150,5,-75.6,-70,-81,11
31,RL,1,150,5,-74.6,-70,-81,11
31,RL,1,150,8,-77,-70,-85,15
31,RL,1,150,5,-75,-70,-84,14
31,RL,1,150,7,-77.8571428571429,-70,-85,15
31,RL,1,150,6,-79.1666666666667,-70,-85,15
31,RL,0,150,1,-84,-84,-84,0
31,RL,1,150,5,-80.6,-75,-85,10
31,RL,1,150,10,-78.8,-72,-95,23
31,RL,1,150,7,-81,-72,-95,23
31,RL,1,150,9,-78,-72,-95,23
31,RL,1,150,9,-76.1111111111111,-72,-88,16
31,RL,1,150,7,-75,-72,-77,5
31,RL,1,150,3,-73.3333333333333,-72,-74,2
31,RL,1,150,8,-76.375,-72,-88,16
31,RL,1,150,4,-79,-74,-88,14
31,RL,1,150,8,-76.875,-72,-88,16
31,RL,1,150,8,-76.75,-72,-88,16
31,RL,1,150,5,-77.6,-72,-88,16
31,RL,1,150,10,-73.7,-70,-79,9
31,RL,1,150,5,-73.6,-70,-79,9
31,RL,1,150,5,-71.8,-70,-76,6
31,RL,1,150,5,-71.4,-70,-74,4
31,RL,0,150,2,-70,-70,-70,0
31,RL,1,150,3,-72.3333333333333,-70,-74,4
31,RL,1,150,3,-74.3333333333333,-73,-76,3
31,RL,0,150,1,-76,-76,-76,0
31,RL,0,150,2,-74.5,-72,-77,5
31,RL,0,150,2,-73,-72,-74,2
31,RL,0,150,1,-74,-74,-74,0
31,RL,1,150,3,-72,-70,-74,4
31,RL,0,150,1,-70,-70,-70,0
31,RL,1,150,8,-74.5,-72,-79,7
31,RL,0,150,2,-74,-72,-76,4
31,RL,1,150,9,-74.3333333333333,-71,-79,8
31,RL,1,150,3,-75.6666666666667,-73,-79,6
31,RL,1,150,5,-74.6,-73,-79,6
31,RL,1,150,8,-75.125,-71,-79,8
31,RL,1,150,8,-75.5,-71,-82,11
31,RL,1,150,3,-72.3333333333333,-71,-73,2
31,RL,1,150,7,-76,-71,-82,11
31,RL,1,150,6,-76.5,-71,-82,11
31,RL,1,150,9,-75.1111111111111,-69,-82,13
31,RL,1,150,5,-75.6,-72,-82,10
31,RL,1,150,9,-73.5555555555556,-69,-82,13
31,RL,1,150,5,-72.4,-69,-75,6
31,RL,1,150,9,-72.5555555555556,-69,-75,6
31,RL,0,150,2,-73.5,-72,-75,3
31,RL,1,150,7,-73.5714285714286,-69,-81,12
31,RL,1,150,8,-74.25,-72,-81,9
31,RL,1,150,7,-74.5714285714286,-72,-81,9
31,RL,1,150,5,-75.2,-72,-81,9
31,RL,1,150,7,-74.8571428571429,-72,-81,9
31,RL,1,150,5,-75.6,-72,-81,9
31,RL,1,150,7,-74.8571428571429,-72,-81,9
31,RL,1,150,3,-75,-73,-76,3
31,RL,1,150,5,-75.2,-73,-81,8
31,RL,1,150,10,-77.9,-72,-87,15
31,RL,0,150,2,-81,-81,-81,0
31,RL,0,150,1,-81,-81,-81,0
31,RL,1,150,7,-78.1428571428571,-72,-87,15
31,RL,0,150,2,-77,-77,-77,0
31,RL,1,150,5,-79.6,-76,-87,11
31,RL,1,150,6,-77,-72,-87,15
31,RL,1,150,6,-75.8333333333333,-72,-87,15
31,RL,1,150,8,-74.25,-72,-77,5
31,RL,1,150,9,-73.7777777777778,-72,-77,5
31,RL,1,150,5,-74,-72,-77,5
31,RL,1,150,9,-73.6666666666667,-72,-77,5
31,RL,0,150,2,-77,-77,-77,0
31,RL,1,150,7,-72.8571428571429,-72,-74,2
31,RL,1,150,10,-73.1,-72,-74,2
31,RL,0,150,1,-73,-73,-73,0
31,RL,1,150,7,-73.1428571428571,-73,-74,1
31,RL,0,150,1,-73,-73,-73,0
31,RL,0,150,2,-73.5,-73,-74,1
31,RL,1,150,9,-77.4444444444444,-73,-86,13
31,RL,1,150,3,-73,-73,-73,0
31,RL,1,150,8,-77.625,-71,-86,15
31,RL,1,150,8,-79,-71,-86,15
31,RL,1,150,10,-78.4,-71,-86,15
31,RL,1,150,8,-78,-71,-85,14
31,RL,1,150,5,-77,-72,-84,12
31,RL,1,150,7,-80.1428571428571,-73,-85,12
31,RL,1,150,4,-79.25,-73,-85,12
31,RL,0,150,1,-80,-80,-80,0
31,RL,1,150,4,-74.25,-72,-79,7
31,RL,1,150,10,-73.7,-72,-79,7
31,RL,1,150,3,-74.6666666666667,-72,-79,7
31,RL,1,150,6,-74.1666666666667,-72,-79,7
31,RL,1,150,10,-74,-72,-79,7
31,RL,1,150,3,-73,-72,-75,3
31,RL,1,150,7,-73.8571428571429,-72,-76,4
31,RL,0,150,1,-75,-75,-75,0
31,RL,1,150,7,-73.7142857142857,-72,-77,5
31,RL,1,150,9,-74,-72,-77,5
31,RL,0,150,2,-74.5,-73,-76,3
31,RL,1,150,8,-73.875,-71,-77,6
31,RL,1,150,10,-74,-71,-77,6
31,RL,1,150,9,-73.4444444444444,-71,-76,5
31,RL,1,150,5,-72.6,-71,-74,3
31,RL,0,150,1,-71,-71,-71,0
31,RL,1,150,3,-72.6666666666667,-71,-74,3
31,RL,1,150,5,-74.2,-73,-76,3
31,RL,1,150,3,-74.6666666666667,-74,-76,2
31,RL,1,150,9,-74.1111111111111,-72,-78,6
31,RL,1,150,9,-73.6666666666667,-72,-78,6
31,RL,1,150,5,-73.2,-72,-77,5
31,RL,1,150,3,-72,-72,-72,0
31,RL,0,150,2,-72,-72,-72,0
31,RL,1,150,5,-73.6,-72,-78,6
31,RL,1,150,10,-76.4,-72,-89,17
31,RL,1,150,8,-75.75,-72,-89,17
31,RL,1,150,10,-76,-72,-89,17
31,RL,0,150,1,-72,-72,-72,0
31,RL,1,150,6,-78,-72,-89,17
31,RL,1,150,7,-79.5714285714286,-73,-89,16
31,RL,1,150,10,-81.6,-73,-89,16
31,RL,1,150,4,-78.25,-73,-85,12
31,RL,1,150,10,-78.7,-72,-87,15
31,RL,1,150,7,-81.1428571428571,-73,-87,14
31,RL,0,150,2,-81.5,-81,-82,1
31,RL,0,150,2,-82,-82,-82,0
31,RL,1,150,3,-83.3333333333333,-79,-87,8
31,RL,1,150,9,-78.1111111111111,-72,-87,15
31,RL,1,150,3,-77.3333333333333,-72,-87,15
31,RL,1,150,9,-76.6666666666667,-72,-81,9
31,RL,0,150,1,-72,-72,-72,0
31,RL,1,150,7,-80.2857142857143,-74,-96,22
31,RL,1,150,7,-81.7142857142857,-74,-96,22
31,RL,1,150,9,-81.4444444444444,-74,-96,22
31,RL,1,150,7,-82.8571428571429,-74,-96,22
31,RL,1,150,7,-82.1428571428571,-74,-96,22
31,RL,1,150,6,-83.5,-76,-96,20
31,RL,0,150,1,-89,-89,-89,0
31,RL,1,150,6,-74.8333333333333,-66,-86,20
31,RL,0,150,1,-76,-76,-76,0
31,RL,1,150,6,-73.6666666666667,-66,-86,20
31,RL,1,150,7,-71.7142857142857,-66,-81,15
31,RL,1,150,10,-72.2,-66,-81,15
31,RL,0,150,2,-66,-66,-66,0
31,RL,1,150,6,-74,-66,-81,15
31,RL,0,150,2,-77,-73,-81,8
31,RL,1,150,8,-73.5,-66,-86,20
31,RL,1,150,8,-72,-66,-81,15
31,RL,1,150,8,-72.125,-66,-81,15
31,RL,1,150,6,-73.6666666666667,-69,-77,8
31,RL,1,150,5,-75.2,-69,-80,11
31,RL,1,150,9,-74.3333333333333,-66,-81,15
31,LR,1,150,4,-77,-73,-86,13
31,LR,1,150,7,-73.5714285714286,-71,-75,4
31,LR,1,150,4,-73,-71,-74,3
31,LR,1,150,4,-73.25,-71,-75,4
31,LR,0,150,1,-74,-74,-74,0
31,LR,1,150,6,-74.1666666666667,-73,-76,3
31,LR,1,150,7,-74.5714285714286,-73,-76,3
31,LR,1,150,4,-74.25,-73,-76,3
31,LR,1,150,6,-74.3333333333333,-73,-76,3
31,LR,1,150,5,-74.6,-73,-76,3
31,LR,0,150,2,-75,-74,-76,2
31,LR,1,150,4,-75,-74,-76,2
31,LR,1,150,10,-74.5,-72,-76,4
31,LR,0,150,2,-75,-74,-76,2
31,LR,1,150,10,-74.1,-72,-76,4
31,LR,1,150,4,-74.75,-74,-76,2
31,LR,0,150,1,-74,-74,-74,0
31,LR,1,150,6,-75.3333333333333,-72,-84,12
31,LR,0,150,1,-73,-73,-73,0
31,LR,1,150,9,-75.3333333333333,-72,-84,12
31,LR,1,150,5,-75.6,-72,-84,12
31,LR,1,150,7,-76,-72,-84,12
31,LR,1,150,3,-76.6666666666667,-72,-84,12
31,LR,1,150,9,-75.1111111111111,-72,-80,8
31,LR,1,150,9,-76.3333333333333,-72,-85,13
31,LR,0,150,2,-77,-74,-80,6
31,LR,0,150,2,-74,-74,-74,0
31,LR,1,150,3,-76,-74,-80,6
31,LR,1,150,8,-76.25,-74,-85,11
31,LR,1,150,3,-77.6666666666667,-74,-85,11
31,LR,1,150,4,-76.75,-74,-85,11
31,LR,1,150,7,-77.1428571428571,-74,-85,11
31,LR,1,150,6,-75.8333333333333,-74,-81,7
31,LR,1,150,3,-76.3333333333333,-74,-81,7
31,LR,1,150,3,-77.3333333333333,-74,-81,7
31,LR,1,150,9,-75.7777777777778,-73,-81,8
31,LR,1,150,10,-76.1,-73,-81,8
31,LR,0,150,1,-75,-75,-75,0
31,LR,1,150,3,-74,-73,-75,2
31,LR,0,150,1,-75,-75,-75,0
31,LR,1,150,5,-77.4,-74,-81,7
31,LR,0,150,1,-79,-79,-79,0
31,LR,0,150,1,-74,-74,-74,0
31,LR,1,150,6,-77.5,-74,-79,5
31,LR,1,150,5,-77.4,-74,-79,5
31,LR,1,150,3,-77,-74,-79,5
31,LR,1,150,4,-76.25,-74,-79,5
31,LR,1,150,7,-76,-74,-79,5
31,LR,1,150,3,-75,-74,-76,2
31,LR,1,150,3,-75.6666666666667,-75,-76,1
31,LR,1,150,7,-77.8571428571429,-74,-81,7
31,LR,1,150,9,-77.7777777777778,-74,-81,7
31,LR,0,150,2,-81,-81,-81,0
31,LR,1,150,5,-77.6,-76,-80,4
31,LR,1,150,8,-78.625,-76,-85,9
31,LR,1,150,6,-78.6666666666667,-76,-85,9
31,LR,1,150,9,-77.6666666666667,-74,-85,11
31,LR,1,150,9,-76.4444444444444,-74,-79,5
31,LR,1,150,7,-76.4285714285714,-74,-79,5
31,LR,1,150,4,-75.75,-74,-79,5
31,LR,1,150,5,-75.8,-74,-79,5
31,LR,1,150,5,-77.4,-75,-82,7
31,LR,1,150,6,-76.1666666666667,-74,-82,8
31,LR,1,150,3,-77.6666666666667,-75,-82,7
31,LR,0,150,2,-79,-76,-82,6
31,LR,1,150,10,-76.5,-73,-85,12
31,LR,1,150,10,-75.4,-73,-85,12
31,LR,1,150,10,-75.5,-73,-85,12
31,LR,1,150,6,-76.6666666666667,-73,-85,12
31,LR,1,150,9,-76.2222222222222,-73,-85,12
31,LR,1,150,7,-76.1428571428571,-73,-85,12
31,LR,1,150,5,-77,-73,-85,12
31,LR,1,150,4,-75.5,-73,-81,8
31,LR,0,150,1,-73,-73,-73,0
31,LR,1,150,8,-76.375,-73,-79,6
31,LR,1,150,10,-76.7,-73,-82,9
31,LR,1,150,10,-76.8,-73,-82,9
31,LR,0,150,1,-77,-77,-77,0
31,LR,1,150,4,-76.5,-73,-79,6
31,LR,1,150,3,-75.6666666666667,-73,-78,5
31,LR,0,150,1,-82,-82,-82,0
31,LR,0,150,1,-74,-74,-74,0
31,LR,0,150,1,-76,-76,-76,0
31,LR,1,150,3,-78,-74,-84,10
31,LR,1,150,9,-75.7777777777778,-72,-84,12
31,LR,0,150,2,-79,-77,-81,4
31,LR,0,150,1,-76,-76,-76,0
31,LR,0,150,1,-73,-73,-73,0
31,LR,1,150,7,-73.4285714285714,-72,-77,5
31,LR,1,150,5,-73.6,-72,-77,5
31,LR,1,150,8,-73.375,-67,-77,10
31,LR,1,150,4,-74,-72,-77,5
31,LR,1,150,7,-72.5714285714286,-67,-77,10
31,LR,1,150,7,-72.4285714285714,-67,-77,10
31,LR,1,150,10,-73.9,-70,-79,9
31,LR,1,150,10,-73.8,-70,-79,9
31,LR,1,150,10,-73.1,-70,-79,9
31,LR,1,150,10,-72.7,-69,-79,10
31,LR,1,150,8,-73,-70,-79,9
31,LR,1,150,7,-73.2857142857143,-70,-79,9
31,LR,1,150,5,-72.8,-70,-77,7
31,LR,1,150,7,-71.8571428571429,-69,-77,8
31,LR,0,150,1,-72,-72,-72,0
31,LR,1,150,7,-71.4285714285714,-69,-77,8
31,LR,1,150,10,-70.9,-68,-77,9
31,LR,1,150,4,-71.5,-69,-77,8
31,LR,1,150,8,-71.25,-68,-77,9
31,LR,1,150,3,-70,-70,-70,0
31,LR,0,150,1,-71,-71,-71,0
31,LR,1,150,10,-72.1,-70,-74,4
31,LR,1,150,10,-71.8,-70,-73,3
31,LR,0,150,1,-72,-72,-72,0
31,LR,1,150,5,-72.2,-71,-73,2
31,LR,0,150,2,-71,-71,-71,0
31,LR,1,150,7,-72.5714285714286,-71,-76,5
31,LR,1,150,8,-73.125,-71,-76,5
31,LR,0,150,2,-72,-72,-72,0
31,LR,0,150,1,-72,-72,-72,0
31,LR,1,150,3,-73.3333333333333,-71,-76,5
31,LR,1,150,9,-73.4444444444444,-70,-76,6
31,LR,1,150,10,-73.1,-70,-76,6
31,LR,1,150,3,-73.6666666666667,-70,-76,6
31,LR,0,150,1,-76,-76,-76,0
31,LR,1,150,3,-72.6666666666667,-70,-75,5
31,LR,1,150,5,-73.4,-70,-76,6
31,LR,1,150,4,-73,-70,-76,6
31,LR,1,150,6,-73.3333333333333,-70,-76,6
31,LR,1,150,6,-74,-72,-76,4
31,LR,1,150,8,-73.25,-71,-76,5
31,LR,1,150,6,-72.1666666666667,-71,-74,3
31,LR,1,150,3,-71.6666666666667,-71,-73,2
31,LR,1,150,8,-71.25,-70,-72,2
31,LR,1,150,3,-71.3333333333333,-70,-72,2
31,LR,1,150,6,-71.1666666666667,-70,-72,2
31,LR,0,150,1,-72,-72,-72,0
31,LR,1,150,4,-71.25,-71,-72,1
31,LR,1,150,5,-70.8,-70,-71,1
31,LR,1,150,5,-71.6,-70,-75,5
31,LR,1,150,4,-71.75,-70,-75,5
31,LR,1,150,3,-72,-70,-75,5
31,LR,1,150,9,-72.5555555555556,-70,-75,5
31,LR,1,150,9,-73,-70,-75,5
31,LR,1,150,10,-73.3,-70,-76,6
31,LR,1,150,3,-71.3333333333333,-70,-73,3
31,LR,1,150,5,-73.2,-70,-75,5
31,LR,1,150,10,-73.4,-69,-76,7
31,LR,1,150,5,-74.6,-74,-76,2
31,LR,1,150,5,-74.4,-73,-76,3
31,LR,1,150,10,-73.4,-69,-77,8
31,LR,1,150,8,-72.875,-69,-77,8
31,LR,1,150,10,-73.2,-69,-78,9
31,LR,1,150,7,-72.7142857142857,-69,-77,8
31,LR,1,150,8,-73,-69,-78,9
31,LR,1,150,4,-72.5,-69,-77,8
31,LR,1,150,8,-73.75,-69,-79,10
31,LR,0,150,2,-73.5,-70,-77,7
31,LR,1,150,10,-73.1,-68,-79,11
31,LR,1,150,8,-72.75,-68,-79,11
31,LR,1,150,5,-73.4,-70,-79,9
31,LR,1,150,8,-71.125,-68,-79,11
31,LR,0,150,2,-74.5,-70,-79,9
31,LR,1,150,5,-70.4,-68,-72,4
31,LR,0,150,2,-71,-70,-72,2
31,LR,1,150,8,-74.5,-70,-79,9
31,LR,1,150,6,-74.8333333333333,-70,-79,9
31,LR,0,150,1,-72,-72,-72,0
31,LR,1,150,8,-75.625,-73,-79,6
31,LR,1,150,3,-76,-73,-78,5
31,LR,0,150,2,-75,-73,-77,4
31,LR,1,150,5,-75,-73,-77,4
31,LR,1,150,4,-74.5,-73,-77,4
31,LR,1,150,4,-74,-73,-77,4
31,LR,1,150,3,-72.6666666666667,-72,-73,1
31,LR,1,150,8,-74.75,-71,-80,9
31,LR,1,150,3,-74.3333333333333,-72,-79,7
31,LR,1,150,10,-73.8,-71,-80,9
31,LR,1,150,8,-74.25,-71,-80,9
31,LR,0,150,1,-72,-72,-72,0
31,LR,1,150,4,-75.25,-71,-80,9
31,LR,0,150,1,-71,-71,-71,0
31,LR,1,150,3,-74,-71,-80,9
31,LR,1,150,3,-71,-71,-71,0
31,LR,1,150,4,-73.5,-71,-80,9
31,LR,1,150,10,-74.6,-70,-80,10
31,LR,1,150,7,-73.8571428571429,-70,-79,9
31,LR,1,150,8,-73.625,-70,-77,7
31,LR,1,150,6,-73.1666666666667,-70,-77,7
31,LR,1,150,3,-71,-70,-72,2
31,LR,1,150,5,-73,-71,-77,6
31,LR,0,150,1,-71,-71,-71,0
31,LR,1,150,6,-74,-71,-78,7
31,LR,1,150,5,-74,-71,-78,7
31,LR,0,150,1,-71,-71,-71,0
31,LR,1,150,7,-73.1428571428571,-71,-78,7
31,LR,1,150,4,-72.75,-71,-77,6
31,LR,0,150,1,-71,-71,-71,0
31,LR,1,150,6,-74.3333333333333,-71,-77,6
31,LR,1,150,5,-73.8,-71,-77,6
31,LR,1,150,7,-74.1428571428571,-71,-77,6
31,LR,1,150,9,-73.6666666666667,-70,-77,7
31,LR,1,150,10,-73,-68,-77,9
31,LR,1,150,10,-74.3,-68,-92,24
31,LR,1,150,10,-74.1,-68,-92,24
31,LR,1,150,4,-73.25,-70,-77,7
31,LR,1,150,8,-74.5,-68,-92,24
31,LR,1,150,7,-74.4285714285714,-68,-92,24
31,LR,1,150,8,-75.25,-68,-92,24
31,LR,1,150,6,-74.8333333333333,-68,-92,24
31,LR,0,150,1,-92,-92,-92,0
31,LR,1,150,7,-72.8571428571429,-70,-76,6
31,LR,1,150,3,-74.3333333333333,-71,-76,5
31,LR,1,150,8,-74.125,-70,-85,15
31,LR,0,150,2,-72.5,-71,-74,3
31,LR,1,150,3,-72,-70,-74,4
31,LR,0,150,1,-70,-70,-70,0
31,LR,1,150,7,-75.7142857142857,-70,-85,15
31,LR,1,150,6,-76.3333333333333,-70,-85,15
31,LR,1,150,6,-77.5,-70,-85,15
31,LR,1,150,6,-75.1666666666667,-70,-80,10
31,LR,1,150,4,-75,-70,-80,10
31,LR,1,150,9,-73.6666666666667,-70,-80,10
31,LR,1,150,6,-73.5,-70,-79,9
31,LR,1,150,10,-73.7,-70,-80,10
31,LR,1,150,3,-76,-72,-79,7
31,LR,1,150,6,-74.3333333333333,-71,-80,9
31,LR,1,150,4,-73.75,-71,-80,9
31,LR,0,150,1,-80,-80,-80,0
31,LR,1,150,3,-71.6666666666667,-71,-73,2
31,LR,1,150,7,-74.1428571428571,-71,-80,9
31,LR,1,150,8,-74.375,-68,-80,12
31,LR,1,150,6,-73.8333333333333,-68,-80,12
31,LR,1,150,9,-78.5555555555556,-68,-85,17
31,LR,1,150,4,-74.25,-68,-79,11
31,LR,0,150,2,-71.5,-68,-75,7
31,LR,1,150,4,-78.75,-68,-85,17
31,LR,0,150,2,-82,-79,-85,6
31,LR,0,150,1,-85,-85,-85,0
31,LR,1,150,6,-78.3333333333333,-74,-85,11
31,LR,1,150,8,-77,-72,-85,13
31,LR,1,150,3,-78.6666666666667,-74,-85,11
31,LR,0,150,1,-74,-74,-74,0
31,LR,0,150,1,-77,-77,-77,0
31,LR,0,150,1,-74,-74,-74,0
31,LR,1,150,7,-74,-71,-84,13
31,LR,0,150,2,-78.5,-73,-84,11
31,LR,1,150,8,-74.75,-71,-84,13
31,LR,1,150,4,-72.25,-71,-74,3
31,LR,1,150,7,-74.7142857142857,-72,-80,8
31,LR,0,150,1,-72,-72,-72,0
31,LR,1,150,6,-76.5,-72,-80,8
31,LR,1,150,10,-75.1,-67,-80,13
31,LR,0,150,1,-74,-74,-74,0
31,LR,1,150,7,-75.1428571428571,-67,-80,13
31,LR,1,150,4,-77.25,-75,-80,5
31,LR,0,150,2,-76.5,-75,-78,3
31,LR,1,150,3,-72.6666666666667,-67,-76,9
31,LR,1,150,8,-72,-66,-91,25
31,LR,1,150,6,-73.1666666666667,-66,-91,25
31,LR,0,150,1,-75,-75,-75,0
31,LR,1,150,8,-71.875,-66,-91,25
31,LR,1,150,8,-69.25,-66,-72,6
31,LR,1,150,10,-70,-68,-72,4
31,LR,1,150,4,-70,-68,-72,4
31,LR,1,150,9,-70.2222222222222,-68,-72,4
31,LR,0,150,1,-72,-72,-72,0
31,LR,1,150,10,-70,-68,-72,4
31,LR,1,150,8,-70,-68,-72,4
31,LR,1,150,10,-70.9,-68,-76,8
31,LR,1,150,10,-71.1,-68,-76,8
31,LR,1,150,4,-69.75,-69,-70,1
31,LR,1,150,3,-70,-70,-70,0
31,LR,1,150,8,-72.5,-70,-76,6
31,LR,1,150,5,-72,-70,-76,6
31,LR,1,150,9,-73,-70,-76,6
31,LR,1,150,3,-73.3333333333333,-70,-76,6
31,LR,0,150,2,-75,-74,-76,2
31,LR,0,150,1,-76,-76,-76,0
31,LR,1,150,7,-73.2857142857143,-71,-76,5
31,LR,1,150,7,-73,-71,-76,5
31,LR,1,150,10,-72.3,-71,-75,4
31,LR,1,150,9,-72.2222222222222,-71,-75,4
31,LR,1,150,3,-72.6666666666667,-71,-75,4
31,LR,1,150,4,-71.75,-71,-72,1
31,LR,0,150,2,-72,-72,-72,0
31,LR,1,150,4,-72,-72,-72,0
31,LR,0,150,2,-72,-72,-72,0
31,LR,1,150,6,-70.5,-68,-73,5
31,LR,0,150,1,-72,-72,-72,0
31,LR,1,150,9,-72.1111111111111,-69,-76,7
31,LR,1,150,7,-72,-69,-76,7
31,LR,1,150,10,-73.1,-70,-78,8
31,LR,1,150,4,-73,-70,-76,6
31,LR,1,150,5,-73.2,-70,-76,6
31,LR,1,150,8,-74.125,-70,-78,8
31,LR,1,150,5,-74,-70,-78,8
31,LR,1,150,3,-74,-70,-78,8
31,LR,0,150,2,-76,-74,-78,4
31,LR,1,150,5,-74.2,-72,-78,6
31,LR,0,150,2,-72,-72,-72,0
31,LR,1,150,10,-72.6,-69,-80,11
31,LR,1,150,6,-74.3333333333333,-70,-80,10
31,LR,1,150,5,-73.8,-70,-80,10
31,LR,0,150,2,-75.5,-71,-80,9
31,LR,1,150,8,-71.375,-68,-80,12
31,LR,1,150,7,-70.1428571428571,-68,-76,8
31,LR,1,150,6,-69.1666666666667,-68,-70,2
31,LR,1,150,8,-69.25,-68,-71,3
31,LR,1,150,3,-69.3333333333333,-69,-70,1
31,LR,1,150,10,-70,-68,-74,6
31,LR,1,150,3,-69,-68,-70,2
31,LR,1,150,9,-70.6666666666667,-68,-75,7
31,LR,1,150,9,-71,-68,-75,7
31,LR,1,150,6,-70.5,-68,-74,6
31,LR,1,150,5,-71.8,-69,-75,6
31,LR,1,150,9,-72.3333333333333,-69,-78,9
31,LR,0,150,2,-73,-71,-75,4
31,LR,1,150,7,-73.2857142857143,-70,-78,8
31,LR,1,150,9,-76.3333333333333,-70,-85,15
31,LR,1,150,6,-74.8333333333333,-70,-82,12
31,LR,0,150,1,-70,-70,-70,0
31,LR,1,150,3,-77,-73,-82,9
31,LR,1,150,3,-81,-76,-85,9
31,LR,0,150,2,-83.5,-82,-85,3
31,LR,1,150,3,-76.6666666666667,-72,-82,10
31,LR,1,150,4,-74,-72,-76,4
31,LR,1,150,8,-76.5,-72,-84,12
31,LR,1,150,6,-76,-73,-82,9
31,LR,1,150,5,-76.2,-73,-82,9
31,LR,1,150,3,-77.6666666666667,-75,-82,7
31,LR,1,150,8,-77.125,-71,-84,13
31,LR,1,150,5,-77.2,-75,-83,8
31,LR,1,150,7,-75.1428571428571,-71,-83,12
31,LR,1,150,6,-75,-72,-78,6
31,LR,0,150,2,-76.5,-75,-78,3
31,LR,0,150,1,-78,-78,-78,0
31,LR,1,150,10,-75.6,-72,-82,10
31,LR,1,150,9,-75.3333333333333,-72,-82,10
31,LR,1,150,3,-75.6666666666667,-73,-77,4
31,LR,0,150,1,-77,-77,-77,0
31,LR,1,150,7,-75.2857142857143,-72,-82,10
31,LR,1,150,6,-74.5,-70,-82,12
31,LR,1,150,3,-77.6666666666667,-73,-82,9
31,LR,0,150,1,-78,-78,-78,0
31,LR,1,150,6,-75.8333333333333,-72,-82,10
31,LR,1,150,6,-74.8333333333333,-70,-82,12
26,RL,1,150,6,-72.1666666666667,-65,-85,20
26,RL,1,150,3,-67.3333333333333,-65,-71,6
26,RL,0,150,1,-65,-65,-65,0
26,RL,1,150,5,-72,-70,-75,5
26,RL,1,150,7,-75.5714285714286,-68,-93,25
26,RL,1,150,5,-72.2,-68,-79,11
26,RL,0,150,1,-68,-68,-68,0
26,RL,1,150,8,-76.625,-70,-93,23
26,RL,0,150,2,-81.5,-70,-93,23
26,RL,1,150,10,-74.6,-70,-80,10
26,RL,1,150,6,-75,-72,-79,7
26,RL,1,150,9,-75.5555555555556,-70,-80,10
26,RL,0,150,1,-72,-72,-72,0
26,RL,1,150,5,-76,-70,-80,10
26,RL,1,150,10,-78.3,-70,-87,17
26,RL,1,150,10,-78.3,-70,-87,17
26,RL,1,150,9,-79.2222222222222,-76,-87,11
26,RL,1,150,4,-79.75,-76,-87,11
26,RL,1,150,3,-81,-76,-87,11
26,RL,0,150,1,-87,-87,-87,0
26,RL,1,150,9,-78.2222222222222,-76,-80,4
26,RL,1,150,10,-79,-76,-86,10
26,RL,1,150,4,-78.25,-77,-79,2
26,RL,0,150,1,-79,-79,-79,0
26,RL,1,150,3,-78,-76,-79,3
26,RL,1,150,8,-78.375,-75,-86,11
26,RL,1,150,6,-78.6666666666667,-75,-86,11
26,RL,1,150,9,-79.4444444444444,-74,-86,12
26,RL,1,150,10,-78.1,-74,-83,9
26,RL,1,150,3,-76.6666666666667,-75,-79,4
26,RL,1,150,8,-78.125,-74,-83,9
26,RL,1,150,6,-77.3333333333333,-74,-83,9
26,RL,0,150,1,-74,-74,-74,0
26,RL,1,150,9,-78.2222222222222,-74,-90,16
26,RL,1,150,6,-78.3333333333333,-74,-90,16
26,RL,1,150,8,-78.875,-74,-90,16
26,RL,1,150,3,-81,-74,-90,16
26,RL,1,150,3,-76.3333333333333,-74,-79,5
26,RL,1,150,9,-79.4444444444444,-73,-90,17
26,RL,1,150,5,-83.2,-75,-90,15
26,RL,1,150,6,-81.6666666666667,-73,-90,17
26,RL,1,150,5,-80.8,-73,-90,17
26,RL,1,150,5,-80,-73,-90,17
26,RL,1,150,3,-74.3333333333333,-73,-76,3
26,RL,1,150,6,-75.8333333333333,-73,-85,12
26,RL,1,150,9,-79.3333333333333,-73,-95,22
26,RL,1,150,5,-81.2,-74,-95,21
26,RL,1,150,5,-76.8,-73,-89,16
26,RL,1,150,6,-78.1666666666667,-73,-89,16
26,RL,1,150,6,-75.5,-73,-85,12
26,RL,1,150,10,-78.8,-73,-92,19
26,RL,1,150,9,-79.3333333333333,-73,-92,19
26,RL,1,150,3,-74,-73,-75,2
26,RL,1,150,5,-80,-73,-92,19
26,RL,0,150,2,-75,-75,-75,0
26,RL,1,150,3,-84,-75,-92,17
26,RL,1,150,8,-79,-72,-85,13
26,RL,1,150,7,-78.1428571428571,-72,-85,13
26,RL,0,150,2,-77.5,-73,-82,9
26,RL,1,150,4,-80,-75,-85,10
26,RL,1,150,5,-76,-70,-85,15
26,RL,1,150,3,-77.3333333333333,-72,-85,13
26,RL,1,150,7,-72.7142857142857,-70,-75,5
26,RL,1,150,10,-72.9,-70,-80,10
26,RL,1,150,10,-73.1,-70,-80,10
26,RL,1,150,3,-75.3333333333333,-73,-80,7
26,RL,1,150,10,-72.7,-70,-80,10
26,RL,1,150,3,-74,-70,-80,10
26,RL,0,150,1,-72,-72,-72,0
26,RL,1,150,3,-72.3333333333333,-71,-73,2
26,RL,1,150,5,-71.8,-70,-75,5
26,RL,1,150,10,-72.9,-70,-76,6
26,RL,1,150,4,-73.5,-70,-75,5
26,RL,0,150,1,-74,-74,-74,0
26,RL,1,150,4,-74,-71,-76,5
26,RL,1,150,9,-73.2222222222222,-71,-76,5
26,RL,1,150,9,-73.1111111111111,-71,-76,5
26,RL,1,150,6,-73,-71,-76,5
26,RL,1,150,3,-72.3333333333333,-71,-73,2
26,RL,1,150,6,-73.3333333333333,-72,-76,4
26,RL,1,150,10,-72.8,-70,-76,6
26,RL,0,150,2,-71.5,-70,-73,3
26,RL,1,150,7,-72,-70,-74,4
26,RL,1,150,5,-72.8,-71,-74,3
26,RL,0,150,2,-71.5,-71,-72,1
26,RL,1,150,10,-72.6,-70,-74,4
26,RL,1,150,8,-72.625,-70,-74,4
26,RL,1,150,10,-74.8,-72,-80,8
26,RL,1,150,5,-73,-72,-74,2
26,RL,0,150,2,-73,-72,-74,2
26,RL,1,150,3,-73.3333333333333,-72,-74,2
26,RL,1,150,10,-78.2,-72,-85,13
26,RL,1,150,10,-78.5,-74,-85,11
26,RL,0,150,2,-78.5,-77,-80,3
26,RL,1,150,3,-77,-75,-79,4
26,RL,1,150,6,-79,-75,-85,10
26,RL,1,150,7,-79.4285714285714,-73,-85,12
26,RL,1,150,7,-78.8571428571429,-73,-85,12
26,RL,1,150,10,-77.4,-72,-85,13
26,RL,1,150,8,-76.875,-72,-84,12
26,RL,1,150,9,-74.7777777777778,-72,-78,6
26,RL,1,150,3,-74.3333333333333,-72,-77,5
26,RL,0,150,1,-72,-72,-72,0
26,RL,1,150,3,-75,-73,-78,5
26,RL,1,150,6,-77.1666666666667,-74,-78,4
26,RL,1,150,3,-76.3333333333333,-74,-78,4
26,RL,0,150,2,-77.5,-77,-78,1
26,RL,1,150,8,-77.5,-75,-81,6
26,RL,1,150,6,-77.3333333333333,-75,-81,6
26,RL,0,150,1,-78,-78,-78,0
26,RL,0,150,2,-75,-75,-75,0
26,RL,0,150,1,-75,-75,-75,0
26,RL,1,150,9,-76.6666666666667,-73,-82,9
26,RL,1,150,9,-76.3333333333333,-73,-82,9
26,RL,1,150,5,-76.8,-74,-82,8
26,RL,1,150,9,-75,-72,-82,10
26,RL,1,150,6,-75.5,-73,-82,9
26,RL,1,150,6,-75.8333333333333,-73,-82,9
26,RL,1,150,6,-74.1666666666667,-72,-76,4
26,RL,1,150,9,-74.3333333333333,-72,-78,6
26,RL,1,150,3,-75,-74,-76,2
26,RL,1,150,4,-75,-72,-78,6
26,RL,1,150,7,-74.4285714285714,-72,-78,6
26,RL,1,150,5,-74.2,-72,-78,6
26,RL,1,150,6,-74.5,-72,-78,6
26,RL,1,150,7,-73.8571428571429,-72,-76,4
26,RL,1,150,8,-74.25,-73,-76,3
26,RL,1,150,10,-74.5,-70,-79,9
26,RL,0,150,1,-75,-75,-75,0
26,RL,1,150,5,-74.8,-73,-79,6
26,RL,1,150,3,-75.6666666666667,-73,-79,6
26,RL,1,150,3,-74,-70,-79,9
26,RL,0,150,2,-74.5,-70,-79,9
26,RL,1,150,3,-73.6666666666667,-73,-75,2
26,RL,1,150,9,-74.5555555555556,-71,-78,7
26,RL,1,150,3,-75.3333333333333,-73,-78,5
26,RL,0,150,2,-75.5,-73,-78,5
26,RL,1,150,9,-75,-71,-79,8
26,RL,0,150,2,-74.5,-71,-78,7
26,RL,1,150,3,-75,-72,-78,6
26,RL,1,150,10,-75.9,-74,-79,5
26,RL,1,150,8,-76,-74,-79,5
26,RL,1,150,7,-76,-74,-79,5
26,RL,1,150,6,-76.3333333333333,-74,-79,5
26,RL,1,150,7,-75.2857142857143,-70,-79,9
26,RL,1,150,9,-74.3333333333333,-70,-77,7
26,RL,1,150,9,-75.2222222222222,-70,-80,10
26,RL,0,150,2,-76.5,-76,-77,1
26,RL,0,150,2,-73,-70,-76,6
26,RL,0,150,1,-73,-73,-73,0
26,RL,1,150,4,-78.25,-74,-80,6
26,RL,1,150,8,-76.75,-73,-80,7
26,RL,1,150,5,-76.4,-74,-80,6
26,RL,0,150,1,-74,-74,-74,0
26,RL,0,150,2,-77,-74,-80,6
26,RL,1,150,8,-75.5,-73,-80,7
26,RL,0,150,1,-74,-74,-74,0
26,RL,1,150,7,-74.8571428571429,-73,-79,6
26,RL,0,150,2,-77.5,-76,-79,3
26,RL,1,150,8,-74,-71,-76,5
26,RL,1,150,3,-74,-73,-76,3
26,RL,1,150,7,-73,-68,-76,8
26,RL,1,150,5,-72.4,-68,-76,8
26,RL,1,150,6,-71.8333333333333,-68,-76,8
26,RL,1,150,7,-71.5714285714286,-68,-76,8
26,RL,0,150,2,-72,-68,-76,8
26,RL,1,150,4,-70.25,-68,-73,5
26,RL,1,150,3,-71,-70,-73,3
26,RL,0,150,1,-70,-70,-70,0
26,RL,1,150,8,-73.375,-70,-78,8
26,RL,1,150,9,-73.7777777777778,-70,-78,8
26,RL,1,150,5,-74,-70,-78,8
26,RL,1,150,6,-74.1666666666667,-70,-78,8
26,RL,1,150,9,-76.7777777777778,-70,-82,12
26,RL,1,150,9,-75.8888888888889,-70,-82,12
26,RL,1,150,7,-76.7142857142857,-70,-82,12
26,RL,0,150,1,-75,-75,-75,0
26,RL,1,150,9,-74,-68,-82,14
26,RL,0,150,1,-74,-74,-74,0
26,RL,1,150,6,-73.8333333333333,-68,-82,14
26,RL,1,150,6,-72,-68,-81,13
26,RL,1,150,9,-71.3333333333333,-68,-75,7
26,RL,1,150,7,-71,-68,-74,6
26,RL,1,150,6,-71.5,-69,-74,5
26,RL,1,150,10,-72.8,-69,-79,10
26,RL,0,150,2,-71,-69,-73,4
26,RL,1,150,5,-75,-71,-79,8
26,RL,0,150,1,-75,-75,-75,0
26,RL,1,150,3,-75.3333333333333,-71,-79,8
26,RL,1,150,10,-75.7,-69,-92,23
26,RL,0,150,2,-70.5,-70,-71,1
26,RL,1,150,7,-74.7142857142857,-69,-92,23
26,RL,1,150,5,-72.2,-69,-77,8
26,RL,1,150,10,-76.6,-69,-92,23
26,RL,1,150,10,-76.5,-68,-92,24
26,RL,1,150,9,-76.8888888888889,-68,-92,24
26,RL,1,150,9,-75.6666666666667,-68,-92,24
26,RL,1,150,6,-71.6666666666667,-68,-77,9
26,RL,0,150,2,-73.5,-73,-74,1
26,RL,1,150,7,-71.7142857142857,-68,-81,13
26,RL,1,150,3,-68.6666666666667,-68,-70,2
26,RL,1,150,10,-73,-68,-81,13
26,RL,1,150,10,-73.2,-69,-81,12
26,RL,1,150,10,-72.9,-67,-81,14
26,RL,1,150,6,-74.5,-69,-81,12
26,RL,1,150,4,-76,-73,-81,8
26,RL,1,150,9,-71.6666666666667,-67,-75,8
26,RL,1,150,7,-70.8571428571429,-67,-74,7
26,RL,1,150,10,-70.7,-67,-75,8
26,RL,0,150,1,-67,-67,-67,0
26,RL,1,150,6,-72,-67,-75,8
26,RL,1,150,7,-71.8571428571429,-68,-75,7
26,RL,1,150,5,-72.6,-70,-75,5
26,RL,1,150,4,-71,-68,-75,7
26,RL,0,150,1,-75,-75,-75,0
26,RL,0,150,2,-69,-68,-70,2
26,RL,1,150,4,-68,-68,-68,0
26,RL,1,150,8,-70.75,-68,-79,11
26,RL,1,150,3,-74,-70,-79,9
26,RL,1,150,9,-71.1111111111111,-69,-73,4
26,RL,1,150,6,-71.1666666666667,-70,-73,3
26,RL,1,150,3,-70.6666666666667,-70,-72,2
26,RL,1,150,5,-71.6,-70,-73,3
26,RL,1,150,8,-70.5,-67,-73,6
26,RL,1,150,3,-72,-71,-73,2
26,RL,1,150,8,-69.625,-67,-73,6
26,RL,1,150,6,-69.1666666666667,-67,-71,4
26,RL,0,150,2,-69.5,-69,-70,1
26,RL,0,150,2,-70,-70,-70,0
26,RL,1,150,5,-68.2,-67,-70,3
26,RL,0,150,1,-67,-67,-67,0
26,RL,1,150,3,-68,-67,-69,2
26,RL,1,150,4,-69.5,-67,-73,6
26,RL,0,150,2,-70,-67,-73,6
26,RL,1,150,8,-71.375,-69,-73,4
26,RL,1,150,9,-71.1111111111111,-69,-72,3
26,RL,1,150,4,-71.5,-71,-72,1
26,RL,0,150,1,-71,-71,-71,0
26,RL,1,150,7,-71.5714285714286,-70,-72,2
26,RL,0,150,2,-71.5,-71,-72,1
26,RL,1,150,9,-73.1111111111111,-70,-79,9
26,RL,0,150,2,-71,-70,-72,2
26,RL,1,150,5,-74.4,-72,-79,7
26,RL,1,150,8,-73,-70,-79,9
26,RL,1,150,9,-72.4444444444444,-69,-79,10
26,RL,1,150,4,-74.25,-72,-79,7
26,RL,1,150,6,-71.8333333333333,-70,-74,4
26,RL,1,150,3,-71.3333333333333,-70,-72,2
26,RL,1,150,9,-71.3333333333333,-69,-75,6
26,RL,0,150,1,-70,-70,-70,0
26,RL,1,150,6,-71.6666666666667,-69,-75,6
26,RL,1,150,9,-73.8888888888889,-69,-84,15
26,RL,1,150,8,-74.5,-70,-84,14
26,RL,1,150,4,-73.5,-70,-76,6
26,RL,1,150,6,-75.5,-70,-84,14
26,RL,0,150,1,-70,-70,-70,0
26,RL,1,150,6,-74.8333333333333,-69,-84,15
26,RL,1,150,4,-76,-70,-84,14
26,RL,0,150,1,-78,-78,-78,0
26,RL,1,150,5,-71,-69,-74,5
26,RL,1,150,6,-75.1666666666667,-69,-85,16
26,RL,0,150,2,-71.5,-69,-74,5
26,RL,0,150,2,-72,-70,-74,4
26,RL,1,150,8,-77.25,-68,-85,17
26,RL,1,150,4,-73.5,-68,-81,13
26,RL,1,150,9,-75.6666666666667,-68,-87,19
26,RL,1,150,6,-78,-70,-87,17
26,RL,1,150,5,-78.4,-70,-87,17
26,RL,1,150,8,-77.25,-70,-87,17
26,RL,1,150,7,-80,-75,-87,12
26,RL,1,150,5,-77.8,-75,-82,7
26,RL,1,150,7,-76.7142857142857,-70,-84,14
26,RL,1,150,7,-76.5714285714286,-70,-84,14
26,RL,1,150,3,-81.3333333333333,-78,-84,6
26,RL,1,150,5,-74.6,-70,-84,14
26,RL,1,150,7,-72.5714285714286,-70,-74,4
26,RL,1,150,3,-73.3333333333333,-73,-74,1
26,RL,1,150,8,-73,-70,-76,6
26,RL,1,150,5,-73.8,-72,-76,4
26,RL,1,150,8,-73.375,-70,-79,9
26,RL,1,150,7,-73.2857142857143,-70,-79,9
26,RL,0,150,2,-75,-74,-76,2
26,RL,1,150,5,-73,-70,-79,9
26,RL,1,150,9,-75.5555555555556,-70,-83,13
26,RL,1,150,5,-76,-70,-83,13
26,RL,1,150,5,-77,-70,-83,13
26,RL,1,150,7,-78,-73,-83,10
26,RL,1,150,7,-76.5714285714286,-69,-83,14
26,RL,1,150,10,-76.4,-69,-83,14
26,RL,1,150,9,-75.3333333333333,-69,-80,11
26,RL,1,150,8,-74.75,-69,-78,9
26,RL,1,150,4,-75.25,-69,-78,9
26,RL,0,150,2,-78,-78,-78,0
26,RL,1,150,10,-74.6,-69,-83,14
26,RL,0,150,1,-76,-76,-76,0
26,RL,1,150,9,-73.8888888888889,-69,-83,14
26,RL,1,150,3,-71.3333333333333,-69,-73,4
26,RL,1,150,8,-73.25,-69,-83,14
26,RL,1,150,10,-73.5,-70,-83,13
26,RL,1,150,8,-73.625,-70,-83,13
26,RL,1,150,8,-72.25,-70,-75,5
26,RL,1,150,7,-72.4285714285714,-70,-75,5
26,RL,1,150,6,-72.1666666666667,-70,-75,5
26,RL,1,150,3,-72.3333333333333,-70,-75,5
26,RL,0,150,1,-75,-75,-75,0
26,RL,1,150,7,-76,-72,-80,8
26,RL,1,150,5,-75.8,-72,-80,8
26,RL,1,150,7,-76.7142857142857,-73,-80,7
26,RL,1,150,9,-75.2222222222222,-68,-80,12
26,RL,1,150,10,-75.9,-68,-84,16
26,RL,0,150,1,-74,-74,-74,0
26,RL,1,150,8,-75.25,-68,-84,16
26,RL,1,150,10,-75.3,-68,-84,16
26,RL,1,150,6,-74.6666666666667,-70,-84,14
26,RL,1,150,10,-75.8,-70,-84,14
26,RL,1,150,7,-76.5714285714286,-70,-84,14
26,RL,1,150,9,-76.5555555555556,-70,-84,14
26,RL,0,150,1,-77,-77,-77,0
26,RL,0,150,1,-70,-70,-70,0
26,RL,1,150,8,-78.5,-73,-87,14
26,RL,1,150,9,-77.3333333333333,-70,-87,17
26,RL,1,150,3,-75.6666666666667,-73,-78,5
26,RL,0,150,2,-75.5,-73,-78,5
26,RL,0,150,2,-76,-74,-78,4
26,RL,1,150,10,-75,-70,-87,17
26,RL,0,150,1,-83,-83,-83,0
26,RL,1,150,9,-73.8888888888889,-70,-87,17
26,RL,1,150,10,-72.4,-70,-74,4
26,RL,1,150,4,-72.5,-71,-74,3
26,RL,1,150,10,-73.7,-69,-81,12
26,RL,1,150,9,-74,-69,-81,12
26,RL,1,150,5,-72.8,-72,-74,2
26,RL,1,150,7,-74.4285714285714,-69,-81,12
26,RL,0,150,1,-72,-72,-72,0
26,RL,1,150,5,-75,-69,-81,12
26,RL,1,150,5,-75.4,-69,-81,12
26,RL,0,150,2,-74,-69,-79,10
26,RL,1,150,4,-77.5,-69,-84,15
26,RL,1,150,6,-77.6666666666667,-71,-84,13
26,RL,1,150,6,-76.1666666666667,-71,-84,13
26,RL,1,150,4,-77.25,-71,-84,13
26,RL,1,150,3,-75,-71,-79,8
26,RL,1,150,6,-71.8333333333333,-70,-74,4
26,RL,1,150,6,-72.1666666666667,-70,-74,4
26,RL,1,150,7,-73,-70,-77,7
26,RL,1,150,8,-73.125,-70,-77,7
26,RL,1,150,5,-72.6,-70,-77,7
26,RL,1,150,3,-73.3333333333333,-70,-77,7
26,RL,1,150,4,-74,-73,-77,4
26,RL,1,150,6,-75.8333333333333,-72,-87,15
26,RL,0,150,2,-74,-73,-75,2
26,RL,0,150,1,-75,-75,-75,0
26,RL,1,150,8,-77.25,-70,-87,17
26,RL,1,150,5,-77.2,-70,-87,17
26,RL,1,150,6,-76.5,-70,-81,11
26,RL,1,150,10,-75.6,-70,-81,11
26,RL,1,150,8,-76.375,-73,-81,8
26,RL,1,150,3,-77.6666666666667,-73,-81,8
26,RL,0,150,1,-79,-79,-79,0
26,RL,1,150,7,-74.1428571428571,-73,-76,3
26,RL,1,150,9,-74.4444444444444,-73,-76,3
26,RL,0,150,1,-75,-75,-75,0
26,RL,0,150,1,-75,-75,-75,0
26,RL,1,150,4,-74.25,-74,-75,1
26,RL,0,150,1,-74,-74,-74,0
26,RL,0,150,1,-68,-68,-68,0
26,RL,0,150,2,-78,-74,-82,8
26,RL,0,150,1,-75,-75,-75,0
26,LR,1,150,4,-73.5,-70,-80,10
26,LR,0,150,2,-75,-70,-80,10
26,LR,1,150,8,-72.75,-70,-76,6
26,LR,1,150,9,-72.7777777777778,-70,-76,6
26,LR,1,150,6,-72.5,-70,-76,6
26,LR,1,150,4,-73.25,-70,-76,6
26,LR,1,150,5,-71.8,-70,-74,4
26,LR,1,150,3,-71.3333333333333,-70,-74,4
26,LR,1,150,6,-72.1666666666667,-70,-75,5
26,LR,1,150,9,-73.3333333333333,-70,-79,9
26,LR,0,150,2,-73.5,-72,-75,3
26,LR,1,150,9,-73.6666666666667,-70,-79,9
26,LR,0,150,2,-74,-74,-74,0
26,LR,1,150,4,-73.5,-70,-79,9
26,LR,0,150,1,-72,-72,-72,0
26,LR,0,150,2,-76,-70,-82,12
26,LR,1,150,10,-76.5,-72,-82,10
26,LR,1,150,8,-75.375,-72,-82,10
26,LR,1,150,10,-76.5,-72,-81,9
26,LR,1,150,8,-76.625,-72,-81,9
26,LR,0,150,2,-75.5,-72,-79,7
26,LR,0,150,2,-74,-72,-76,4
26,LR,1,150,3,-77.3333333333333,-76,-80,4
26,LR,0,150,1,-76,-76,-76,0
26,LR,1,150,10,-77.5,-72,-81,9
26,LR,0,150,1,-75,-75,-75,0
26,LR,0,150,1,-80,-80,-80,0
26,LR,1,150,7,-76.7142857142857,-72,-80,8
26,LR,1,150,7,-74.8571428571429,-72,-78,6
26,LR,1,150,10,-74.7,-72,-78,6
26,LR,1,150,7,-74,-72,-78,6
26,LR,1,150,8,-74.375,-72,-78,6
26,LR,1,150,5,-73.6,-72,-77,5
26,LR,0,150,1,-72,-72,-72,0
26,LR,0,150,1,-73,-73,-73,0
26,LR,1,150,9,-75.7777777777778,-72,-80,8
26,LR,1,150,4,-75,-72,-78,6
26,LR,0,150,2,-72.5,-72,-73,1
26,LR,1,150,8,-76.625,-73,-81,8
26,LR,0,150,2,-78,-78,-78,0
26,LR,1,150,4,-76.75,-74,-80,6
26,LR,1,150,3,-76.3333333333333,-74,-80,6
26,LR,1,150,5,-77.4,-74,-81,7
26,LR,1,150,7,-76.4285714285714,-74,-81,7
26,LR,1,150,10,-75.4,-74,-77,3
26,LR,1,150,3,-76,-75,-77,2
26,LR,1,150,7,-75.2857142857143,-74,-77,3
26,LR,1,150,4,-74.75,-74,-76,2
26,LR,1,150,9,-75.5555555555556,-74,-81,7
26,LR,1,150,7,-75.8571428571429,-74,-81,7
26,LR,1,150,6,-76.1666666666667,-74,-81,7
26,LR,1,150,5,-76.2,-74,-81,7
26,LR,1,150,9,-75.7777777777778,-73,-81,8
26,LR,1,150,5,-75.8,-73,-81,8
26,LR,1,150,6,-75.3333333333333,-73,-80,7
26,LR,1,150,4,-75.25,-73,-80,7
26,LR,0,150,2,-76.5,-73,-80,7
26,LR,1,150,7,-74.8571428571429,-73,-80,7
26,LR,1,150,4,-75.75,-74,-80,6
26,LR,0,150,2,-77.5,-75,-80,5
26,LR,0,150,2,-74.5,-74,-75,1
26,LR,1,150,8,-75.25,-70,-85,15
26,LR,1,150,7,-75.4285714285714,-70,-85,15
26,LR,1,150,4,-74.5,-70,-81,11
26,LR,1,150,7,-75.8571428571429,-70,-85,15
26,LR,1,150,5,-78,-72,-85,13
26,LR,1,150,7,-75.8571428571429,-71,-85,14
26,LR,0,150,1,-78,-78,-78,0
26,LR,1,150,10,-75.7,-72,-82,10
26,LR,1,150,5,-74,-72,-80,8
26,LR,1,150,5,-75.2,-72,-80,8
26,LR,1,150,5,-75.4,-72,-80,8
26,LR,1,150,4,-78.75,-74,-82,8
26,LR,1,150,6,-78.8333333333333,-73,-84,11
26,LR,1,150,10,-75.1,-68,-84,16
26,LR,1,150,4,-74,-68,-80,12
26,LR,1,150,10,-72.4,-68,-80,12
26,LR,1,150,8,-71.125,-68,-74,6
26,LR,1,150,5,-72.6,-70,-74,4
26,LR,1,150,4,-72.75,-70,-74,4
26,LR,1,150,10,-73.2,-67,-85,18
26,LR,1,150,6,-73.6666666666667,-68,-85,17
26,LR,1,150,3,-70.6666666666667,-68,-74,6
26,LR,1,150,6,-73.8333333333333,-67,-85,18
26,LR,1,150,5,-72,-67,-77,10
26,LR,1,150,5,-72.4,-70,-77,7
26,LR,1,150,7,-71,-69,-75,6
26,LR,1,150,5,-70,-69,-71,2
26,LR,1,150,4,-69.75,-69,-70,1
26,LR,0,150,2,-69.5,-69,-70,1
26,LR,1,150,10,-72.6,-68,-80,12
26,LR,0,150,2,-72.5,-70,-75,5
26,LR,1,150,3,-73.6666666666667,-71,-75,4
26,LR,1,150,3,-74.6666666666667,-71,-78,7
26,LR,1,150,8,-71.75,-68,-80,12
26,LR,1,150,6,-72.1666666666667,-68,-80,12
26,LR,1,150,10,-71.1,-68,-80,12
26,LR,1,150,4,-68.75,-68,-70,2
26,LR,0,150,1,-69,-69,-69,0
26,LR,1,150,7,-70.5714285714286,-68,-73,5
26,LR,1,150,8,-70.75,-68,-73,5
26,LR,1,150,10,-70.7,-68,-73,5
26,LR,1,150,4,-71.25,-70,-73,3
26,LR,1,150,9,-70.6666666666667,-69,-72,3
26,LR,1,150,8,-70.75,-69,-72,3
26,LR,1,150,7,-70.8571428571429,-69,-72,3
26,LR,0,150,2,-70,-70,-70,0
26,LR,1,150,10,-71.1,-70,-73,3
26,LR,1,150,3,-71.6666666666667,-71,-72,1
26,LR,1,150,4,-71.25,-70,-72,2
26,LR,1,150,6,-71.1666666666667,-70,-73,3
26,LR,1,150,9,-71.5555555555556,-70,-75,5
26,LR,1,150,10,-71.6,-70,-75,5
26,LR,1,150,3,-71.3333333333333,-70,-73,3
26,LR,1,150,10,-71.3,-70,-75,5
26,LR,1,150,3,-71.6666666666667,-70,-75,5
26,LR,1,150,10,-72,-70,-75,5
26,LR,0,150,1,-70,-70,-70,0
26,LR,1,150,6,-72,-70,-74,4
26,LR,1,150,6,-71.6666666666667,-70,-74,4
26,LR,1,150,10,-72.1,-70,-74,4
26,LR,1,150,4,-72.5,-72,-74,2
26,LR,1,150,4,-72.5,-72,-74,2
26,LR,0,150,2,-72,-72,-72,0
26,LR,0,150,2,-72,-72,-72,0
26,LR,1,150,4,-72,-70,-74,4
26,LR,1,150,8,-71.625,-70,-74,4
26,LR,1,150,3,-71.6666666666667,-70,-73,3
26,LR,0,150,2,-72.5,-72,-73,1
26,LR,1,150,8,-71.25,-70,-73,3
26,LR,1,150,10,-71,-70,-73,3
26,LR,1,150,10,-71,-70,-73,3
26,LR,1,150,6,-70.6666666666667,-70,-72,2
26,LR,1,150,7,-70.8571428571429,-70,-72,2
26,LR,1,150,9,-71.4444444444444,-70,-74,4
26,LR,0,150,1,-71,-71,-71,0
26,LR,1,150,4,-71.5,-70,-73,3
26,LR,0,150,2,-71.5,-71,-72,1
26,LR,1,150,5,-72,-70,-74,4
26,LR,0,150,1,-74,-74,-74,0
26,LR,1,150,4,-72.5,-72,-73,1
26,LR,1,150,5,-72.2,-70,-73,3
26,LR,0,150,2,-72.5,-72,-73,1
26,LR,1,150,3,-72,-70,-73,3
26,LR,1,150,3,-71,-70,-73,3
26,LR,1,150,5,-70.8,-68,-73,5
26,LR,1,150,3,-71,-70,-73,3
26,LR,1,150,7,-71.2857142857143,-68,-74,6
26,LR,1,150,7,-71.8571428571429,-68,-74,6
26,LR,1,150,10,-71.3,-68,-76,8
26,LR,1,150,3,-72,-68,-74,6
26,LR,0,150,1,-68,-68,-68,0
26,LR,1,150,10,-71.2,-68,-76,8
26,LR,1,150,8,-71,-69,-76,7
26,LR,1,150,6,-71.3333333333333,-69,-76,7
26,LR,1,150,8,-71.25,-69,-78,9
26,LR,1,150,3,-71,-69,-72,3
26,LR,1,150,5,-71.8,-69,-78,9
26,LR,1,150,3,-70.6666666666667,-70,-72,2
26,LR,1,150,10,-73,-70,-78,8
26,LR,1,150,8,-73.375,-70,-78,8
26,LR,1,150,10,-74.6,-70,-79,9
26,LR,0,150,1,-70,-70,-70,0
26,LR,1,150,6,-73.6666666666667,-72,-76,4
26,LR,1,150,7,-75.1428571428571,-73,-79,6
26,LR,1,150,6,-75.5,-73,-79,6
26,LR,1,150,3,-73.6666666666667,-73,-74,1
26,LR,1,150,6,-75.3333333333333,-70,-79,9
26,LR,1,150,10,-74.3,-70,-79,9
26,LR,0,150,1,-79,-79,-79,0
26,LR,1,150,5,-74.8,-70,-79,9
26,LR,1,150,6,-74,-70,-79,9
26,LR,1,150,5,-74.8,-70,-79,9
26,LR,1,150,10,-73.1,-70,-78,8
26,LR,1,150,3,-75,-70,-78,8
26,LR,1,150,4,-72.25,-70,-77,7
26,LR,0,150,1,-77,-77,-77,0
26,LR,1,150,6,-72.6666666666667,-70,-76,6
26,LR,1,150,9,-73,-71,-77,6
26,LR,1,150,8,-73.125,-71,-77,6
26,LR,1,150,5,-72.2,-71,-76,5
26,LR,1,150,5,-73.4,-71,-77,6
26,LR,1,150,3,-71.3333333333333,-71,-72,1
26,LR,1,150,6,-72.8333333333333,-71,-77,6
26,LR,1,150,8,-72,-70,-77,7
26,LR,1,150,6,-72.5,-70,-77,7
26,LR,1,150,7,-71.5714285714286,-70,-75,5
26,LR,1,150,5,-72,-70,-75,5
26,LR,1,150,6,-70.8333333333333,-70,-74,4
26,LR,1,150,3,-71.3333333333333,-70,-74,4
26,LR,1,150,4,-71,-70,-74,4
26,LR,1,150,8,-72.25,-67,-82,15
26,LR,1,150,10,-74.3,-67,-89,22
26,LR,1,150,9,-74.7777777777778,-67,-89,22
26,LR,1,150,9,-75.2222222222222,-67,-89,22
26,LR,1,150,5,-75,-67,-89,22
26,LR,1,150,10,-73.3,-67,-89,22
26,LR,0,150,2,-73,-70,-76,6
26,LR,1,150,10,-73.1,-69,-83,14
26,LR,1,150,10,-72.8,-67,-83,16
26,LR,0,150,1,-71,-71,-71,0
26,LR,1,150,8,-72.25,-67,-83,16
26,LR,0,150,2,-69.5,-69,-70,1
26,LR,0,150,2,-80,-77,-83,6
26,LR,1,150,8,-71.625,-67,-77,10
26,LR,0,150,2,-71,-70,-72,2
26,LR,1,150,8,-71,-67,-75,8
26,LR,1,150,3,-70,-67,-75,8
26,LR,1,150,4,-71.75,-68,-75,7
26,LR,0,150,2,-68.5,-68,-69,1
26,LR,0,150,1,-69,-69,-69,0
26,LR,1,150,10,-72.5,-68,-79,11
26,LR,1,150,4,-72.5,-69,-79,10
26,LR,1,150,3,-73.3333333333333,-69,-79,10
26,LR,1,150,5,-73.8,-69,-79,10
26,LR,1,150,4,-75,-70,-79,9
26,LR,1,150,4,-72.25,-68,-78,10
26,LR,1,150,5,-72,-68,-78,10
26,LR,1,150,5,-72.6,-68,-81,13
26,LR,1,150,3,-71.3333333333333,-71,-72,1
26,LR,1,150,9,-73.1111111111111,-67,-82,15
26,LR,1,150,8,-73.25,-67,-82,15
26,LR,1,150,4,-72.5,-67,-82,15
26,LR,1,150,7,-71.7142857142857,-67,-82,15
26,LR,1,150,4,-73.25,-67,-82,15
26,LR,0,150,2,-77,-72,-82,10
26,LR,0,150,2,-72,-72,-72,0
26,LR,1,150,8,-72.25,-70,-77,7
26,LR,1,150,10,-73.7,-70,-82,12
26,LR,1,150,9,-73.8888888888889,-70,-82,12
26,LR,1,150,7,-75,-70,-82,12
26,LR,1,150,9,-73.1111111111111,-68,-82,14
26,LR,1,150,9,-72.5555555555556,-68,-82,14
26,LR,1,150,5,-75.8,-70,-82,12
26,LR,0,150,2,-77,-72,-82,10
26,LR,1,150,10,-70.1,-67,-76,9
26,LR,0,150,1,-68,-68,-68,0
26,LR,1,150,10,-69.8,-67,-76,9
26,LR,1,150,3,-71.3333333333333,-68,-76,8
26,LR,1,150,4,-71,-67,-76,9
26,LR,1,150,4,-68.75,-67,-73,6
26,LR,1,150,8,-68.75,-67,-71,4
26,LR,1,150,7,-69,-67,-71,4
26,LR,0,150,1,-69,-69,-69,0
26,LR,1,150,9,-72.4444444444444,-68,-84,16
26,LR,1,150,7,-72.7142857142857,-68,-84,16
26,LR,1,150,7,-74.1428571428571,-69,-84,15
26,LR,1,150,10,-73.3,-69,-84,15
26,LR,1,150,4,-75.5,-71,-84,13
26,LR,1,150,4,-72.25,-71,-74,3
26,LR,1,150,6,-71.6666666666667,-70,-74,4
26,LR,1,150,6,-71.1666666666667,-70,-72,2
26,LR,1,150,6,-71,-70,-72,2
26,LR,1,150,4,-71.25,-70,-72,2
26,LR,1,150,3,-71,-70,-72,2
26,LR,1,150,8,-70.375,-69,-72,3
26,LR,1,150,8,-70.25,-69,-72,3
26,LR,1,150,8,-69.875,-67,-72,5
26,LR,0,150,1,-70,-70,-70,0
26,LR,1,150,7,-69.1428571428571,-67,-72,5
26,LR,1,150,6,-69.1666666666667,-67,-72,5
26,LR,1,150,8,-69.875,-67,-72,5
26,LR,1,150,10,-70.5,-67,-78,11
26,LR,1,150,9,-71.4444444444444,-68,-78,10
26,LR,0,150,1,-68,-68,-68,0
26,LR,1,150,4,-72.5,-70,-78,8
26,LR,1,150,8,-72.375,-70,-78,8
26,LR,0,150,1,-70,-70,-70,0
26,LR,1,150,6,-72.8333333333333,-70,-78,8
26,LR,1,150,6,-72,-70,-75,5
26,LR,1,150,4,-71.75,-70,-73,3
26,LR,1,150,6,-70.6666666666667,-69,-73,4
26,LR,1,150,10,-69.3,-66,-73,7
26,LR,0,150,2,-71.5,-70,-73,3
26,LR,1,150,4,-69.25,-68,-70,2
26,LR,1,150,6,-68.3333333333333,-66,-70,4
26,LR,1,150,6,-68.5,-66,-70,4
26,LR,1,150,4,-68.25,-66,-70,4
26,LR,1,150,3,-68.6666666666667,-66,-70,4
26,LR,1,150,9,-71.5555555555556,-69,-81,12
26,LR,1,150,4,-70.5,-69,-73,4
26,LR,1,150,7,-72,-69,-81,12
26,LR,1,150,10,-71.5,-67,-81,14
26,LR,0,150,2,-70,-70,-70,0
26,LR,0,150,2,-70,-70,-70,0
26,LR,0,150,2,-76,-71,-81,10
26,LR,1,150,7,-73.1428571428571,-67,-84,17
26,LR,0,150,2,-67.5,-67,-68,1
26,LR,1,150,5,-74.8,-68,-84,16
26,LR,1,150,10,-76.8,-71,-85,14
26,LR,1,150,6,-76.8333333333333,-71,-85,14
26,LR,1,150,7,-75.1428571428571,-71,-85,14
26,LR,1,150,6,-75.8333333333333,-71,-85,14
26,LR,1,150,6,-73.3333333333333,-70,-79,9
26,LR,0,150,2,-74.5,-74,-75,1
26,LR,1,150,9,-74.7777777777778,-70,-80,10
26,LR,0,150,2,-74.5,-70,-79,9
26,LR,1,150,5,-74,-70,-80,10
26,LR,1,150,5,-76,-70,-80,10
26,LR,1,150,9,-77.1111111111111,-70,-82,12
26,LR,1,150,10,-76.9,-70,-82,12
26,LR,1,150,8,-77.125,-70,-82,12
26,LR,1,150,6,-78.1666666666667,-75,-82,7
26,LR,1,150,6,-77.8333333333333,-75,-82,7
26,LR,1,150,6,-75.6666666666667,-72,-78,6
26,LR,1,150,6,-75.1666666666667,-72,-78,6
26,LR,1,150,4,-74,-72,-77,5
26,LR,1,150,4,-74,-72,-77,5
26,LR,1,150,4,-72.75,-72,-75,3
26,LR,1,150,5,-75,-72,-79,7
26,LR,0,150,2,-73.5,-72,-75,3
26,LR,1,150,3,-77,-75,-79,4
26,LR,1,150,8,-74,-72,-77,5
26,LR,0,150,1,-79,-79,-79,0
26,LR,0,150,1,-83,-83,-83,0
26,LR,1,150,4,-78.5,-75,-83,8
31,RL,0,200,2,-78.5,-71,-86,15
31,RL,1,200,3,-84.3333333333333,-81,-86,5
31,RL,1,200,4,-82.25,-79,-86,7
31,RL,1,200,7,-80.4285714285714,-76,-83,7
31,RL,1,200,8,-78.75,-74,-83,9
31,RL,1,200,7,-78.7142857142857,-74,-83,9
31,RL,0,200,1,-83,-83,-83,0
31,RL,1,200,7,-77.1428571428571,-74,-82,8
31,RL,1,200,4,-76.5,-74,-82,8
31,RL,1,200,4,-75.75,-74,-79,5
31,RL,1,200,3,-76.3333333333333,-74,-79,5
31,RL,1,200,9,-76.7777777777778,-72,-94,22
31,RL,1,200,10,-76.4,-70,-94,24
31,RL,1,200,10,-76.3,-70,-94,24
31,RL,1,200,8,-76.25,-70,-94,24
31,RL,1,200,6,-77.3333333333333,-72,-94,22
31,RL,1,200,6,-73.3333333333333,-70,-79,9
31,RL,1,200,6,-74.3333333333333,-70,-79,9
31,RL,1,200,5,-74.4,-70,-79,9
31,RL,0,200,2,-76,-73,-79,6
31,RL,1,200,9,-76,-70,-83,13
31,RL,0,200,1,-70,-70,-70,0
31,RL,1,200,6,-77,-70,-83,13
31,RL,1,200,9,-76.2222222222222,-70,-83,13
31,RL,0,200,1,-77,-77,-77,0
31,RL,1,200,4,-74.5,-70,-83,13
31,RL,1,200,6,-74.1666666666667,-71,-80,9
31,RL,1,200,3,-76.3333333333333,-73,-80,7
31,RL,1,200,10,-74,-71,-76,5
31,RL,0,200,1,-72,-72,-72,0
31,RL,1,200,10,-74.9,-73,-76,3
31,RL,1,200,7,-75,-73,-76,3
31,RL,1,200,9,-75.7777777777778,-73,-78,5
31,RL,1,200,6,-75.6666666666667,-74,-76,2
31,RL,1,200,10,-77.4,-76,-80,4
31,RL,1,200,8,-77.75,-76,-80,4
31,RL,1,200,7,-78,-76,-80,4
31,RL,1,200,6,-78.3333333333333,-77,-80,3
31,RL,1,200,4,-78.25,-78,-79,1
31,RL,1,200,8,-80.75,-78,-92,14
31,RL,1,200,10,-81.6,-78,-92,14
31,RL,1,200,9,-82.3333333333333,-79,-92,13
31,RL,1,200,10,-82.6,-79,-92,13
31,RL,1,200,6,-83.5,-79,-92,13
31,RL,1,200,10,-82.2,-77,-92,15
31,RL,1,200,9,-81.1111111111111,-77,-85,8
31,RL,1,200,6,-82.3333333333333,-80,-85,5
31,RL,1,200,6,-80.3333333333333,-77,-85,8
31,RL,1,200,8,-81.875,-77,-85,8
31,RL,0,200,1,-85,-85,-85,0
31,RL,0,200,1,-81,-81,-81,0
31,RL,1,200,8,-82.75,-77,-86,9
31,RL,1,200,5,-83.6,-77,-86,9
31,RL,1,200,7,-83.1428571428571,-74,-86,12
31,RL,1,200,5,-80.2,-74,-86,12
31,RL,0,200,1,-86,-86,-86,0
31,RL,1,200,6,-80.1666666666667,-74,-91,17
31,RL,1,200,4,-77.25,-74,-84,10
31,RL,1,200,3,-78.3333333333333,-74,-84,10
31,RL,1,200,4,-84.75,-77,-92,15
31,RL,0,200,1,-91,-91,-91,0
31,RL,1,200,4,-86,-79,-94,15
31,RL,0,200,1,-79,-79,-79,0
31,RL,1,200,4,-86.5,-83,-94,11
31,RL,1,200,8,-84.625,-83,-87,4
31,RL,1,200,4,-84.25,-83,-87,4
31,RL,0,200,2,-85,-83,-87,4
31,RL,1,200,10,-84.1,-81,-87,6
31,RL,1,200,6,-84.8333333333333,-84,-86,2
31,RL,1,200,3,-84.6666666666667,-84,-86,2
31,RL,1,200,3,-84.3333333333333,-84,-85,1
31,RL,1,200,4,-84.25,-82,-86,4
31,RL,1,200,9,-83.1111111111111,-81,-86,5
31,RL,1,200,6,-82,-81,-84,3
31,RL,0,200,1,-82,-82,-82,0
31,RL,0,200,1,-81,-81,-81,0
31,RL,1,200,5,-82.8,-81,-85,4
31,RL,1,200,6,-82.6666666666667,-81,-85,4
31,RL,0,200,1,-84,-84,-84,0
31,RL,1,200,8,-82.5,-82,-83,1
31,RL,1,200,10,-82.7,-82,-83,1
31,RL,1,200,7,-82.7142857142857,-82,-83,1
31,RL,1,200,5,-82.8,-82,-83,1
31,RL,1,200,7,-82.8571428571429,-82,-84,2
31,RL,1,200,10,-82.5,-82,-84,2
31,RL,1,200,7,-82.5714285714286,-82,-84,2
31,RL,1,200,8,-82.375,-82,-84,2
31,RL,1,200,5,-82.4,-82,-84,2
31,RL,1,200,4,-82,-82,-82,0
31,RL,1,200,4,-82,-82,-82,0
31,RL,1,200,9,-81.5555555555556,-79,-83,4
31,RL,1,200,6,-82.3333333333333,-82,-83,1
31,RL,1,200,3,-82,-82,-82,0
31,RL,1,200,5,-81.8,-79,-83,4
31,RL,1,200,4,-81,-79,-83,4
31,RL,1,200,8,-81.25,-79,-84,5
31,RL,1,200,5,-80.4,-79,-82,3
31,RL,1,200,7,-81.5714285714286,-79,-84,5
31,RL,1,200,3,-81.3333333333333,-80,-82,2
31,RL,0,200,1,-82,-82,-82,0
31,RL,1,200,6,-82.6666666666667,-80,-84,4
31,RL,0,200,1,-81,-81,-81,0
31,RL,1,200,5,-83.6,-83,-84,1
31,RL,1,200,6,-83.1666666666667,-82,-84,2
31,RL,0,200,1,-84,-84,-84,0
31,RL,1,200,3,-82.6666666666667,-82,-83,1
31,RL,0,200,2,-83,-83,-83,0
31,RL,1,200,4,-82.5,-82,-83,1
31,RL,1,200,3,-82.3333333333333,-82,-83,1
31,RL,1,200,5,-82.2,-82,-83,1
31,RL,1,200,5,-81.6,-79,-83,4
31,RL,1,200,5,-81.8,-79,-83,4
31,RL,1,200,10,-81.6,-79,-84,5
31,RL,1,200,8,-81.75,-79,-84,5
31,RL,0,200,2,-81,-79,-83,4
31,RL,1,200,8,-81.75,-80,-85,5
31,RL,0,200,2,-84,-84,-84,0
31,RL,1,200,8,-82.625,-80,-85,5
31,RL,1,200,4,-82.5,-80,-85,5
31,RL,0,200,1,-80,-80,-80,0
31,RL,1,200,6,-82.5,-80,-85,5
31,RL,0,200,2,-82.5,-80,-85,5
31,RL,1,200,8,-82.125,-80,-85,5
31,RL,1,200,4,-81.25,-80,-85,5
31,RL,0,200,1,-80,-80,-80,0
31,RL,1,200,8,-81.125,-76,-84,8
31,RL,1,200,4,-82.25,-81,-84,3
31,RL,1,200,5,-82.2,-81,-84,3
31,RL,0,200,2,-81.5,-81,-82,1
31,RL,1,200,9,-78.1111111111111,-71,-83,12
31,RL,1,200,9,-77.2222222222222,-71,-83,12
31,RL,1,200,10,-75.7,-71,-81,10
31,RL,1,200,8,-75.25,-71,-80,9
31,RL,1,200,9,-74.8888888888889,-71,-80,9
31,RL,1,200,6,-73.3333333333333,-71,-76,5
31,RL,1,200,3,-73,-71,-74,3
31,RL,0,200,1,-74,-74,-74,0
31,RL,1,200,4,-73.25,-71,-74,3
31,RL,1,200,6,-72.3333333333333,-70,-74,4
31,RL,1,200,6,-72.1666666666667,-70,-74,4
31,RL,1,200,9,-72.1111111111111,-70,-76,6
31,RL,1,200,5,-72.4,-70,-76,6
31,RL,1,200,6,-72.1666666666667,-70,-76,6
31,RL,1,200,10,-72.9,-70,-79,9
31,RL,0,200,2,-73.5,-71,-76,5
31,RL,0,200,2,-71.5,-71,-72,1
31,RL,1,200,10,-73.8,-70,-79,9
31,RL,1,200,3,-73.6666666666667,-70,-79,9
31,RL,1,200,10,-74,-70,-79,9
31,RL,1,200,8,-74.375,-70,-79,9
31,RL,1,200,10,-73.2,-70,-76,6
31,RL,1,200,3,-75,-73,-76,3
31,RL,1,200,7,-73.2857142857143,-70,-76,6
31,RL,1,200,7,-72.4285714285714,-70,-75,5
31,RL,1,200,6,-72.3333333333333,-70,-75,5
31,RL,1,200,9,-72.5555555555556,-70,-77,7
31,RL,1,200,7,-72.8571428571429,-70,-77,7
31,RL,1,200,6,-73.3333333333333,-70,-77,7
31,RL,1,200,5,-72.8,-70,-77,7
31,RL,0,200,1,-70,-70,-70,0
31,RL,1,200,5,-75,-70,-81,11
31,RL,1,200,8,-73.375,-70,-81,11
31,RL,1,200,7,-73.8571428571429,-70,-81,11
31,RL,1,200,3,-76.6666666666667,-70,-81,11
31,RL,1,200,3,-74,-70,-79,9
31,RL,1,200,7,-73.4285714285714,-71,-79,8
31,RL,0,200,1,-73,-73,-73,0
31,RL,0,200,2,-72,-71,-73,2
31,RL,1,200,8,-71.75,-70,-75,5
31,RL,1,200,6,-72.1666666666667,-71,-75,4
31,RL,1,200,3,-73,-72,-75,3
31,RL,1,200,5,-71.4,-70,-72,2
31,RL,1,200,5,-72,-70,-75,5
31,RL,1,200,8,-72,-70,-75,5
31,RL,1,200,10,-72,-70,-75,5
31,RL,1,200,8,-72,-70,-75,5
31,RL,0,200,2,-70.5,-70,-71,1
31,RL,1,200,5,-72.8,-72,-76,4
31,RL,1,200,9,-72.2222222222222,-70,-76,6
31,RL,1,200,8,-72.25,-70,-76,6
31,RL,0,200,1,-72,-72,-72,0
31,RL,1,200,5,-72.4,-70,-76,6
31,RL,1,200,9,-71,-70,-76,6
31,RL,1,200,9,-70.4444444444444,-70,-72,2
31,RL,0,200,2,-71,-70,-72,2
31,RL,0,200,2,-70,-70,-70,0
31,RL,1,200,5,-70.4,-70,-71,1
31,RL,0,200,1,-71,-71,-71,0
31,RL,1,200,3,-70,-70,-70,0
31,RL,1,200,8,-71.25,-70,-73,3
31,RL,0,200,2,-70.5,-70,-71,1
31,RL,1,200,5,-72,-71,-73,2
31,RL,1,200,10,-72.1,-70,-77,7
31,RL,1,200,4,-71.25,-70,-72,2
31,RL,1,200,10,-72.1,-70,-77,7
31,RL,1,200,4,-71.75,-70,-77,7
31,RL,0,200,2,-73.5,-70,-77,7
31,RL,1,200,5,-72.4,-70,-75,5
31,RL,0,200,2,-71,-70,-72,2
31,RL,1,200,4,-73,-70,-75,5
31,RL,1,200,9,-72.8888888888889,-70,-75,5
31,RL,1,200,3,-72,-70,-75,5
31,RL,0,200,1,-70,-70,-70,0
31,RL,1,200,4,-72.5,-71,-75,4
31,RL,0,200,1,-72,-72,-72,0
31,RL,1,200,4,-73.25,-72,-75,3
31,RL,0,200,1,-74,-74,-74,0
31,RL,1,200,10,-72.2,-70,-75,5
31,RL,1,200,6,-72.6666666666667,-71,-75,4
31,RL,1,200,8,-72.25,-70,-75,5
31,RL,1,200,8,-72.125,-70,-75,5
31,RL,0,200,1,-74,-74,-74,0
31,RL,1,200,8,-72.375,-70,-76,6
31,RL,1,200,10,-72.3,-70,-76,6
31,RL,0,200,1,-72,-72,-72,0
31,RL,1,200,6,-72.6666666666667,-70,-76,6
31,RL,1,200,10,-72.6,-71,-76,5
31,RL,1,200,10,-73,-71,-76,5
31,RL,0,200,1,-75,-75,-75,0
31,RL,1,200,4,-71.5,-71,-72,1
31,RL,1,200,5,-72,-71,-74,3
31,RL,1,200,9,-72.5555555555556,-71,-75,4
31,RL,1,200,5,-72.8,-71,-75,4
31,RL,1,200,10,-72.8,-70,-75,5
31,RL,0,200,1,-72,-72,-72,0
31,RL,0,200,2,-74.5,-74,-75,1
31,RL,0,200,2,-73,-72,-74,2
31,RL,1,200,5,-71.4,-70,-75,5
31,RL,1,200,8,-71.875,-70,-75,5
31,RL,1,200,9,-71.7777777777778,-70,-73,3
31,RL,0,200,2,-70,-70,-70,0
31,RL,1,200,7,-72.2857142857143,-71,-73,2
31,RL,1,200,6,-72.3333333333333,-71,-73,2
31,RL,1,200,10,-72.5,-71,-75,4
31,RL,1,200,5,-72.6,-72,-73,1
31,RL,1,200,7,-72.8571428571429,-72,-75,3
31,RL,1,200,5,-72.8,-72,-75,3
31,RL,1,200,7,-72.5714285714286,-71,-75,4
31,RL,0,200,2,-73.5,-72,-75,3
31,RL,1,200,10,-72.6,-70,-77,7
31,RL,1,200,9,-72.6666666666667,-70,-77,7
31,RL,1,200,9,-72.4444444444444,-70,-77,7
31,RL,1,200,8,-72.375,-70,-75,5
31,RL,0,200,1,-71,-71,-71,0
31,RL,0,200,1,-72,-72,-72,0
31,RL,1,200,6,-73.1666666666667,-71,-75,4
31,RL,1,200,4,-73.5,-71,-75,4
31,RL,1,200,4,-73,-71,-75,4
31,RL,1,200,3,-73.6666666666667,-73,-75,2
31,RL,1,200,3,-72.6666666666667,-72,-73,1
31,RL,0,200,2,-72.5,-72,-73,1
31,RL,0,200,2,-72,-72,-72,0
31,RL,1,200,6,-73.8333333333333,-72,-76,4
31,RL,1,200,6,-74,-72,-76,4
31,RL,1,200,8,-74,-72,-76,4
31,RL,0,200,2,-74,-72,-76,4
31,RL,0,200,2,-76,-76,-76,0
31,RL,1,200,10,-73.3,-72,-75,3
31,RL,0,200,1,-72,-72,-72,0
31,RL,1,200,3,-73.6666666666667,-73,-75,2
31,RL,1,200,7,-73.2857142857143,-73,-75,2
31,RL,1,200,10,-73.3,-72,-75,3
31,RL,1,200,3,-73,-73,-73,0
31,RL,1,200,9,-73.3333333333333,-72,-75,3
31,RL,1,200,9,-73.5555555555556,-72,-75,3
31,RL,1,200,7,-73.4285714285714,-72,-75,3
31,RL,0,200,2,-74,-73,-75,2
31,RL,1,200,4,-73,-72,-75,3
31,RL,1,200,5,-73.4,-72,-75,3
31,RL,1,200,7,-73.2857142857143,-72,-75,3
31,RL,1,200,6,-73.8333333333333,-72,-75,3
31,RL,1,200,3,-74.6666666666667,-74,-75,1
31,RL,1,200,6,-73.1666666666667,-72,-75,3
31,RL,1,200,8,-73.125,-72,-75,3
31,RL,1,200,6,-72.6666666666667,-72,-74,2
31,RL,1,200,10,-73.2,-72,-76,4
31,RL,1,200,8,-73,-72,-76,4
31,RL,1,200,3,-73.3333333333333,-73,-74,1
31,RL,1,200,10,-73.3,-72,-76,4
31,RL,1,200,4,-72.5,-72,-74,2
31,RL,1,200,9,-73.6666666666667,-72,-77,5
31,RL,1,200,8,-74.25,-72,-77,5
31,RL,0,200,1,-76,-76,-76,0
31,RL,1,200,5,-74,-72,-77,5
31,RL,1,200,8,-74.25,-72,-77,5
31,RL,1,200,4,-75.25,-74,-77,3
31,RL,1,200,9,-74.6666666666667,-73,-77,4
31,RL,0,200,2,-75,-75,-75,0
31,RL,1,200,8,-74.375,-73,-76,3
31,RL,1,200,6,-74.1666666666667,-73,-76,3
31,RL,1,200,6,-74.1666666666667,-73,-76,3
31,RL,1,200,6,-74,-72,-76,4
31,RL,1,200,8,-74.5,-72,-79,7
31,RL,1,200,7,-74.7142857142857,-72,-79,7
31,RL,0,200,2,-73.5,-72,-75,3
31,RL,1,200,5,-75.2,-72,-79,7
31,RL,1,200,3,-77.3333333333333,-74,-79,5
31,RL,1,200,5,-74.4,-71,-79,8
31,RL,1,200,3,-74,-72,-78,6
31,RL,0,200,1,-72,-72,-72,0
31,RL,1,200,7,-73.5714285714286,-70,-78,8
31,RL,0,200,1,-70,-70,-70,0
31,RL,1,200,8,-75.5,-70,-78,8
31,RL,1,200,6,-76,-73,-78,5
31,RL,1,200,10,-78.6,-76,-81,5
31,RL,0,200,2,-77,-76,-78,2
31,RL,1,200,4,-77.75,-76,-79,3
31,RL,1,200,8,-79.125,-78,-81,3
31,RL,1,200,8,-79,-78,-81,3
31,RL,0,200,1,-79,-79,-79,0
31,RL,1,200,9,-79,-77,-81,4
31,RL,1,200,10,-78.5,-77,-80,3
31,RL,1,200,5,-78.6,-78,-80,2
31,RL,1,200,8,-78.375,-77,-80,3
31,RL,0,200,1,-78,-78,-78,0
31,RL,1,200,9,-78.5555555555556,-77,-80,3
31,RL,0,200,1,-77,-77,-77,0
31,RL,1,200,10,-77.8,-77,-80,3
31,RL,1,200,7,-78.1428571428571,-77,-80,3
31,RL,0,200,2,-78,-78,-78,0
31,RL,1,200,4,-78,-77,-80,3
31,RL,1,200,7,-77.4285714285714,-77,-80,3
31,RL,1,200,7,-77,-77,-77,0
31,RL,1,200,9,-76.3333333333333,-72,-77,5
31,RL,1,200,5,-77,-77,-77,0
31,RL,1,200,6,-76.8333333333333,-76,-77,1
31,RL,0,200,1,-77,-77,-77,0
31,RL,1,200,10,-75.9,-72,-83,11
31,RL,0,200,1,-77,-77,-77,0
31,RL,1,200,7,-75.5714285714286,-74,-83,9
31,RL,1,200,6,-75.8333333333333,-74,-83,9
31,RL,1,200,8,-77.625,-74,-86,12
31,RL,0,200,2,-78.5,-74,-83,9
31,RL,1,200,3,-77.3333333333333,-74,-83,9
31,RL,1,200,10,-78.4,-74,-86,12
31,RL,1,200,10,-78.4,-74,-86,12
31,RL,1,200,7,-78.4285714285714,-75,-86,11
31,RL,0,200,1,-79,-79,-79,0
31,RL,0,200,2,-75.5,-75,-76,1
31,RL,1,200,3,-75.6666666666667,-75,-77,2
31,RL,1,200,7,-77.8571428571429,-74,-86,12
31,RL,1,200,7,-78.1428571428571,-74,-86,12
31,RL,0,200,2,-83.5,-81,-86,5
31,RL,1,200,8,-76.75,-74,-79,5
31,RL,1,200,8,-77.75,-77,-79,2
31,RL,1,200,5,-78,-77,-79,2
31,RL,0,200,1,-78,-78,-78,0
31,RL,0,200,1,-79,-79,-79,0
31,RL,0,200,1,-79,-79,-79,0
31,RL,0,200,2,-77.5,-77,-78,1
31,RL,1,200,7,-78,-77,-80,3
31,RL,0,200,2,-77.5,-77,-78,1
31,RL,1,200,10,-78,-77,-80,3
31,RL,0,200,2,-77.5,-77,-78,1
31,RL,1,200,3,-78.3333333333333,-77,-80,3
31,RL,0,200,1,-77,-77,-77,0
31,RL,1,200,8,-77.5,-75,-79,4
31,RL,1,200,10,-76.8,-74,-79,5
31,RL,1,200,4,-78,-77,-79,2
31,RL,1,200,5,-77.4,-75,-79,4
31,RL,1,200,9,-76.3333333333333,-74,-79,5
31,RL,1,200,10,-76,-74,-78,4
31,RL,1,200,9,-75.7777777777778,-74,-78,4
31,RL,1,200,3,-75.6666666666667,-74,-78,4
31,RL,1,200,9,-75.7777777777778,-74,-78,4
31,RL,1,200,10,-75.8,-74,-78,4
31,RL,1,200,3,-75.3333333333333,-74,-78,4
31,RL,1,200,8,-76.25,-74,-78,4
31,RL,1,200,3,-76.6666666666667,-76,-78,2
31,RL,0,200,2,-76,-76,-76,0
31,RL,1,200,3,-76,-74,-78,4
31,RL,1,200,3,-76,-74,-79,5
31,RL,1,200,4,-75,-73,-79,6
31,RL,1,200,8,-75.125,-73,-78,5
31,RL,1,200,5,-75.2,-73,-78,5
31,RL,1,200,3,-76.3333333333333,-73,-78,5
31,RL,1,200,7,-75.7142857142857,-74,-78,4
31,RL,0,200,2,-74,-74,-74,0
31,RL,1,200,8,-75.75,-74,-79,5
31,RL,0,200,2,-76,-74,-78,4
31,RL,0,200,1,-78,-78,-78,0
31,RL,1,200,10,-75.9,-74,-79,5
31,RL,1,200,7,-76.4285714285714,-74,-79,5
31,RL,1,200,3,-76,-74,-79,5
31,RL,1,200,3,-77.6666666666667,-75,-79,4
31,RL,1,200,8,-75.625,-74,-79,5
31,RL,1,200,8,-75.25,-74,-79,5
31,RL,1,200,10,-76.3,-74,-80,6
31,RL,1,200,4,-74.75,-74,-76,2
31,RL,1,200,5,-75.6,-74,-79,5
31,RL,1,200,3,-76.3333333333333,-74,-79,5
31,RL,1,200,8,-76.875,-74,-80,6
31,RL,1,200,3,-78.3333333333333,-75,-80,5
31,RL,1,200,9,-76,-74,-80,6
31,RL,1,200,9,-75.8888888888889,-74,-80,6
31,RL,1,200,4,-74.75,-74,-76,2
31,RL,1,200,4,-76,-74,-80,6
31,RL,1,200,9,-75.8888888888889,-74,-80,6
31,RL,1,200,10,-75.9,-74,-80,6
31,RL,0,200,2,-80,-80,-80,0
31,RL,1,200,10,-75.6,-74,-80,6
31,RL,1,200,8,-75.25,-74,-77,3
31,RL,1,200,9,-76.4444444444444,-74,-80,6
31,RL,1,200,6,-75.6666666666667,-74,-77,3
31,RL,1,200,7,-76.7142857142857,-74,-80,6
31,RL,1,200,7,-77.4285714285714,-74,-80,6
31,RL,1,200,10,-77.9,-74,-80,6
31,RL,1,200,9,-78,-74,-80,6
31,RL,1,200,10,-77.4,-75,-80,5
31,RL,1,200,4,-77,-75,-79,4
31,RL,1,200,7,-77,-75,-80,5
31,RL,1,200,6,-76.8333333333333,-75,-80,5
31,RL,0,200,2,-80,-80,-80,0
31,RL,1,200,7,-77.4285714285714,-75,-80,5
31,RL,1,200,8,-77.125,-75,-80,5
31,RL,1,200,6,-77.1666666666667,-75,-80,5
31,RL,0,200,1,-80,-80,-80,0
31,RL,1,200,3,-77,-76,-79,3
31,RL,1,200,9,-77.5555555555556,-75,-80,5
31,RL,1,200,10,-77,-75,-80,5
31,RL,1,200,4,-77.5,-75,-80,5
31,RL,1,200,10,-77.5,-75,-80,5
31,RL,1,200,6,-77.3333333333333,-75,-80,5
31,RL,1,200,6,-77.1666666666667,-75,-80,5
31,RL,1,200,9,-76.4444444444444,-74,-79,5
31,RL,1,200,5,-77,-75,-79,4
31,RL,0,200,2,-78,-77,-79,2
31,RL,1,200,6,-77,-74,-79,5
31,RL,1,200,6,-76.3333333333333,-74,-79,5
31,RL,1,200,9,-75.6666666666667,-74,-78,4
31,RL,1,200,6,-76.1666666666667,-74,-78,4
31,RL,1,200,4,-76.5,-75,-78,3
31,RL,1,200,3,-76,-75,-78,3
31,RL,0,200,2,-76.5,-75,-78,3
31,RL,1,200,6,-76.5,-75,-78,3
31,RL,1,200,10,-76.4,-75,-79,4
31,RL,1,200,4,-76.5,-76,-78,2
31,RL,0,200,1,-76,-76,-76,0
31,RL,1,200,10,-76.5,-74,-80,6
31,RL,1,200,7,-77.2857142857143,-75,-80,5
31,RL,1,200,5,-77.2,-75,-80,5
31,RL,1,200,9,-76.4444444444444,-74,-80,6
31,RL,0,200,2,-80,-80,-80,0
31,RL,1,200,10,-75.7,-74,-80,6
31,RL,1,200,3,-74.6666666666667,-74,-75,1
31,RL,1,200,4,-77.5,-75,-80,5
31,RL,1,200,5,-77,-75,-80,5
31,RL,1,200,4,-77.5,-75,-80,5
31,RL,1,200,4,-76,-74,-80,6
31,RL,1,200,4,-74.75,-74,-75,1
31,RL,0,200,1,-75,-75,-75,0
31,RL,1,200,5,-75.6,-74,-79,5
31,RL,1,200,6,-76,-75,-80,5
31,RL,0,200,2,-75,-75,-75,0
31,RL,1,200,5,-76.8,-75,-80,5
31,RL,1,200,4,-76,-75,-78,3
31,RL,1,200,5,-75.6,-75,-78,3
31,RL,0,200,1,-78,-78,-78,0
31,RL,1,200,8,-75.5,-74,-78,4
31,RL,1,200,3,-74.6666666666667,-74,-75,1
31,RL,0,200,2,-74.5,-74,-75,1
31,RL,1,200,4,-76,-74,-78,4
31,RL,1,200,6,-76,-74,-78,4
31,RL,1,200,5,-76,-75,-78,3
31,RL,0,200,1,-75,-75,-75,0
31,RL,1,200,10,-75.8,-74,-79,5
31,RL,1,200,9,-75.8888888888889,-74,-79,5
31,RL,1,200,4,-76.75,-76,-79,3
31,RL,0,200,2,-76,-76,-76,0
31,RL,1,200,10,-76.8,-75,-80,5
31,RL,1,200,3,-75.3333333333333,-75,-76,1
31,RL,1,200,7,-76.7142857142857,-75,-80,5
31,RL,1,200,3,-75.6666666666667,-75,-76,1
31,RL,0,200,2,-76,-76,-76,0
31,RL,0,200,1,-76,-76,-76,0
31,RL,1,200,4,-77.25,-75,-80,5
31,RL,1,200,3,-76.3333333333333,-75,-79,4
31,RL,0,200,2,-74.5,-74,-75,1
31,RL,1,200,6,-76.1666666666667,-74,-79,5
31,RL,1,200,6,-77,-75,-79,4
31,RL,1,200,5,-76.6,-75,-79,4
31,RL,1,200,3,-76.3333333333333,-75,-79,4
31,RL,1,200,3,-77.3333333333333,-74,-79,5
31,RL,1,200,4,-77.25,-74,-80,6
31,RL,1,200,8,-77.75,-74,-81,7
31,RL,1,200,6,-77.1666666666667,-74,-81,7
31,RL,1,200,7,-76.7142857142857,-74,-81,7
31,RL,1,200,8,-76.25,-74,-80,6
31,RL,1,200,5,-76.4,-74,-80,6
31,RL,1,200,7,-76.2857142857143,-74,-80,6
31,RL,1,200,9,-76.3333333333333,-72,-80,8
31,RL,0,200,2,-75,-75,-75,0
31,RL,1,200,6,-76.1666666666667,-72,-78,6
31,RL,0,200,2,-76.5,-76,-77,1
31,RL,1,200,9,-76.2222222222222,-74,-78,4
31,RL,1,200,6,-76.1666666666667,-74,-77,3
31,RL,1,200,7,-76,-74,-77,3
31,RL,1,200,3,-76,-74,-77,3
31,RL,1,200,8,-76.375,-74,-81,7
31,RL,1,200,4,-75.5,-74,-77,3
31,RL,1,200,8,-76.75,-74,-81,7
31,RL,1,200,8,-77.5,-74,-81,7
31,RL,0,200,1,-77,-77,-77,0
31,RL,1,200,6,-79,-74,-81,7
31,RL,1,200,3,-78,-74,-80,6
31,RL,1,200,8,-78.5,-74,-80,6
31,RL,0,200,1,-80,-80,-80,0
31,RL,1,200,5,-77.6,-74,-79,5
31,RL,1,200,5,-77.4,-74,-79,5
31,RL,1,200,9,-76.3333333333333,-74,-79,5
31,RL,0,200,1,-79,-79,-79,0
31,RL,1,200,7,-76.4285714285714,-74,-79,5
31,RL,1,200,8,-76.5,-74,-79,5
31,RL,0,200,1,-77,-77,-77,0
31,RL,1,200,10,-76.7,-74,-79,5
31,RL,1,200,8,-76.75,-74,-79,5
31,RL,1,200,3,-77.3333333333333,-74,-79,5
31,RL,1,200,8,-77.875,-74,-80,6
31,RL,1,200,4,-77.5,-74,-79,5
31,RL,1,200,9,-78.5555555555556,-74,-80,6
31,RL,1,200,6,-79.1666666666667,-77,-80,3
31,RL,0,200,2,-78,-77,-79,2
31,RL,1,200,8,-77.875,-74,-80,6
31,RL,0,200,1,-80,-80,-80,0
31,RL,1,200,10,-78.7,-74,-81,7
31,RL,1,200,3,-79.3333333333333,-78,-80,2
31,RL,1,200,7,-78.1428571428571,-74,-81,7
31,RL,1,200,7,-78.1428571428571,-74,-81,7
31,RL,0,200,2,-77.5,-74,-81,7
31,RL,1,200,7,-77,-73,-80,7
31,RL,1,200,3,-77.6666666666667,-73,-80,7
31,RL,1,200,6,-75.1666666666667,-73,-79,6
31,RL,1,200,10,-75.6,-73,-80,7
31,RL,1,200,7,-76.2857142857143,-73,-80,7
31,RL,1,200,9,-76.2222222222222,-73,-80,7
31,RL,1,200,8,-76.625,-73,-80,7
31,RL,1,200,7,-76.2857142857143,-73,-80,7
31,RL,1,200,4,-75.5,-73,-80,7
31,RL,1,200,5,-76.4,-73,-80,7
31,RL,0,200,1,-73,-73,-73,0
31,RL,1,200,3,-76.3333333333333,-73,-78,5
31,RL,0,200,1,-78,-78,-78,0
31,RL,1,200,10,-76.7,-73,-79,6
31,RL,1,200,10,-76.8,-73,-79,6
31,RL,0,200,2,-78.5,-78,-79,1
31,RL,0,200,1,-78,-78,-78,0
31,RL,1,200,9,-76.6666666666667,-73,-79,6
31,RL,1,200,7,-76.4285714285714,-73,-79,6
31,RL,1,200,6,-76.6666666666667,-73,-79,6
31,RL,1,200,10,-76.5,-73,-79,6
31,RL,1,200,10,-76.8,-73,-79,6
31,RL,0,200,2,-76,-73,-79,6
31,RL,1,200,6,-76.8333333333333,-74,-78,4
31,RL,1,200,7,-77.4285714285714,-74,-80,6
31,RL,1,200,9,-77.8888888888889,-77,-80,3
31,RL,0,200,1,-77,-77,-77,0
31,RL,1,200,10,-77.4,-76,-80,4
31,RL,1,200,9,-76.8888888888889,-76,-78,2
31,RL,1,200,6,-76.8333333333333,-76,-78,2
31,RL,1,200,10,-76.9,-76,-78,2
31,RL,1,200,8,-76.625,-76,-77,1
31,RL,1,200,7,-76.8571428571429,-76,-77,1
31,RL,0,200,1,-77,-77,-77,0
31,RL,1,200,9,-76.5555555555556,-73,-80,7
31,RL,1,200,4,-77,-77,-77,0
31,RL,0,200,1,-77,-77,-77,0
31,RL,0,200,1,-77,-77,-77,0
31,RL,1,200,7,-77.2857142857143,-73,-80,7
31,RL,1,200,4,-76,-73,-80,7
31,RL,1,200,10,-75.9,-73,-80,7
31,RL,1,200,10,-75.9,-73,-80,7
31,RL,1,200,4,-78.25,-73,-80,7
31,RL,0,200,1,-80,-80,-80,0
31,RL,1,200,8,-74.125,-72,-80,8
31,RL,1,200,5,-73.6,-73,-76,3
31,RL,0,200,1,-73,-73,-73,0
31,RL,1,200,3,-74,-73,-76,3
31,RL,1,200,5,-73.4,-72,-76,4
31,RL,0,200,2,-72.5,-72,-73,1
31,RL,0,200,2,-72.5,-72,-73,1
31,RL,1,200,7,-74.2857142857143,-73,-76,3
31,RL,1,200,6,-74.5,-73,-76,3
31,RL,0,200,2,-73,-73,-73,0
31,RL,1,200,8,-75.25,-73,-79,6
31,RL,1,200,3,-75,-73,-76,3
31,RL,1,200,3,-75,-73,-76,3
31,RL,1,200,4,-75.25,-73,-76,3
31,RL,1,200,9,-76.8888888888889,-73,-79,6
31,RL,1,200,9,-77.1111111111111,-73,-79,6
31,RL,1,200,5,-76.8,-73,-79,6
31,RL,1,200,5,-77.8,-76,-79,3
31,RL,1,200,5,-77.6,-76,-79,3
31,RL,0,200,2,-76.5,-76,-77,1
31,RL,1,200,6,-76.3333333333333,-73,-78,5
31,RL,1,200,8,-75.625,-73,-78,5
31,RL,1,200,3,-76,-73,-78,5
31,RL,1,200,7,-75.7142857142857,-74,-77,3
31,RL,1,200,5,-75.8,-74,-77,3
31,RL,0,200,2,-75.5,-74,-77,3
31,RL,1,200,6,-76,-74,-77,3
31,RL,1,200,5,-75.8,-74,-77,3
31,RL,0,200,1,-74,-74,-74,0
31,RL,1,200,6,-76.5,-75,-78,3
31,RL,1,200,7,-76.2857142857143,-75,-78,3
31,RL,1,200,8,-78.625,-75,-87,12
31,RL,1,200,9,-82.3333333333333,-75,-94,19
31,RL,1,200,6,-79.1666666666667,-75,-87,12
31,RL,1,200,4,-78.25,-75,-87,12
31,RL,1,200,8,-76.125,-74,-78,4
31,RL,0,200,1,-75,-75,-75,0
31,RL,1,200,3,-88.3333333333333,-84,-94,10
31,RL,1,200,10,-78.1,-75,-87,12
31,RL,1,200,6,-81.8333333333333,-75,-94,19
31,RL,1,200,5,-87.4,-78,-94,16
31,RL,1,200,5,-85.6,-78,-94,16
31,LR,1,200,3,-84.6666666666667,-74,-98,24
31,LR,1,200,7,-87.1428571428571,-82,-98,16
31,LR,1,200,3,-90,-82,-98,16
31,LR,1,200,7,-84.5714285714286,-81,-91,10
31,LR,1,200,4,-87,-83,-91,8
31,LR,1,200,8,-80.5,-73,-91,18
31,LR,1,200,9,-79.3333333333333,-73,-91,18
31,LR,1,200,5,-78.8,-73,-83,10
31,LR,1,200,7,-77.1428571428571,-73,-81,8
31,LR,1,200,3,-76.6666666666667,-73,-81,8
31,LR,1,200,3,-74.6666666666667,-73,-76,3
31,LR,1,200,7,-77.4285714285714,-75,-82,7
31,LR,1,200,6,-77.6666666666667,-75,-82,7
31,LR,1,200,6,-78.3333333333333,-76,-82,6
31,LR,1,200,3,-77,-76,-78,2
31,LR,0,200,2,-77.5,-77,-78,1
31,LR,1,200,6,-79.8333333333333,-78,-82,4
31,LR,1,200,3,-81,-79,-82,3
31,LR,1,200,7,-78.8571428571429,-76,-82,6
31,LR,0,200,1,-82,-82,-82,0
31,LR,1,200,7,-77.8571428571429,-76,-80,4
31,LR,1,200,5,-77.4,-76,-80,4
31,LR,1,200,3,-77.6666666666667,-76,-80,4
31,LR,1,200,3,-76.6666666666667,-76,-77,1
31,LR,1,200,9,-78.3333333333333,-77,-81,4
31,LR,1,200,6,-78.1666666666667,-77,-81,4
31,LR,1,200,6,-78.6666666666667,-77,-81,4
31,LR,1,200,3,-78.6666666666667,-77,-81,4
31,LR,1,200,9,-78.2222222222222,-75,-81,6
31,LR,1,200,7,-78.5714285714286,-75,-81,6
31,LR,1,200,8,-77.875,-75,-80,5
31,LR,0,200,2,-79.5,-79,-80,1
31,LR,0,200,2,-79.5,-79,-80,1
31,LR,1,200,6,-77.1666666666667,-75,-80,5
31,LR,1,200,9,-76.2222222222222,-73,-81,8
31,LR,1,200,6,-76,-73,-77,4
31,LR,1,200,8,-76.125,-73,-81,8
31,LR,0,200,2,-77,-77,-77,0
31,LR,0,200,2,-75,-73,-77,4
31,LR,1,200,10,-76.1,-72,-82,10
31,LR,1,200,7,-76.8571428571429,-74,-82,8
31,LR,1,200,9,-76.3333333333333,-72,-82,10
31,LR,1,200,9,-75,-72,-82,10
31,LR,1,200,7,-72.8571428571429,-72,-74,2
31,LR,0,200,1,-74,-74,-74,0
31,LR,1,200,9,-72.8888888888889,-72,-74,2
31,LR,0,200,2,-72.5,-72,-73,1
31,LR,1,200,5,-72.6,-72,-73,1
31,LR,1,200,6,-73.1666666666667,-72,-75,3
31,LR,1,200,4,-73.75,-72,-75,3
31,LR,1,200,3,-74.3333333333333,-74,-75,1
31,LR,1,200,6,-73.5,-72,-76,4
31,LR,1,200,5,-73.4,-72,-76,4
31,LR,1,200,9,-73.1111111111111,-72,-76,4
31,LR,1,200,4,-73.75,-72,-76,4
31,LR,1,200,10,-73.6,-72,-76,4
31,LR,1,200,6,-73,-72,-75,3
31,LR,1,200,5,-73.2,-72,-75,3
31,LR,1,200,8,-73.125,-72,-75,3
31,LR,0,200,2,-73.5,-73,-74,1
31,LR,1,200,9,-73.6666666666667,-70,-78,8
31,LR,1,200,7,-74.1428571428571,-72,-78,6
31,LR,0,200,2,-74,-73,-75,2
31,LR,1,200,7,-74.2857142857143,-70,-78,8
31,LR,1,200,9,-75.5555555555556,-70,-80,10
31,LR,1,200,6,-75,-70,-78,8
31,LR,1,200,6,-76.3333333333333,-70,-80,10
31,LR,1,200,3,-74.3333333333333,-70,-78,8
31,LR,1,200,9,-75,-70,-80,10
31,LR,1,200,8,-75.625,-72,-80,8
31,LR,1,200,3,-77.6666666666667,-76,-80,4
31,LR,1,200,6,-74.3333333333333,-72,-76,4
31,LR,1,200,9,-74.1111111111111,-72,-76,4
31,LR,1,200,3,-74,-73,-75,2
31,LR,0,200,1,-74,-74,-74,0
31,LR,1,200,3,-75,-74,-76,2
31,LR,0,200,1,-74,-74,-74,0
31,LR,1,200,10,-74.2,-72,-75,3
31,LR,1,200,5,-74.4,-73,-75,2
31,LR,1,200,5,-74.6,-74,-75,1
31,LR,1,200,3,-73.3333333333333,-72,-74,2
31,LR,1,200,7,-74.2857142857143,-72,-76,4
31,LR,1,200,3,-74.6666666666667,-74,-75,1
31,LR,1,200,4,-74.75,-74,-76,2
31,LR,1,200,6,-75.1666666666667,-74,-76,2
31,LR,0,200,1,-76,-76,-76,0
31,LR,1,200,8,-74.5,-73,-76,3
31,LR,1,200,4,-74.75,-73,-76,3
31,LR,1,200,10,-74.5,-73,-76,3
31,LR,1,200,7,-74.4285714285714,-73,-76,3
31,LR,1,200,6,-74.1666666666667,-73,-75,2
31,LR,1,200,7,-74.4285714285714,-74,-75,1
31,LR,0,200,1,-74,-74,-74,0
31,LR,0,200,1,-74,-74,-74,0
31,LR,0,200,2,-74.5,-74,-75,1
31,LR,1,200,6,-74.3333333333333,-73,-75,2
31,LR,0,200,2,-74,-73,-75,2
31,LR,1,200,4,-76.5,-72,-81,9
31,LR,1,200,4,-76.25,-72,-81,9
31,LR,1,200,5,-77,-71,-81,10
31,LR,1,200,9,-77.5555555555556,-71,-81,10
31,LR,1,200,4,-75.5,-71,-81,10
31,LR,1,200,7,-77.5714285714286,-71,-81,10
31,LR,1,200,10,-80.1,-72,-93,21
31,LR,1,200,8,-80.5,-72,-93,21
31,LR,1,200,4,-78.5,-72,-92,20
31,LR,0,200,2,-82,-72,-92,20
31,LR,0,200,2,-82,-72,-92,20
31,LR,1,200,10,-75.2,-69,-93,24
31,LR,1,200,4,-76.25,-74,-81,7
31,LR,1,200,10,-72.2,-69,-75,6
31,LR,1,200,10,-71.8,-69,-75,6
31,LR,1,200,10,-71.6,-69,-75,6
31,LR,1,200,5,-70.8,-69,-72,3
31,LR,1,200,9,-71.7777777777778,-69,-77,8
31,LR,0,200,1,-72,-72,-72,0
31,LR,1,200,3,-71.3333333333333,-70,-72,2
31,LR,1,200,9,-73.3333333333333,-70,-77,7
31,LR,1,200,7,-73.8571428571429,-71,-77,6
31,LR,1,200,9,-73.3333333333333,-70,-77,7
31,LR,1,200,7,-73,-70,-76,6
31,LR,1,200,5,-72.4,-70,-76,6
31,LR,1,200,7,-71.8571428571429,-70,-73,3
31,LR,0,200,2,-71,-70,-72,2
31,LR,1,200,9,-71.7777777777778,-70,-73,3
31,LR,1,200,6,-72,-70,-73,3
31,LR,1,200,8,-71.875,-70,-73,3
31,LR,1,200,6,-72,-70,-73,3
31,LR,1,200,4,-71.75,-71,-72,1
31,LR,0,200,2,-72,-72,-72,0
31,LR,1,200,8,-71.75,-70,-73,3
31,LR,1,200,7,-71.7142857142857,-70,-73,3
31,LR,1,200,7,-72.4285714285714,-70,-75,5
31,LR,1,200,6,-72.5,-70,-75,5
31,LR,1,200,10,-72.6,-71,-75,4
31,LR,1,200,10,-72.4,-71,-75,4
31,LR,1,200,7,-72.7142857142857,-71,-75,4
31,LR,1,200,8,-72.125,-71,-73,2
31,LR,1,200,6,-72.1666666666667,-71,-73,2
31,LR,1,200,10,-72.3,-71,-73,2
31,LR,1,200,7,-72.2857142857143,-71,-73,2
31,LR,1,200,8,-72.5,-71,-73,2
31,LR,0,200,2,-72.5,-72,-73,1
31,LR,1,200,5,-72.4,-71,-73,2
31,LR,1,200,10,-72.6,-71,-74,3
31,LR,1,200,4,-72.75,-72,-73,1
31,LR,1,200,4,-72.75,-72,-73,1
31,LR,1,200,9,-73.2222222222222,-72,-75,3
31,LR,1,200,9,-73.3333333333333,-72,-75,3
31,LR,1,200,7,-73.4285714285714,-72,-75,3
31,LR,1,200,10,-73.3,-70,-75,5
31,LR,0,200,2,-75,-75,-75,0
31,LR,1,200,8,-72.75,-70,-75,5
31,LR,1,200,3,-71.3333333333333,-70,-72,2
31,LR,1,200,9,-72.5555555555556,-70,-75,5
31,LR,0,200,2,-74,-74,-74,0
31,LR,0,200,2,-74.5,-74,-75,1
31,LR,1,200,6,-72.1666666666667,-70,-75,5
31,LR,1,200,9,-72,-70,-74,4
31,LR,1,200,6,-71.8333333333333,-70,-73,3
31,LR,1,200,10,-72.2,-70,-74,4
31,LR,0,200,2,-71,-70,-72,2
31,LR,1,200,3,-72,-71,-73,2
31,LR,1,200,4,-72.75,-71,-74,3
31,LR,0,200,2,-73.5,-73,-74,1
31,LR,1,200,5,-73,-72,-75,3
31,LR,1,200,4,-73,-72,-75,3
31,LR,1,200,3,-73.3333333333333,-72,-75,3
31,LR,0,200,1,-75,-75,-75,0
31,LR,1,200,4,-74.25,-71,-80,9
31,LR,1,200,8,-72.5,-71,-74,3
31,LR,1,200,4,-72.5,-72,-73,1
31,LR,1,200,9,-72.1111111111111,-70,-73,3
31,LR,1,200,4,-72.25,-71,-73,2
31,LR,1,200,10,-72.3,-70,-74,4
31,LR,1,200,6,-72.1666666666667,-70,-73,3
31,LR,0,200,2,-73,-73,-73,0
31,LR,1,200,4,-73,-72,-74,2
31,LR,0,200,1,-72,-72,-72,0
31,LR,1,200,5,-75.2,-72,-80,8
31,LR,0,200,1,-74,-74,-74,0
31,LR,1,200,8,-74.375,-70,-80,10
31,LR,1,200,8,-74.25,-70,-80,10
31,LR,1,200,5,-75.2,-70,-80,10
31,LR,1,200,5,-73.2,-70,-80,10
31,LR,1,200,6,-71.5,-70,-73,3
31,LR,1,200,3,-71,-70,-73,3
31,LR,1,200,7,-71,-70,-72,2
31,LR,0,200,2,-70.5,-70,-71,1
31,LR,0,200,2,-71.5,-71,-72,1
31,LR,1,200,3,-72,-72,-72,0
31,LR,1,200,4,-71.25,-70,-72,2
31,LR,0,200,2,-71,-70,-72,2
31,LR,1,200,3,-70.3333333333333,-70,-71,1
31,LR,1,200,9,-70.8888888888889,-70,-72,2
31,LR,1,200,8,-71,-70,-72,2
31,LR,1,200,5,-71,-70,-72,2
31,LR,1,200,7,-71,-70,-72,2
31,LR,0,200,1,-70,-70,-70,0
31,LR,1,200,3,-71,-70,-72,2
31,LR,1,200,4,-70.75,-70,-72,2
31,LR,1,200,8,-71.375,-70,-72,2
31,LR,1,200,6,-71.3333333333333,-70,-72,2
31,LR,1,200,10,-71.8,-70,-73,3
31,LR,1,200,10,-72,-71,-73,2
31,LR,1,200,7,-71.8571428571429,-71,-73,2
31,LR,1,200,6,-72,-71,-73,2
31,LR,0,200,1,-72,-72,-72,0
31,LR,0,200,1,-72,-72,-72,0
31,LR,1,200,9,-73.1111111111111,-72,-76,4
31,LR,0,200,1,-73,-73,-73,0
31,LR,0,200,2,-72.5,-72,-73,1
31,LR,1,200,4,-73,-72,-74,2
31,LR,1,200,9,-73.6666666666667,-71,-76,5
31,LR,1,200,7,-73.5714285714286,-71,-76,5
31,LR,1,200,8,-73.5,-71,-76,5
31,LR,1,200,3,-74.3333333333333,-73,-76,3
31,LR,1,200,6,-73.1666666666667,-71,-76,5
31,LR,1,200,8,-72,-70,-74,4
31,LR,1,200,10,-71.8,-70,-74,4
31,LR,1,200,7,-72.1428571428571,-70,-74,4
31,LR,1,200,5,-71.6,-70,-74,4
31,LR,0,200,1,-71,-71,-71,0
31,LR,1,200,10,-71.9,-70,-74,4
31,LR,0,200,2,-72.5,-71,-74,3
31,LR,1,200,7,-72.2857142857143,-70,-74,4
31,LR,0,200,2,-71,-70,-72,2
31,LR,1,200,3,-71.6666666666667,-70,-73,3
31,LR,1,200,4,-72.5,-72,-73,1
31,LR,1,200,4,-72.5,-72,-73,1
31,LR,1,200,5,-72.4,-72,-73,1
31,LR,1,200,9,-72.6666666666667,-70,-79,9
31,LR,1,200,6,-73.5,-71,-79,8
31,LR,1,200,10,-72.3,-70,-79,9
31,LR,1,200,5,-72.8,-70,-79,9
31,LR,1,200,4,-73.25,-70,-79,9
31,LR,1,200,7,-71.1428571428571,-70,-74,4
31,LR,1,200,7,-71,-70,-73,3
31,LR,1,200,9,-72,-70,-77,7
31,LR,1,200,4,-71.5,-70,-73,3
31,LR,1,200,9,-72.6666666666667,-70,-77,7
31,LR,1,200,6,-72.8333333333333,-70,-77,7
31,LR,1,200,5,-73.4,-72,-77,5
31,LR,1,200,9,-72.4444444444444,-70,-74,4
31,LR,1,200,7,-72.2857142857143,-70,-74,4
31,LR,1,200,5,-72.6,-70,-74,4
31,LR,1,200,8,-73,-70,-75,5
31,LR,0,200,1,-73,-73,-73,0
31,LR,0,200,2,-72,-70,-74,4
31,LR,1,200,7,-73.5714285714286,-70,-77,7
31,LR,1,200,8,-73.875,-71,-77,6
31,LR,1,200,4,-75,-74,-77,3
31,LR,1,200,5,-74.4,-73,-77,4
31,LR,0,200,1,-74,-74,-74,0
31,LR,1,200,8,-72.5,-71,-75,4
31,LR,1,200,9,-72.4444444444444,-71,-75,4
31,LR,1,200,5,-71.8,-71,-73,2
31,LR,1,200,4,-72,-71,-73,2
31,LR,1,200,10,-72.5,-71,-75,4
31,LR,1,200,3,-73,-71,-75,4
31,LR,0,200,1,-71,-71,-71,0
31,LR,1,200,6,-72.8333333333333,-71,-75,4
31,LR,0,200,2,-72.5,-71,-74,3
31,LR,1,200,8,-72.25,-70,-74,4
31,LR,1,200,10,-72.4,-70,-74,4
31,LR,1,200,3,-72.6666666666667,-71,-74,3
31,LR,1,200,3,-73.3333333333333,-73,-74,1
31,LR,1,200,5,-72.6,-70,-74,4
31,LR,1,200,4,-71.75,-70,-73,3
31,LR,0,200,2,-73,-73,-73,0
31,LR,1,200,7,-72,-70,-73,3
31,LR,0,200,1,-70,-70,-70,0
31,LR,1,200,3,-73,-73,-73,0
31,LR,1,200,6,-72.5,-72,-74,2
31,LR,1,200,9,-71.8888888888889,-71,-74,3
31,LR,1,200,4,-72.5,-72,-74,2
31,LR,1,200,10,-72.4,-71,-75,4
31,LR,1,200,9,-72,-70,-75,5
31,LR,0,200,2,-71,-71,-71,0
31,LR,1,200,4,-71.75,-71,-73,2
31,LR,1,200,8,-72.375,-70,-75,5
31,LR,1,200,9,-72.4444444444444,-70,-75,5
31,LR,1,200,10,-72.9,-70,-75,5
31,LR,0,200,2,-74,-73,-75,2
31,LR,1,200,9,-73,-70,-76,6
31,LR,1,200,8,-74.5,-71,-82,11
31,LR,1,200,5,-73,-71,-75,4
31,LR,1,200,3,-73.3333333333333,-71,-75,4
31,LR,1,200,8,-76.125,-71,-82,11
31,LR,0,200,2,-74,-73,-75,2
31,LR,0,200,1,-82,-82,-82,0
31,LR,1,200,4,-80.25,-71,-92,21
31,LR,1,200,5,-80,-73,-92,19
31,LR,0,200,2,-82.5,-73,-92,19
31,LR,1,200,7,-75.5714285714286,-73,-79,6
31,LR,1,200,10,-77.2,-74,-92,18
31,LR,1,200,3,-76,-74,-79,5
31,LR,1,200,3,-74.6666666666667,-74,-75,1
31,LR,1,200,6,-78,-74,-92,18
31,LR,0,200,1,-75,-75,-75,0
31,LR,1,200,10,-78.8,-73,-92,19
31,LR,1,200,3,-75.6666666666667,-74,-78,4
31,LR,1,200,5,-78,-74,-92,18
31,LR,1,200,8,-77.75,-74,-92,18
31,LR,1,200,5,-80.2,-74,-92,18
31,LR,1,200,3,-82,-78,-86,8
31,LR,1,200,3,-84.3333333333333,-82,-86,4
31,LR,1,200,4,-85.75,-82,-90,8
26,RL,1,200,6,-75.3333333333333,-68,-87,19
26,RL,1,200,9,-73.8888888888889,-68,-87,19
26,RL,1,200,6,-74,-68,-87,19
26,RL,0,200,1,-68,-68,-68,0
26,RL,1,200,8,-73.125,-68,-87,19
26,RL,1,200,8,-73.875,-69,-87,18
26,RL,1,200,7,-72,-69,-76,7
26,RL,1,200,4,-73,-70,-76,6
26,RL,1,200,6,-75.3333333333333,-70,-81,11
26,RL,1,200,3,-74.3333333333333,-72,-77,5
26,RL,1,200,3,-78.6666666666667,-77,-81,4
26,RL,0,200,1,-78,-78,-78,0
26,RL,1,200,7,-80.5714285714286,-77,-84,7
26,RL,1,200,10,-81.5,-77,-99,22
26,RL,1,200,10,-82.2,-77,-99,22
26,RL,1,200,7,-82.4285714285714,-77,-99,22
26,RL,1,200,10,-82.4,-74,-99,25
26,RL,1,200,7,-82,-74,-99,25
26,RL,1,200,5,-83.2,-77,-99,22
26,RL,0,200,2,-88,-77,-99,22
26,RL,1,200,4,-83.75,-74,-99,25
26,RL,1,200,8,-83.5,-74,-89,15
26,RL,1,200,8,-84.125,-74,-89,15
26,RL,0,200,1,-89,-89,-89,0
26,RL,1,200,3,-86,-84,-88,4
26,RL,0,200,2,-85,-84,-86,2
26,RL,1,200,4,-84,-82,-85,3
26,RL,1,200,3,-82.6666666666667,-81,-85,4
26,RL,0,200,1,-81,-81,-81,0
26,RL,1,200,4,-82,-81,-84,3
26,RL,1,200,8,-81.5,-80,-83,3
26,RL,1,200,9,-81.5555555555556,-80,-83,3
26,RL,1,200,9,-81.6666666666667,-80,-83,3
26,RL,1,200,7,-81.5714285714286,-80,-83,3
26,RL,1,200,6,-81.8333333333333,-81,-83,2
26,RL,1,200,7,-82.1428571428571,-81,-83,2
26,RL,1,200,8,-82.375,-82,-83,1
26,RL,1,200,5,-82.2,-82,-83,1
26,RL,1,200,8,-82.125,-82,-83,1
26,RL,1,200,4,-82,-82,-82,0
26,RL,1,200,10,-81.8,-79,-84,5
26,RL,1,200,6,-82.5,-82,-84,2
26,RL,1,200,4,-82.25,-82,-83,1
26,RL,1,200,4,-82,-80,-84,4
26,RL,1,200,10,-81.1,-79,-84,5
26,RL,1,200,5,-80.6,-79,-84,5
26,RL,0,200,2,-81.5,-79,-84,5
26,RL,0,200,1,-79,-79,-79,0
26,RL,1,200,6,-77.6666666666667,-72,-82,10
26,RL,1,200,5,-76.8,-72,-81,9
26,RL,1,200,3,-76.3333333333333,-72,-81,9
26,RL,0,200,1,-76,-76,-76,0
26,RL,0,200,1,-72,-72,-72,0
26,RL,1,200,3,-73,-70,-78,8
26,RL,1,200,5,-73.4,-69,-78,9
26,RL,1,200,4,-72.25,-69,-78,9
26,RL,1,200,9,-72.2222222222222,-69,-78,9
26,RL,1,200,5,-72.4,-69,-78,9
26,RL,1,200,7,-71.8571428571429,-69,-78,9
26,RL,1,200,8,-71.875,-69,-78,9
26,RL,0,200,1,-78,-78,-78,0
26,RL,1,200,4,-71,-69,-74,5
26,RL,1,200,8,-70.625,-69,-74,5
26,RL,1,200,5,-70.2,-69,-74,5
26,RL,1,200,3,-71,-69,-74,5
26,RL,1,200,6,-70,-69,-72,3
26,RL,1,200,5,-70.2,-69,-72,3
26,RL,1,200,4,-70.25,-69,-72,3
26,RL,1,200,4,-69.75,-69,-70,1
26,RL,0,200,1,-70,-70,-70,0
26,RL,0,200,2,-69.5,-69,-70,1
26,RL,0,200,1,-70,-70,-70,0
26,RL,1,200,4,-72.25,-70,-77,7
26,RL,1,200,7,-72.8571428571429,-70,-77,7
26,RL,1,200,8,-72.25,-70,-74,4
26,RL,1,200,3,-72,-70,-74,4
26,RL,1,200,9,-72.6666666666667,-70,-74,4
26,RL,1,200,6,-72.6666666666667,-70,-74,4
26,RL,1,200,5,-73.2,-71,-74,3
26,RL,0,200,2,-72,-71,-73,2
26,RL,0,200,2,-72.5,-71,-74,3
26,RL,1,200,3,-72.6666666666667,-71,-74,3
26,RL,1,200,10,-71.2,-69,-75,6
26,RL,1,200,10,-71.1,-69,-75,6
26,RL,1,200,8,-71.125,-69,-75,6
26,RL,1,200,5,-71.2,-69,-75,6
26,RL,1,200,8,-71.25,-69,-75,6
26,RL,1,200,8,-71.125,-69,-74,5
26,RL,0,200,1,-69,-69,-69,0
26,RL,1,200,8,-71.75,-69,-74,5
26,RL,0,200,1,-70,-70,-70,0
26,RL,1,200,6,-72.1666666666667,-70,-74,4
26,RL,0,200,2,-73,-72,-74,2
26,RL,1,200,6,-72.6666666666667,-71,-74,3
26,RL,1,200,3,-72.3333333333333,-72,-73,1
26,RL,1,200,7,-71.5714285714286,-70,-74,4
26,RL,1,200,5,-71.6,-70,-74,4
26,RL,1,200,7,-70.8571428571429,-70,-74,4
26,RL,1,200,5,-70.4,-70,-71,1
26,RL,1,200,3,-70.3333333333333,-70,-71,1
26,RL,1,200,9,-71.8888888888889,-70,-74,4
26,RL,1,200,8,-72,-70,-74,4
26,RL,1,200,8,-72.25,-70,-74,4
26,RL,1,200,7,-72.5714285714286,-70,-74,4
26,RL,0,200,1,-73,-73,-73,0
26,RL,0,200,2,-73.5,-73,-74,1
26,RL,0,200,2,-73.5,-73,-74,1
26,RL,1,200,9,-72.3333333333333,-70,-74,4
26,RL,0,200,2,-72,-70,-74,4
26,RL,1,200,3,-71.6666666666667,-70,-74,4
26,RL,1,200,5,-72.2,-71,-74,3
26,RL,1,200,9,-72.7777777777778,-71,-74,3
26,RL,1,200,4,-72.5,-72,-74,2
26,RL,1,200,8,-72.5,-71,-74,3
26,RL,1,200,6,-72.8333333333333,-71,-74,3
26,RL,1,200,9,-72.6666666666667,-71,-74,3
26,RL,1,200,10,-72.5,-71,-74,3
26,RL,1,200,4,-72.5,-71,-74,3
26,RL,1,200,6,-72.8333333333333,-71,-74,3
26,RL,1,200,9,-72.3333333333333,-71,-74,3
26,RL,1,200,10,-72.5,-71,-74,3
26,RL,1,200,7,-72,-71,-73,2
26,RL,1,200,8,-72.375,-71,-74,3
26,RL,1,200,4,-72,-71,-73,2
26,RL,1,200,5,-72.2,-71,-74,3
26,RL,1,200,4,-72.5,-71,-74,3
26,RL,1,200,4,-72.25,-71,-74,3
26,RL,1,200,10,-72.2,-71,-74,3
26,RL,1,200,7,-71.7142857142857,-71,-73,2
26,RL,1,200,4,-72,-71,-73,2
26,RL,1,200,3,-72.3333333333333,-71,-73,2
26,RL,1,200,9,-71.8888888888889,-71,-74,3
26,RL,1,200,7,-71.8571428571429,-71,-74,3
26,RL,1,200,7,-72.2857142857143,-71,-74,3
26,RL,1,200,9,-72.5555555555556,-71,-74,3
26,RL,1,200,6,-72.1666666666667,-71,-74,3
26,RL,1,200,8,-73.125,-71,-76,5
26,RL,1,200,10,-73.4,-71,-76,5
26,RL,1,200,9,-73.3333333333333,-71,-76,5
26,RL,1,200,10,-73.7,-72,-76,4
26,RL,1,200,8,-73.375,-72,-76,4
26,RL,1,200,10,-73.8,-70,-77,7
26,RL,1,200,7,-73.8571428571429,-72,-76,4
26,RL,1,200,6,-74,-72,-76,4
26,RL,1,200,8,-72.875,-70,-77,7
26,RL,0,200,2,-74,-72,-76,4
26,RL,1,200,6,-74.3333333333333,-70,-81,11
26,RL,1,200,3,-73,-70,-77,7
26,RL,1,200,4,-73.25,-70,-81,11
26,RL,0,200,1,-72,-72,-72,0
26,RL,0,200,1,-70,-70,-70,0
26,RL,1,200,3,-77.3333333333333,-73,-81,8
26,RL,1,200,8,-76.625,-73,-80,7
26,RL,1,200,7,-77.1428571428571,-74,-80,6
26,RL,0,200,1,-74,-74,-74,0
26,RL,1,200,3,-77.6666666666667,-75,-80,5
26,RL,1,200,6,-78.3333333333333,-77,-80,3
26,RL,0,200,1,-77,-77,-77,0
26,RL,1,200,4,-77.5,-75,-80,5
26,RL,1,200,3,-77.3333333333333,-75,-80,5
26,RL,1,200,7,-75.5714285714286,-70,-85,15
26,RL,1,200,5,-73.8,-70,-76,6
26,RL,1,200,5,-75.8,-70,-85,15
26,RL,0,200,2,-75,-74,-76,2
26,RL,0,200,2,-80.5,-76,-85,9
26,RL,1,200,4,-76.25,-75,-78,3
26,RL,1,200,4,-75.5,-73,-78,5
26,RL,1,200,3,-75.3333333333333,-73,-78,5
26,RL,1,200,10,-76.4,-73,-79,6
26,RL,1,200,6,-76.3333333333333,-76,-77,1
26,RL,1,200,9,-76.7777777777778,-76,-79,3
26,RL,1,200,4,-76.25,-76,-77,1
26,RL,1,200,5,-76.4,-76,-77,1
26,RL,1,200,8,-76.625,-74,-79,5
26,RL,1,200,5,-77.2,-76,-79,3
26,RL,1,200,6,-76.8333333333333,-74,-79,5
26,RL,0,200,2,-78,-77,-79,2
26,RL,1,200,4,-76.75,-74,-79,5
26,RL,1,200,5,-76,-74,-77,3
26,RL,1,200,6,-75.3333333333333,-74,-77,3
26,RL,0,200,2,-77,-77,-77,0
26,RL,1,200,3,-75.3333333333333,-74,-77,3
26,RL,1,200,8,-75.875,-72,-78,6
26,RL,1,200,10,-75.8,-72,-78,6
26,RL,1,200,10,-75.6,-72,-78,6
26,RL,1,200,10,-75.2,-72,-78,6
26,RL,0,200,2,-75,-72,-78,6
26,RL,1,200,10,-75.2,-73,-78,5
26,RL,0,200,2,-74,-74,-74,0
26,RL,1,200,5,-75.8,-74,-78,4
26,RL,1,200,3,-77,-75,-78,3
26,RL,1,200,7,-75.8571428571429,-73,-79,6
26,RL,0,200,1,-74,-74,-74,0
26,RL,1,200,7,-75.2857142857143,-73,-79,6
26,RL,1,200,7,-75.2857142857143,-73,-79,6
26,RL,1,200,7,-75.2857142857143,-73,-79,6
26,RL,1,200,10,-75.2,-73,-79,6
26,RL,1,200,3,-75.6666666666667,-74,-79,5
26,RL,1,200,4,-73.75,-73,-74,1
26,RL,0,200,1,-73,-73,-73,0
26,RL,1,200,4,-76.25,-73,-79,6
26,RL,1,200,5,-75.6,-73,-79,6
26,RL,1,200,5,-76.6,-73,-79,6
26,RL,1,200,7,-75.1428571428571,-73,-79,6
26,RL,0,200,2,-73.5,-73,-74,1
26,RL,1,200,9,-74.5555555555556,-73,-78,5
26,RL,1,200,6,-74.8333333333333,-73,-78,5
26,RL,1,200,6,-74.1666666666667,-73,-75,2
26,RL,1,200,5,-74.4,-74,-75,1
26,RL,1,200,4,-74.5,-74,-75,1
26,RL,1,200,6,-75.6666666666667,-74,-79,5
26,RL,1,200,8,-75.875,-74,-79,5
26,RL,0,200,2,-76.5,-74,-79,5
26,RL,0,200,1,-79,-79,-79,0
26,RL,1,200,3,-75.6666666666667,-74,-79,5
26,RL,1,200,4,-75.25,-74,-79,5
26,RL,0,200,2,-74,-74,-74,0
26,RL,1,200,7,-75.2857142857143,-74,-79,5
26,RL,1,200,8,-75.75,-74,-79,5
26,RL,0,200,2,-76.5,-74,-79,5
26,RL,1,200,7,-75.2857142857143,-74,-78,4
26,RL,1,200,4,-75.25,-74,-77,3
26,RL,1,200,7,-75.8571428571429,-74,-78,4
26,RL,1,200,8,-75.625,-74,-78,4
26,RL,1,200,5,-75.8,-74,-78,4
26,RL,1,200,6,-75.5,-74,-78,4
26,RL,1,200,4,-75.25,-74,-78,4
26,RL,1,200,5,-76,-74,-78,4
26,RL,1,200,6,-75.1666666666667,-74,-78,4
26,RL,1,200,10,-75,-73,-79,6
26,RL,1,200,8,-74.5,-73,-78,5
26,RL,1,200,8,-74.625,-73,-79,6
26,RL,1,200,7,-74.5714285714286,-73,-79,6
26,RL,1,200,5,-74.8,-73,-79,6
26,RL,0,200,1,-74,-74,-74,0
26,RL,0,200,2,-76.5,-74,-79,5
26,RL,1,200,10,-76,-73,-79,6
26,RL,1,200,5,-75.4,-73,-78,5
26,RL,0,200,2,-76,-74,-78,4
26,RL,1,200,3,-77,-74,-79,5
26,RL,1,200,10,-76.2,-73,-80,7
26,RL,1,200,8,-76.25,-73,-80,7
26,RL,1,200,5,-75.4,-73,-79,6
26,RL,1,200,9,-76.1111111111111,-73,-80,7
26,RL,0,200,2,-73.5,-73,-74,1
26,RL,1,200,3,-75.6666666666667,-73,-80,7
26,RL,1,200,5,-76,-73,-80,7
26,RL,1,200,10,-76,-72,-80,8
26,RL,1,200,10,-75.4,-72,-80,8
26,RL,1,200,9,-75.5555555555556,-72,-80,8
26,RL,1,200,9,-74.8888888888889,-72,-80,8
26,RL,1,200,3,-76,-73,-80,7
26,RL,1,200,5,-74.6,-72,-80,8
26,RL,1,200,4,-73,-72,-74,2
26,RL,1,200,9,-74.6666666666667,-72,-79,7
26,RL,1,200,7,-74.8571428571429,-72,-79,7
26,RL,1,200,8,-75.375,-72,-79,7
26,RL,1,200,7,-75.8571428571429,-73,-79,6
26,RL,1,200,6,-76.1666666666667,-73,-79,6
26,RL,1,200,5,-74.4,-72,-77,5
26,RL,1,200,9,-74.4444444444444,-71,-77,6
26,RL,1,200,4,-75.25,-72,-77,5
26,RL,1,200,8,-74.5,-71,-77,6
26,RL,1,200,3,-74.6666666666667,-72,-76,4
26,RL,0,200,2,-76,-76,-76,0
26,RL,1,200,6,-73.5,-71,-77,6
26,RL,1,200,8,-74,-71,-77,6
26,RL,0,200,2,-76,-75,-77,2
26,RL,1,200,8,-74.5,-71,-78,7
26,RL,1,200,7,-74.4285714285714,-71,-78,7
26,RL,1,200,10,-74.4,-71,-78,7
26,RL,0,200,2,-73,-71,-75,4
26,RL,1,200,8,-74.625,-72,-78,6
26,RL,1,200,7,-74.5714285714286,-72,-78,6
26,RL,1,200,4,-73.5,-72,-75,3
26,RL,0,200,1,-72,-72,-72,0
26,RL,1,200,4,-74.25,-72,-77,5
26,RL,0,200,1,-73,-73,-73,0
26,RL,1,200,5,-75,-72,-77,5
26,RL,1,200,7,-75.4285714285714,-72,-79,7
26,RL,1,200,9,-76.3333333333333,-73,-79,6
26,RL,1,200,4,-76.5,-73,-79,6
26,RL,1,200,7,-76.4285714285714,-73,-79,6
26,RL,1,200,7,-75.5714285714286,-73,-78,5
26,RL,0,200,2,-78,-78,-78,0
26,RL,0,200,2,-75,-73,-77,4
26,RL,1,200,9,-76.1111111111111,-73,-78,5
26,RL,0,200,1,-77,-77,-77,0
26,RL,0,200,1,-73,-73,-73,0
26,RL,1,200,8,-76.75,-73,-79,6
26,RL,0,200,1,-78,-78,-78,0
26,RL,0,200,1,-73,-73,-73,0
26,RL,1,200,8,-76.5,-73,-79,6
26,RL,1,200,5,-76,-73,-79,6
26,RL,1,200,7,-76.1428571428571,-72,-79,7
26,RL,1,200,9,-75.1111111111111,-72,-79,7
26,RL,1,200,7,-74.8571428571429,-72,-78,6
26,RL,1,200,7,-74,-72,-78,6
26,RL,1,200,10,-74.8,-72,-80,8
26,RL,0,200,1,-78,-78,-78,0
26,RL,1,200,7,-75.1428571428571,-72,-80,8
26,RL,1,200,10,-75.7,-72,-80,8
26,RL,0,200,1,-77,-77,-77,0
26,RL,1,200,5,-76,-73,-80,7
26,RL,1,200,10,-75.7,-72,-80,8
26,RL,0,200,2,-76.5,-76,-77,1
26,RL,1,200,6,-75.1666666666667,-72,-79,7
26,RL,1,200,5,-75.4,-72,-79,7
26,RL,1,200,9,-74.2222222222222,-72,-79,7
26,RL,0,200,1,-72,-72,-72,0
26,RL,0,200,1,-75,-75,-75,0
26,RL,1,200,10,-74.7,-72,-78,6
26,RL,0,200,1,-73,-73,-73,0
26,RL,1,200,3,-73.3333333333333,-73,-74,1
26,RL,1,200,8,-75.375,-72,-78,6
26,RL,1,200,4,-76.25,-72,-78,6
26,RL,1,200,8,-75.875,-72,-79,7
26,RL,1,200,10,-76.1,-72,-79,7
26,RL,1,200,10,-76.5,-73,-79,6
26,RL,0,200,2,-75,-73,-77,4
26,RL,1,200,7,-76.8571428571429,-73,-79,6
26,RL,0,200,1,-73,-73,-73,0
26,RL,1,200,3,-78.3333333333333,-78,-79,1
26,RL,1,200,8,-74.875,-72,-78,6
26,RL,0,200,2,-76.5,-76,-77,1
26,RL,0,200,2,-74.5,-73,-76,3
26,RL,1,200,7,-73.8571428571429,-72,-77,5
26,RL,1,200,8,-74.125,-72,-77,5
26,RL,1,200,3,-74.6666666666667,-73,-77,4
26,RL,0,200,1,-73,-73,-73,0
26,RL,1,200,9,-74.7777777777778,-72,-79,7
26,RL,1,200,6,-74.1666666666667,-72,-77,5
26,RL,0,200,1,-72,-72,-72,0
26,RL,1,200,5,-73.8,-72,-77,5
26,RL,1,200,8,-74.625,-72,-79,7
26,RL,1,200,5,-75.4,-72,-79,7
26,RL,0,200,2,-78,-77,-79,2
26,RL,1,200,10,-75.5,-72,-78,6
26,RL,1,200,9,-75.3333333333333,-72,-78,6
26,RL,1,200,9,-74.8888888888889,-72,-78,6
26,RL,1,200,8,-75,-72,-77,5
26,RL,1,200,5,-75,-72,-77,5
26,RL,1,200,5,-74.2,-72,-77,5
26,RL,0,200,2,-73.5,-72,-75,3
26,RL,0,200,2,-73.5,-72,-75,3
26,RL,1,200,9,-74.2222222222222,-72,-77,5
26,RL,1,200,5,-74.4,-72,-77,5
26,RL,0,200,2,-74,-72,-76,4
26,RL,1,200,7,-74.4285714285714,-72,-77,5
26,RL,0,200,2,-73.5,-72,-75,3
26,RL,1,200,10,-74.1,-72,-77,5
26,RL,1,200,3,-75.3333333333333,-73,-77,4
26,RL,1,200,9,-75.2222222222222,-72,-84,12
26,RL,1,200,9,-76.7777777777778,-72,-86,14
26,RL,1,200,9,-74.3333333333333,-72,-77,5
26,RL,0,200,2,-74.5,-73,-76,3
26,RL,1,200,10,-74.6,-72,-77,5
26,RL,1,200,3,-76.6666666666667,-72,-84,12
26,RL,1,200,5,-74.2,-72,-76,4
26,RL,0,200,1,-84,-84,-84,0
26,RL,0,200,1,-78,-78,-78,0
26,RL,0,200,2,-82,-78,-86,8
26,RL,1,200,6,-79,-72,-86,14
26,RL,1,200,8,-78.875,-72,-86,14
26,LR,1,200,6,-81,-74,-91,17
26,LR,1,200,4,-83,-74,-91,17
26,LR,1,200,3,-86,-78,-91,13
26,LR,1,200,6,-82,-77,-91,14
26,LR,0,200,1,-89,-89,-89,0
26,LR,1,200,6,-79.6666666666667,-75,-91,16
26,LR,0,200,2,-77.5,-77,-78,1
26,LR,0,200,2,-84.5,-78,-91,13
26,LR,0,200,2,-83,-75,-91,16
26,LR,1,200,9,-82.1111111111111,-77,-91,14
26,LR,1,200,6,-81.5,-77,-89,12
26,LR,1,200,9,-80.1111111111111,-77,-89,12
26,LR,0,200,1,-89,-89,-89,0
26,LR,1,200,9,-79,-76,-81,5
26,LR,1,200,8,-79.125,-76,-81,5
26,LR,1,200,4,-79.25,-77,-81,4
26,LR,0,200,1,-79,-79,-79,0
26,LR,1,200,10,-79.1,-75,-84,9
26,LR,1,200,10,-78.6,-75,-84,9
26,LR,1,200,7,-79.2857142857143,-75,-84,9
26,LR,1,200,3,-81,-77,-84,7
26,LR,1,200,8,-78,-75,-84,9
26,LR,1,200,3,-76.3333333333333,-75,-78,3
26,LR,1,200,5,-77.2,-75,-81,6
26,LR,1,200,10,-78.4,-75,-84,9
26,LR,1,200,6,-79.5,-76,-84,8
26,LR,1,200,4,-79.75,-76,-84,8
26,LR,1,200,6,-78.6666666666667,-76,-84,8
26,LR,0,200,1,-78,-78,-78,0
26,LR,1,200,7,-79.5714285714286,-76,-84,8
26,LR,1,200,7,-79,-76,-81,5
26,LR,1,200,5,-78.6,-76,-81,5
26,LR,1,200,4,-79.25,-78,-81,3
26,LR,1,200,5,-78.6,-74,-81,7
26,LR,1,200,10,-76.7,-73,-81,8
26,LR,0,200,2,-80.5,-80,-81,1
26,LR,1,200,6,-76.5,-74,-80,6
26,LR,1,200,10,-74.6,-73,-78,5
26,LR,1,200,10,-74.9,-73,-78,5
26,LR,0,200,2,-77,-76,-78,2
26,LR,1,200,3,-74.3333333333333,-73,-76,3
26,LR,1,200,8,-74.375,-73,-77,4
26,LR,1,200,3,-73.3333333333333,-73,-74,1
26,LR,0,200,2,-73.5,-73,-74,1
26,LR,1,200,4,-75.25,-73,-77,4
26,LR,0,200,2,-75,-73,-77,4
26,LR,0,200,2,-77,-77,-77,0
26,LR,0,200,1,-77,-77,-77,0
26,LR,1,200,3,-74.3333333333333,-71,-79,8
26,LR,1,200,7,-74,-70,-79,9
26,LR,1,200,9,-73.2222222222222,-70,-79,9
26,LR,1,200,10,-71.9,-70,-75,5
26,LR,0,200,2,-73.5,-72,-75,3
26,LR,0,200,2,-71,-70,-72,2
26,LR,1,200,5,-71,-70,-72,2
26,LR,0,200,1,-70,-70,-70,0
26,LR,1,200,6,-72.5,-71,-75,4
26,LR,0,200,1,-73,-73,-73,0
26,LR,1,200,3,-72,-71,-74,3
26,LR,1,200,5,-72.8,-70,-75,5
26,LR,1,200,8,-72.875,-70,-76,6
26,LR,1,200,4,-73.25,-70,-75,5
26,LR,1,200,3,-72.6666666666667,-70,-74,4
26,LR,1,200,7,-71.8571428571429,-70,-76,6
26,LR,1,200,5,-72.6,-70,-76,6
26,LR,1,200,6,-72.1666666666667,-70,-76,6
26,LR,1,200,8,-72.125,-68,-75,7
26,LR,1,200,4,-72.5,-72,-73,1
26,LR,1,200,5,-72,-68,-74,6
26,LR,1,200,8,-73,-68,-76,8
26,LR,1,200,10,-72.7,-68,-76,8
26,LR,0,200,1,-68,-68,-68,0
26,LR,1,200,8,-73.125,-70,-76,6
26,LR,1,200,4,-71.75,-70,-74,4
26,LR,1,200,4,-71.5,-70,-73,3
26,LR,1,200,7,-72.8571428571429,-70,-74,4
26,LR,0,200,2,-72.5,-72,-73,1
26,LR,1,200,4,-73.75,-73,-74,1
26,LR,1,200,10,-73.3,-72,-74,2
26,LR,1,200,9,-73.1111111111111,-72,-74,2
26,LR,1,200,6,-73.1666666666667,-72,-74,2
26,LR,1,200,7,-73,-72,-74,2
26,LR,1,200,4,-73,-72,-74,2
26,LR,0,200,2,-73.5,-73,-74,1
26,LR,1,200,7,-72.4285714285714,-72,-73,1
26,LR,1,200,8,-72.625,-72,-75,3
26,LR,1,200,5,-73,-72,-75,3
26,LR,1,200,3,-72.3333333333333,-72,-73,1
26,LR,1,200,3,-73.3333333333333,-72,-75,3
26,LR,1,200,3,-73,-72,-75,3
26,LR,1,200,8,-74.125,-72,-75,3
26,LR,1,200,9,-74.1111111111111,-72,-75,3
26,LR,0,200,2,-74.5,-74,-75,1
26,LR,1,200,9,-74.3333333333333,-73,-75,2
26,LR,1,200,4,-74.25,-73,-75,2
26,LR,0,200,2,-74,-73,-75,2
26,LR,1,200,3,-75,-75,-75,0
26,LR,1,200,3,-74.6666666666667,-74,-75,1
26,LR,1,200,8,-74.375,-73,-75,2
26,LR,0,200,2,-74.5,-74,-75,1
26,LR,1,200,4,-74.25,-73,-75,2
26,LR,1,200,9,-73.2222222222222,-70,-75,5
26,LR,1,200,6,-74.1666666666667,-73,-75,2
26,LR,1,200,4,-74,-73,-75,2
26,LR,1,200,3,-74,-73,-75,2
26,LR,1,200,7,-72.2857142857143,-70,-74,4
26,LR,1,200,7,-71.7142857142857,-70,-74,4
26,LR,0,200,1,-74,-74,-74,0
26,LR,0,200,2,-70.5,-70,-71,1
26,LR,1,200,10,-72.8,-69,-79,10
26,LR,0,200,2,-72,-72,-72,0
26,LR,1,200,5,-73.6,-70,-77,7
26,LR,1,200,6,-74,-69,-79,10
26,LR,0,200,2,-74.5,-73,-76,3
26,LR,1,200,10,-76.8,-69,-90,21
26,LR,1,200,7,-77,-69,-90,21
26,LR,1,200,7,-77.2857142857143,-69,-90,21
26,LR,1,200,7,-77.5714285714286,-69,-90,21
26,LR,1,200,8,-76.5,-69,-90,21
26,LR,1,200,7,-76.5714285714286,-69,-90,21
26,LR,1,200,10,-73.8,-68,-90,22
26,LR,0,200,1,-71,-71,-71,0
26,LR,1,200,5,-73.8,-69,-81,12
26,LR,1,200,10,-70.8,-68,-74,6
26,LR,1,200,8,-70,-68,-72,4
26,LR,0,200,2,-69.5,-68,-71,3
26,LR,1,200,10,-70.8,-68,-73,5
26,LR,1,200,8,-70.875,-70,-72,2
26,LR,1,200,4,-70.5,-70,-72,2
26,LR,1,200,8,-71.375,-70,-73,3
26,LR,1,200,4,-71,-70,-72,2
26,LR,1,200,8,-71.625,-70,-74,4
26,LR,0,200,1,-72,-72,-72,0
26,LR,1,200,3,-72.6666666666667,-71,-74,3
26,LR,0,200,1,-74,-74,-74,0
26,LR,1,200,8,-71.375,-70,-74,4
26,LR,0,200,1,-72,-72,-72,0
26,LR,0,200,2,-70.5,-70,-71,1
26,LR,1,200,8,-71.75,-71,-74,3
26,LR,0,200,2,-71.5,-71,-72,1
26,LR,0,200,2,-71,-71,-71,0
26,LR,1,200,8,-71.875,-70,-74,4
26,LR,0,200,2,-73.5,-73,-74,1
26,LR,1,200,10,-71.2,-70,-73,3
26,LR,1,200,3,-71.3333333333333,-71,-72,1
26,LR,1,200,3,-72,-71,-73,2
26,LR,1,200,10,-70.9,-70,-73,3
26,LR,1,200,5,-70.6,-70,-73,3
26,LR,1,200,3,-70,-70,-70,0
26,LR,1,200,8,-70.875,-70,-73,3
26,LR,1,200,3,-70.6666666666667,-70,-72,2
26,LR,1,200,5,-71,-70,-73,3
26,LR,1,200,8,-70.75,-70,-73,3
26,LR,0,200,1,-70,-70,-70,0
26,LR,0,200,1,-73,-73,-73,0
26,LR,1,200,5,-70.2,-70,-71,1
26,LR,1,200,10,-70.9,-70,-74,4
26,LR,1,200,8,-71,-70,-74,4
26,LR,1,200,10,-71,-70,-74,4
26,LR,1,200,3,-71,-70,-73,3
26,LR,1,200,4,-70.25,-70,-71,1
26,LR,1,200,3,-70.3333333333333,-70,-71,1
26,LR,1,200,8,-71.5,-70,-75,5
26,LR,1,200,5,-72.2,-70,-75,5
26,LR,0,200,1,-70,-70,-70,0
26,LR,1,200,4,-72.75,-70,-75,5
26,LR,0,200,1,-75,-75,-75,0
26,LR,1,200,10,-72.7,-70,-77,7
26,LR,0,200,2,-75.5,-74,-77,3
26,LR,1,200,10,-72.6,-70,-77,7
26,LR,1,200,9,-72.1111111111111,-70,-75,5
26,LR,1,200,7,-71.7142857142857,-70,-75,5
26,LR,1,200,10,-71.5,-70,-74,4
26,LR,1,200,6,-71.5,-70,-74,4
26,LR,1,200,3,-70.6666666666667,-70,-71,1
26,LR,1,200,7,-71.4285714285714,-70,-74,4
26,LR,1,200,5,-71.2,-70,-72,2
26,LR,1,200,3,-71,-70,-72,2
26,LR,1,200,9,-71.6666666666667,-70,-74,4
26,LR,1,200,3,-72,-70,-74,4
26,LR,0,200,2,-72,-70,-74,4
26,LR,1,200,8,-71.125,-70,-74,4
26,LR,0,200,1,-72,-72,-72,0
26,LR,1,200,4,-70.5,-70,-72,2
26,LR,1,200,9,-70.7777777777778,-69,-73,4
26,LR,0,200,2,-70,-70,-70,0
26,LR,1,200,10,-70.9,-69,-73,4
26,LR,1,200,7,-71.4285714285714,-70,-73,3
26,LR,1,200,4,-71.5,-70,-73,3
26,LR,1,200,8,-70.875,-70,-73,3
26,LR,0,200,2,-71,-70,-72,2
26,LR,1,200,8,-70.875,-70,-73,3
26,LR,1,200,9,-71,-70,-73,3
26,LR,1,200,5,-71,-70,-73,3
26,LR,0,200,2,-71,-70,-72,2
26,LR,1,200,5,-71.2,-70,-72,2
26,LR,1,200,6,-71.6666666666667,-70,-74,4
26,LR,1,200,5,-72,-70,-74,4
26,LR,1,200,9,-71.6666666666667,-70,-74,4
26,LR,1,200,6,-71.5,-70,-74,4
26,LR,1,200,4,-71,-70,-73,3
26,LR,1,200,4,-71.25,-70,-73,3
26,LR,1,200,4,-71,-70,-73,3
26,LR,0,200,2,-72,-71,-73,2
26,LR,1,200,5,-71.2,-70,-74,4
26,LR,1,200,9,-71.3333333333333,-70,-74,4
26,LR,1,200,6,-71.3333333333333,-70,-74,4
26,LR,1,200,8,-71.75,-70,-74,4
26,LR,0,200,1,-71,-71,-71,0
26,LR,1,200,9,-71.2222222222222,-70,-74,4
26,LR,0,200,1,-72,-72,-72,0
26,LR,1,200,9,-71.1111111111111,-70,-74,4
26,LR,1,200,8,-70.75,-70,-72,2
26,LR,1,200,9,-70.7777777777778,-70,-72,2
26,LR,1,200,10,-70.4,-69,-72,3
26,LR,1,200,6,-70.6666666666667,-70,-72,2
26,LR,0,200,1,-70,-70,-70,0
26,LR,0,200,2,-71,-70,-72,2
26,LR,1,200,7,-70,-69,-71,2
26,LR,0,200,1,-70,-70,-70,0
26,LR,1,200,5,-70,-69,-71,2
26,LR,1,200,7,-70,-69,-71,2
26,LR,1,200,10,-70.3,-70,-72,2
26,LR,0,200,1,-70,-70,-70,0
26,LR,0,200,1,-70,-70,-70,0
26,LR,1,200,4,-70.5,-70,-72,2
26,LR,1,200,9,-70.6666666666667,-70,-72,2
26,LR,1,200,3,-70.3333333333333,-70,-71,1
26,LR,1,200,7,-70.8571428571429,-70,-72,2
26,LR,1,200,10,-71,-70,-72,2
26,LR,1,200,9,-71,-70,-72,2
26,LR,0,200,1,-72,-72,-72,0
26,LR,1,200,7,-71,-70,-72,2
26,LR,1,200,10,-71.6,-70,-75,5
26,LR,1,200,8,-71.875,-70,-75,5
26,LR,1,200,5,-71.2,-70,-72,2
26,LR,1,200,9,-71.4444444444444,-70,-75,5
26,LR,0,200,2,-71,-70,-72,2
26,LR,1,200,3,-72,-72,-72,0
26,LR,1,200,8,-71.375,-69,-75,6
26,LR,1,200,5,-71.8,-70,-75,5
26,LR,1,200,10,-70.7,-69,-73,4
26,LR,1,200,8,-70.75,-69,-73,4
26,LR,1,200,5,-71.2,-69,-73,4
26,LR,1,200,3,-71,-69,-73,4
26,LR,1,200,4,-71,-69,-73,4
26,LR,1,200,9,-71.1111111111111,-70,-73,3
26,LR,0,200,1,-70,-70,-70,0
26,LR,1,200,3,-71,-70,-73,3
26,LR,1,200,8,-71.875,-70,-75,5
26,LR,1,200,5,-71.6,-70,-73,3
26,LR,1,200,9,-72,-70,-75,5
26,LR,0,200,1,-70,-70,-70,0
26,LR,1,200,8,-72,-70,-75,5
26,LR,1,200,7,-71.8571428571429,-70,-75,5
26,LR,1,200,4,-72,-71,-73,2
26,LR,1,200,5,-71.2,-70,-73,3
26,LR,0,200,1,-71,-71,-71,0
26,LR,1,200,6,-70.6666666666667,-70,-72,2
26,LR,0,200,1,-70,-70,-70,0
26,LR,0,200,1,-72,-72,-72,0
26,LR,0,200,2,-70.5,-70,-71,1
26,LR,1,200,7,-70.8571428571429,-69,-73,4
26,LR,1,200,8,-71.125,-69,-73,4
26,LR,1,200,10,-71.7,-70,-73,3
26,LR,1,200,7,-71.7142857142857,-70,-73,3
26,LR,1,200,4,-71.5,-70,-73,3
26,LR,1,200,9,-71.4444444444444,-70,-73,3
26,LR,1,200,8,-71.25,-70,-73,3
26,LR,0,200,1,-71,-71,-71,0
26,LR,1,200,10,-72.5,-70,-81,11
26,LR,1,200,10,-74.9,-70,-96,26
26,LR,1,200,4,-71.5,-70,-73,3
26,LR,1,200,9,-75.4444444444444,-70,-96,26
26,LR,1,200,9,-75.3333333333333,-70,-96,26
26,LR,1,200,9,-75.6666666666667,-70,-96,26
26,LR,1,200,9,-75.3333333333333,-70,-96,26
26,LR,1,200,10,-75,-70,-96,26
26,LR,1,200,9,-75.2222222222222,-70,-96,26
26,LR,1,200,9,-74,-70,-96,26
26,LR,0,200,1,-71,-71,-71,0
26,LR,1,200,10,-71.2,-70,-74,4
26,LR,1,200,4,-70.5,-70,-72,2
26,LR,1,200,8,-71.125,-70,-73,3
26,LR,1,200,4,-70.75,-70,-72,2
26,LR,1,200,10,-70.8,-69,-73,4
26,LR,1,200,6,-71,-69,-73,4
26,LR,0,200,2,-71.5,-71,-72,1
26,LR,1,200,4,-71.25,-69,-73,4
26,LR,1,200,9,-70.7777777777778,-69,-73,4
26,LR,1,200,4,-70.75,-69,-73,4
26,LR,1,200,8,-70.375,-69,-72,3
26,LR,1,200,7,-70.5714285714286,-69,-72,3
26,LR,1,200,7,-70.7142857142857,-69,-72,3
26,LR,1,200,4,-70.75,-69,-72,3
26,LR,1,200,5,-71.2,-70,-72,2
26,LR,1,200,6,-70.6666666666667,-70,-72,2
26,LR,1,200,4,-71,-70,-72,2
26,LR,1,200,10,-70.3,-68,-72,4
26,LR,1,200,7,-70,-68,-71,3
26,LR,1,200,6,-70,-68,-71,3
26,LR,1,200,6,-70.1666666666667,-68,-71,3
26,LR,1,200,3,-70.3333333333333,-70,-71,1
26,LR,1,200,7,-70.1428571428571,-68,-72,4
26,LR,1,200,7,-70.4285714285714,-68,-72,4
26,LR,1,200,3,-69.6666666666667,-68,-71,3
26,LR,1,200,7,-71.1428571428571,-70,-72,2
26,LR,1,200,9,-71,-70,-72,2
26,LR,1,200,10,-72.4,-70,-82,12
26,LR,1,200,9,-72.6666666666667,-70,-82,12
26,LR,1,200,8,-72.625,-70,-82,12
26,LR,1,200,9,-74.2222222222222,-70,-82,12
26,LR,1,200,3,-70.6666666666667,-70,-72,2
26,LR,1,200,10,-79,-70,-98,28
26,LR,1,200,9,-80,-71,-98,27
26,LR,1,200,3,-78.3333333333333,-71,-82,11
26,LR,1,200,8,-80,-71,-98,27
26,LR,0,200,1,-82,-82,-82,0
26,LR,0,200,1,-76,-76,-76,0
26,LR,1,200,4,-84,-76,-98,22
26,LR,1,200,10,-79.6,-73,-98,25
26,LR,0,200,2,-87,-76,-98,22
26,LR,1,200,9,-79,-73,-98,25
26,LR,1,200,3,-74.3333333333333,-73,-75,2
26,LR,0,200,1,-73,-73,-73,0
26,LR,1,200,7,-76.4285714285714,-70,-92,22
26,LR,1,200,7,-78.1428571428571,-70,-92,22
26,LR,1,200,9,-74.7777777777778,-70,-88,18
26,LR,1,200,8,-77.375,-70,-88,18
26,LR,1,200,7,-78.4285714285714,-72,-88,16
26,LR,1,200,10,-77.1,-70,-92,22
26,LR,1,200,4,-78.25,-73,-87,14
26,LR,1,200,4,-76.5,-72,-88,16
26,LR,1,200,8,-76.625,-70,-88,18
26,LR,1,200,9,-77,-70,-88,18
26,LR,1,200,7,-79.4285714285714,-72,-88,16
26,LR,1,200,4,-83.5,-80,-87,7
31,RL,1,250,10,-76,-69,-80,11
31,RL,0,250,5,-76,-70,-79,9
31,RL,1,250,9,-78.3333333333333,-69,-90,21
31,RL,0,250,3,-72.3333333333333,-69,-78,9
31,RL,0,250,7,-81.7142857142857,-77,-90,13
31,RL,1,250,10,-81.9,-79,-90,11
31,RL,0,250,4,-82.75,-79,-90,11
31,RL,0,250,1,-90,-90,-90,0
31,RL,0,250,7,-81.4285714285714,-79,-85,6
31,RL,0,250,7,-80.7142857142857,-78,-85,7
31,RL,0,250,1,-84,-84,-84,0
31,RL,0,250,2,-80,-79,-81,2
31,RL,0,250,2,-79,-79,-79,0
31,RL,0,250,8,-78.75,-77,-83,6
31,RL,0,250,8,-78.875,-77,-83,6
31,RL,0,250,1,-83,-83,-83,0
31,RL,0,250,1,-80,-80,-80,0
31,RL,0,250,5,-78,-77,-79,2
31,RL,0,250,5,-78,-77,-79,2
31,RL,0,250,8,-77.75,-77,-79,2
31,RL,0,250,4,-77.75,-77,-79,2
31,RL,0,250,8,-79,-77,-82,5
31,RL,0,250,2,-77.5,-77,-78,1
31,RL,0,250,2,-77.5,-77,-78,1
31,RL,0,250,3,-79,-77,-82,5
31,RL,1,250,10,-79.2,-74,-84,10
31,RL,0,250,1,-82,-82,-82,0
31,RL,1,250,9,-79.1111111111111,-74,-84,10
31,RL,0,250,4,-78.75,-74,-84,10
31,RL,0,250,3,-77.6666666666667,-74,-84,10
31,RL,0,250,8,-80,-75,-86,11
31,RL,0,250,3,-77,-75,-80,5
31,RL,1,250,10,-79.8,-76,-86,10
31,RL,0,250,3,-79.6666666666667,-79,-80,1
31,RL,1,250,10,-80.8,-78,-86,8
31,RL,0,250,2,-82.5,-79,-86,7
31,RL,0,250,5,-80.6,-78,-86,8
31,RL,0,250,1,-78,-78,-78,0
31,RL,0,250,4,-81,-79,-85,6
31,RL,0,250,3,-81.6666666666667,-80,-85,5
31,RL,0,250,8,-81.125,-79,-85,6
31,RL,0,250,4,-81.75,-80,-85,5
31,RL,0,250,8,-78.875,-75,-83,8
31,RL,0,250,1,-81,-81,-81,0
31,RL,0,250,3,-75.6666666666667,-75,-76,1
31,RL,0,250,2,-76,-76,-76,0
31,RL,0,250,4,-78.25,-76,-81,5
31,RL,0,250,8,-80.625,-77,-83,6
31,RL,0,250,6,-80.1666666666667,-77,-82,5
31,RL,1,250,10,-81.8,-77,-87,10
31,RL,0,250,1,-81,-81,-81,0
31,RL,0,250,5,-82.8,-81,-87,6
31,RL,0,250,4,-83.25,-81,-87,6
31,RL,0,250,5,-83.6,-82,-87,5
31,RL,1,250,10,-82.8,-80,-87,7
31,RL,0,250,6,-82.1666666666667,-80,-87,7
31,RL,0,250,7,-81.8571428571429,-80,-86,6
31,RL,0,250,4,-80.25,-80,-81,1
31,RL,0,250,6,-83.1666666666667,-80,-86,6
31,RL,0,250,5,-83.8,-81,-86,5
31,RL,0,250,7,-83.5714285714286,-81,-86,5
31,RL,0,250,5,-83.6,-82,-85,3
31,RL,0,250,7,-81.5714285714286,-78,-84,6
31,RL,1,250,9,-80.5555555555556,-78,-84,6
31,RL,0,250,7,-80.2857142857143,-78,-84,6
31,RL,0,250,5,-79.8,-78,-82,4
31,RL,0,250,3,-79.3333333333333,-78,-81,3
31,RL,0,250,8,-80,-78,-83,5
31,RL,0,250,2,-79,-79,-79,0
31,RL,0,250,1,-79,-79,-79,0
31,RL,0,250,2,-82.5,-82,-83,1
31,RL,0,250,4,-81.25,-80,-83,3
31,RL,0,250,6,-80.5,-79,-83,4
31,RL,1,250,9,-82.5555555555556,-79,-89,10
31,RL,0,250,3,-81.6666666666667,-79,-83,4
31,RL,1,250,10,-83.8,-79,-89,10
31,RL,1,250,10,-83.3,-78,-89,11
31,RL,0,250,8,-84.5,-79,-89,10
31,RL,0,250,7,-83.2857142857143,-78,-89,11
31,RL,0,250,4,-84,-82,-89,7
31,RL,0,250,1,-82,-82,-82,0
31,RL,0,250,5,-80.6,-78,-83,5
31,RL,0,250,5,-80.2,-78,-83,5
31,RL,1,250,9,-81.1111111111111,-78,-85,7
31,RL,0,250,5,-81.8,-80,-85,5
31,RL,0,250,3,-81.6666666666667,-80,-85,5
31,RL,0,250,5,-82.4,-80,-85,5
31,RL,1,250,9,-81.3333333333333,-78,-85,7
31,RL,0,250,7,-81.2857142857143,-79,-84,5
31,RL,0,250,4,-80.5,-79,-82,3
31,RL,0,250,7,-80.1428571428571,-78,-82,4
31,RL,0,250,1,-81,-81,-81,0
31,RL,1,250,9,-80.2222222222222,-78,-88,10
31,RL,1,250,9,-80.6666666666667,-78,-88,10
31,RL,1,250,10,-80.6,-78,-88,10
31,RL,0,250,6,-80.6666666666667,-78,-88,10
31,RL,0,250,2,-83.5,-79,-88,9
31,RL,0,250,6,-81.1666666666667,-78,-88,10
31,RL,0,250,4,-79.5,-78,-82,4
31,RL,0,250,2,-79,-79,-79,0
31,RL,1,250,10,-80.3,-78,-83,5
31,RL,0,250,8,-80,-78,-83,5
31,RL,0,250,2,-81.5,-80,-83,3
31,RL,0,250,7,-80.5714285714286,-80,-83,3
31,RL,0,250,8,-80.5,-79,-84,5
31,RL,0,250,8,-80.875,-79,-84,5
31,RL,1,250,10,-84,-79,-92,13
31,RL,0,250,7,-82.4285714285714,-79,-90,11
31,RL,0,250,5,-81.2,-79,-84,5
31,RL,0,250,2,-79.5,-79,-80,1
31,RL,0,250,5,-85.6,-79,-92,13
31,RL,1,250,9,-86.2222222222222,-82,-92,10
31,RL,1,250,9,-85.8888888888889,-81,-92,11
31,RL,1,250,10,-85.2,-81,-92,11
31,RL,1,250,9,-84.6666666666667,-81,-92,11
31,RL,0,250,7,-84.1428571428571,-81,-91,10
31,RL,0,250,8,-82,-81,-87,6
31,RL,0,250,3,-83.3333333333333,-81,-87,6
31,RL,1,250,10,-81.5,-81,-83,2
31,RL,0,250,4,-81,-81,-81,0
31,RL,0,250,3,-81,-81,-81,0
31,RL,0,250,8,-81.75,-81,-83,2
31,RL,0,250,2,-81,-81,-81,0
31,RL,0,250,2,-81.5,-81,-82,1
31,RL,0,250,7,-82.5714285714286,-81,-84,3
31,RL,1,250,9,-82.2222222222222,-77,-85,8
31,RL,0,250,6,-82.8333333333333,-81,-85,4
31,RL,0,250,8,-82,-77,-85,8
31,RL,0,250,7,-81.7142857142857,-77,-85,8
31,RL,1,250,9,-80.6666666666667,-77,-85,8
31,RL,0,250,7,-80.7142857142857,-77,-85,8
31,RL,0,250,8,-80.5,-77,-85,8
31,RL,1,250,10,-80.4,-77,-84,7
31,RL,0,250,8,-79.625,-77,-83,6
31,RL,0,250,4,-79.5,-79,-80,1
31,RL,0,250,1,-79,-79,-79,0
31,RL,0,250,7,-80.2857142857143,-78,-83,5
31,RL,0,250,2,-80,-80,-80,0
31,RL,0,250,6,-81.5,-78,-86,8
31,RL,0,250,4,-80.75,-78,-83,5
31,RL,0,250,5,-83.2,-78,-86,8
31,RL,0,250,6,-82,-78,-86,8
31,RL,0,250,5,-81.8,-78,-86,8
31,RL,0,250,3,-84,-80,-86,6
31,RL,0,250,3,-81.6666666666667,-79,-86,7
31,RL,1,250,9,-81.6666666666667,-79,-92,13
31,RL,1,250,10,-81.5,-78,-92,14
31,RL,0,250,8,-80.25,-78,-81,3
31,RL,1,250,10,-80.2,-78,-81,3
31,RL,0,250,2,-80.5,-80,-81,1
31,RL,1,250,10,-80.3,-78,-82,4
31,RL,0,250,5,-80.2,-78,-81,3
31,RL,0,250,4,-80.25,-78,-81,3
31,RL,0,250,6,-80,-78,-81,3
31,RL,0,250,1,-78,-78,-78,0
31,RL,0,250,5,-80.6,-79,-82,3
31,RL,0,250,4,-80.5,-79,-82,3
31,RL,1,250,10,-82.2,-79,-87,8
31,RL,0,250,3,-82,-81,-83,2
31,RL,1,250,10,-82.4,-81,-87,6
31,RL,0,250,1,-82,-82,-82,0
31,RL,0,250,2,-82,-82,-82,0
31,RL,0,250,7,-82.4285714285714,-81,-87,6
31,RL,0,250,7,-82.7142857142857,-81,-87,6
31,RL,1,250,9,-83,-81,-87,6
31,RL,0,250,2,-81.5,-81,-82,1
31,RL,0,250,8,-83.125,-81,-87,6
31,RL,0,250,2,-81.5,-81,-82,1
31,RL,0,250,6,-84,-82,-87,5
31,RL,0,250,7,-81.7142857142857,-76,-87,11
31,RL,0,250,5,-81.8,-76,-84,8
31,RL,0,250,6,-79.6666666666667,-76,-84,8
31,RL,0,250,7,-78.4285714285714,-76,-83,7
31,RL,0,250,8,-78.125,-76,-81,5
31,RL,0,250,3,-76.6666666666667,-76,-77,1
31,RL,1,250,10,-79.8,-77,-82,5
31,RL,0,250,4,-80.5,-79,-81,2
31,RL,0,250,8,-81.375,-81,-82,1
31,RL,0,250,6,-81.3333333333333,-81,-82,1
31,RL,0,250,6,-81.5,-81,-82,1
31,RL,0,250,3,-81.3333333333333,-81,-82,1
31,RL,0,250,7,-81.4285714285714,-79,-82,3
31,RL,0,250,7,-81.5714285714286,-79,-82,3
31,RL,0,250,5,-81.4,-79,-82,3
31,RL,0,250,4,-81,-79,-82,3
31,RL,0,250,2,-82,-82,-82,0
31,RL,1,250,9,-81,-80,-85,5
31,RL,1,250,10,-80.7,-80,-85,5
31,RL,0,250,7,-80.8571428571429,-80,-85,5
31,RL,0,250,6,-81,-80,-85,5
31,RL,1,250,10,-82.1,-80,-88,8
31,RL,0,250,1,-80,-80,-80,0
31,RL,0,250,3,-81.6666666666667,-80,-85,5
31,RL,0,250,1,-85,-85,-85,0
31,RL,0,250,1,-80,-80,-80,0
31,RL,0,250,1,-80,-80,-80,0
31,RL,0,250,4,-84,-80,-88,8
31,RL,0,250,6,-82.8333333333333,-80,-88,8
31,RL,0,250,7,-80.7142857142857,-80,-83,3
31,RL,0,250,5,-80.8,-80,-83,3
31,RL,0,250,6,-81.3333333333333,-80,-83,3
31,RL,1,250,10,-82.6,-81,-84,3
31,RL,0,250,4,-82,-81,-83,2
31,RL,1,250,10,-82.2,-80,-84,4
31,RL,0,250,8,-82.625,-80,-84,4
31,RL,1,250,10,-83,-80,-86,6
31,RL,0,250,3,-82.3333333333333,-81,-83,2
31,RL,0,250,7,-82.8571428571429,-80,-86,6
31,RL,1,250,9,-83.4444444444444,-80,-88,8
31,RL,1,250,10,-83.8,-80,-88,8
31,RL,0,250,5,-83.2,-80,-86,6
31,RL,0,250,1,-80,-80,-80,0
31,RL,0,250,8,-83.75,-80,-88,8
31,RL,1,250,10,-83,-79,-88,9
31,RL,0,250,6,-84,-80,-88,8
31,RL,1,250,9,-81.8888888888889,-79,-88,9
31,RL,0,250,3,-86,-82,-88,6
31,RL,1,250,10,-82.4,-79,-88,9
31,RL,0,250,4,-80.75,-80,-82,2
31,RL,0,250,2,-80.5,-80,-81,1
31,RL,0,250,2,-80.5,-80,-81,1
31,RL,0,250,2,-79.5,-79,-80,1
31,RL,1,250,10,-83.1,-79,-86,7
31,RL,0,250,2,-82.5,-79,-86,7
31,RL,0,250,4,-85,-83,-86,3
31,RL,0,250,8,-83.375,-80,-86,6
31,RL,0,250,4,-83.75,-82,-85,3
31,RL,0,250,5,-83.6,-80,-86,6
31,RL,0,250,1,-85,-85,-85,0
31,RL,0,250,2,-84,-82,-86,4
31,RL,0,250,7,-85.1428571428571,-80,-90,10
31,RL,0,250,4,-82.5,-80,-86,6
31,RL,1,250,9,-86.3333333333333,-80,-93,13
31,RL,0,250,8,-87.125,-80,-93,13
31,RL,1,250,10,-85,-79,-93,14
31,RL,0,250,6,-87.8333333333333,-80,-93,13
31,RL,0,250,5,-87.4,-80,-93,13
31,RL,0,250,2,-92.5,-92,-93,1
31,RL,0,250,3,-79.3333333333333,-79,-80,1
31,RL,0,250,8,-80.25,-77,-84,7
31,RL,0,250,4,-80.5,-79,-84,5
31,RL,0,250,5,-81,-77,-84,7
31,RL,0,250,5,-81.6,-77,-84,7
31,RL,0,250,3,-80.3333333333333,-77,-84,7
31,RL,0,250,6,-80.1666666666667,-77,-83,6
31,RL,0,250,5,-80.2,-77,-83,6
31,RL,0,250,7,-81.8571428571429,-79,-95,16
31,RL,1,250,10,-83.2,-79,-95,16
31,RL,0,250,8,-83.625,-79,-95,16
31,RL,0,250,1,-79,-79,-79,0
31,RL,0,250,8,-83.875,-79,-95,16
31,RL,0,250,3,-85,-80,-92,12
31,RL,0,250,8,-83.75,-79,-92,13
31,RL,0,250,3,-80.6666666666667,-79,-82,3
31,RL,0,250,2,-80,-79,-81,2
31,RL,1,250,9,-82.5555555555556,-79,-88,9
31,RL,0,250,7,-83.4285714285714,-79,-88,9
31,RL,0,250,8,-83.5,-80,-88,8
31,RL,0,250,4,-83.75,-82,-86,4
31,RL,0,250,6,-82.3333333333333,-80,-84,4
31,RL,0,250,6,-82.3333333333333,-80,-84,4
31,RL,0,250,8,-82.5,-80,-84,4
31,RL,0,250,8,-82,-80,-84,4
31,RL,0,250,1,-83,-83,-83,0
31,RL,0,250,3,-82.3333333333333,-81,-84,3
31,RL,0,250,4,-82.5,-81,-84,3
31,RL,0,250,3,-83,-81,-84,3
31,RL,0,250,8,-81.75,-78,-85,7
31,RL,0,250,8,-81.5,-78,-85,7
31,RL,0,250,2,-78,-78,-78,0
31,RL,0,250,8,-82.5,-78,-85,7
31,RL,1,250,10,-83,-80,-85,5
31,RL,0,250,4,-82.5,-80,-85,5
31,RL,0,250,8,-82.625,-80,-85,5
31,RL,0,250,1,-82,-82,-82,0
31,RL,0,250,7,-82.5714285714286,-80,-85,5
31,RL,1,250,10,-82.9,-80,-85,5
31,RL,0,250,1,-83,-83,-83,0
31,RL,0,250,5,-83,-82,-85,3
31,RL,1,250,9,-82.3333333333333,-79,-85,6
31,RL,0,250,5,-82.6,-80,-85,5
31,RL,1,250,10,-83.2,-79,-85,6
31,RL,0,250,7,-82.8571428571429,-79,-85,6
31,RL,1,250,10,-84.7,-82,-87,5
31,RL,0,250,3,-85,-85,-85,0
31,RL,0,250,1,-85,-85,-85,0
31,RL,0,250,4,-84.5,-82,-87,5
31,RL,0,250,8,-84.125,-82,-87,5
31,RL,0,250,6,-83.3333333333333,-80,-87,7
31,RL,0,250,2,-85.5,-84,-87,3
31,RL,0,250,8,-82.875,-79,-90,11
31,RL,0,250,5,-83.8,-80,-90,10
31,RL,0,250,7,-82.7142857142857,-79,-90,11
31,RL,0,250,4,-84.5,-81,-90,9
31,RL,0,250,2,-83,-81,-85,4
31,RL,0,250,6,-80.8333333333333,-79,-82,3
31,RL,1,250,9,-80.1111111111111,-78,-82,4
31,RL,0,250,4,-80.5,-79,-82,3
31,RL,0,250,8,-80.25,-78,-82,4
31,RL,0,250,3,-79.6666666666667,-78,-82,4
31,RL,0,250,7,-82.2857142857143,-79,-86,7
31,RL,0,250,3,-80.6666666666667,-79,-82,3
31,RL,0,250,8,-83.25,-81,-86,5
31,RL,0,250,7,-83.5714285714286,-82,-86,4
31,RL,1,250,10,-82.5,-80,-86,6
31,RL,0,250,6,-81.6666666666667,-80,-83,3
31,RL,0,250,6,-81.1666666666667,-80,-83,3
31,RL,0,250,1,-82,-82,-82,0
31,RL,0,250,3,-80.6666666666667,-80,-81,1
31,RL,0,250,7,-80.1428571428571,-78,-82,4
31,RL,0,250,8,-82.875,-78,-90,12
31,RL,0,250,7,-83.5714285714286,-78,-90,12
31,RL,0,250,6,-84.5,-79,-90,11
31,RL,0,250,7,-84,-79,-90,11
31,RL,0,250,5,-83.8,-79,-90,11
31,RL,0,250,8,-82.5,-79,-90,11
31,RL,0,250,4,-81.75,-79,-84,5
31,RL,1,250,10,-81.8,-79,-85,6
31,RL,1,250,9,-82.1111111111111,-81,-85,4
31,RL,1,250,9,-82.1111111111111,-81,-85,4
31,RL,0,250,3,-81.6666666666667,-81,-83,2
31,RL,0,250,6,-82,-81,-85,4
31,RL,0,250,6,-82.1666666666667,-81,-85,4
31,RL,0,250,3,-82.6666666666667,-81,-85,4
31,RL,0,250,7,-83,-80,-85,5
31,RL,0,250,8,-83.625,-80,-86,6
31,RL,0,250,2,-82.5,-80,-85,5
31,RL,0,250,6,-84.5,-80,-86,6
31,RL,1,250,10,-83.3,-79,-86,7
31,RL,0,250,6,-83.3333333333333,-80,-86,6
31,RL,0,250,3,-83.3333333333333,-82,-86,4
31,RL,0,250,3,-82.6666666666667,-82,-84,2
31,RL,0,250,7,-81.8571428571429,-79,-86,7
31,RL,0,250,2,-84,-84,-84,0
31,RL,0,250,4,-80.25,-79,-84,5
31,RL,0,250,3,-79,-79,-79,0
31,RL,0,250,5,-83,-79,-87,8
31,RL,0,250,4,-84,-81,-87,6
31,RL,0,250,7,-83.7142857142857,-80,-88,8
31,RL,0,250,8,-84.875,-80,-88,8
31,RL,0,250,4,-84,-80,-88,8
31,RL,0,250,4,-85.75,-80,-88,8
31,RL,0,250,8,-84,-80,-88,8
31,RL,0,250,4,-84.25,-80,-88,8
31,RL,0,250,6,-83.6666666666667,-80,-88,8
31,RL,0,250,5,-84,-80,-88,8
31,RL,0,250,1,-80,-80,-80,0
31,RL,0,250,3,-84,-80,-88,8
31,RL,0,250,3,-84,-80,-88,8
31,RL,0,250,2,-82,-80,-84,4
31,RL,0,250,6,-83.3333333333333,-80,-86,6
31,RL,0,250,5,-84,-83,-86,3
31,RL,0,250,3,-84,-83,-86,3
31,RL,0,250,4,-82.75,-78,-86,8
31,RL,0,250,1,-83,-83,-83,0
31,RL,0,250,1,-84,-84,-84,0
31,RL,0,250,3,-81.3333333333333,-78,-83,5
31,RL,0,250,5,-87.8,-80,-98,18
31,RL,1,250,10,-86.1,-79,-98,19
31,RL,1,250,10,-86.6,-79,-98,19
31,RL,0,250,1,-84,-84,-84,0
31,RL,0,250,5,-85.8,-79,-94,15
31,RL,1,250,10,-84.7,-79,-90,11
31,RL,0,250,6,-85.1666666666667,-82,-90,8
31,RL,0,250,4,-84,-82,-86,4
31,RL,0,250,4,-84.25,-82,-86,4
31,RL,0,250,4,-85.75,-85,-86,1
31,RL,0,250,8,-83.125,-79,-86,7
31,RL,0,250,3,-85.6666666666667,-85,-86,1
31,RL,0,250,8,-84,-79,-90,11
31,RL,0,250,6,-83.8333333333333,-79,-90,11
31,RL,1,250,9,-83.2222222222222,-77,-90,13
31,RL,0,250,2,-79.5,-79,-80,1
31,RL,0,250,3,-87.3333333333333,-84,-90,6
31,RL,1,250,10,-83.1,-77,-88,11
31,RL,0,250,1,-88,-88,-88,0
31,RL,0,250,6,-82.5,-77,-88,11
31,RL,0,250,5,-83.6,-79,-88,9
31,RL,0,250,7,-83.4285714285714,-79,-88,9
31,RL,1,250,9,-84.7777777777778,-81,-90,9
31,RL,0,250,3,-82,-81,-84,3
31,RL,0,250,2,-82.5,-81,-84,3
31,RL,0,250,4,-85,-83,-90,7
31,RL,0,250,7,-84.7142857142857,-80,-90,10
31,RL,0,250,5,-86,-83,-90,7
31,RL,0,250,7,-85.1428571428571,-80,-90,10
31,RL,1,250,10,-82.7,-79,-90,11
31,RL,0,250,5,-83.2,-80,-88,8
31,RL,0,250,3,-84,-80,-88,8
31,RL,0,250,5,-81.8,-79,-88,9
31,RL,1,250,9,-82.2222222222222,-79,-88,9
31,RL,0,250,6,-80.6666666666667,-79,-82,3
31,RL,1,250,10,-82.3,-79,-84,5
31,RL,0,250,7,-82,-79,-84,5
31,RL,0,250,2,-80.5,-79,-82,3
31,RL,0,250,5,-83.2,-82,-84,2
31,RL,0,250,2,-83,-82,-84,2
31,RL,0,250,5,-84,-84,-84,0
31,RL,0,250,1,-84,-84,-84,0
31,RL,0,250,7,-84.1428571428571,-84,-85,1
31,RL,0,250,4,-84.25,-84,-85,1
31,RL,0,250,1,-85,-85,-85,0
31,RL,0,250,4,-84.5,-84,-86,2
31,RL,0,250,2,-84,-84,-84,0
31,RL,0,250,3,-83.6666666666667,-81,-86,5
31,RL,0,250,2,-83.5,-81,-86,5
31,RL,0,250,3,-81,-80,-82,2
31,RL,0,250,6,-82.3333333333333,-78,-86,8
31,RL,0,250,4,-81.5,-78,-86,8
31,RL,0,250,5,-83.4,-78,-86,8
31,RL,0,250,5,-81.6,-77,-86,9
31,RL,1,250,9,-84.6666666666667,-77,-88,11
31,RL,0,250,2,-83.5,-81,-86,5
31,RL,0,250,8,-84.25,-77,-88,11
31,RL,0,250,8,-84.5,-77,-88,11
31,RL,1,250,10,-85.3,-81,-88,7
31,RL,0,250,7,-85.2857142857143,-82,-88,6
31,RL,0,250,7,-85.1428571428571,-82,-88,6
31,RL,0,250,3,-85,-83,-88,5
31,RL,0,250,5,-84.6,-82,-87,5
31,RL,0,250,2,-82.5,-82,-83,1
31,RL,0,250,8,-84.625,-81,-87,6
31,RL,0,250,5,-84.2,-81,-87,6
31,RL,0,250,6,-84,-81,-87,6
31,RL,0,250,1,-87,-87,-87,0
31,RL,1,250,10,-85,-83,-87,4
31,RL,0,250,7,-84.7142857142857,-83,-87,4
31,RL,0,250,4,-84.25,-83,-86,3
31,RL,0,250,8,-84.875,-83,-87,4
31,RL,0,250,1,-84,-84,-84,0
31,RL,0,250,1,-84,-84,-84,0
31,RL,0,250,3,-85,-83,-86,3
31,RL,1,250,10,-84.2,-80,-92,12
31,RL,0,250,8,-83.625,-80,-92,12
31,RL,0,250,5,-83.2,-80,-92,12
31,RL,0,250,4,-83.25,-80,-92,12
31,RL,0,250,6,-83.6666666666667,-80,-91,11
31,RL,0,250,1,-80,-80,-80,0
31,RL,0,250,7,-87.7142857142857,-77,-94,17
31,RL,0,250,5,-88.8,-77,-94,17
31,RL,0,250,6,-86.8333333333333,-77,-94,17
31,RL,0,250,8,-84,-75,-95,20
31,RL,0,250,7,-85,-75,-95,20
31,RL,0,250,8,-82.375,-75,-95,20
31,RL,0,250,3,-81,-75,-90,15
31,RL,0,250,8,-82.125,-75,-95,20
31,RL,0,250,3,-81.6666666666667,-75,-95,20
31,RL,1,250,10,-81.4,-75,-95,20
31,RL,0,250,2,-86.5,-78,-95,17
31,RL,1,250,9,-80.3333333333333,-78,-88,10
31,RL,0,250,8,-80.625,-78,-88,10
31,RL,0,250,8,-81.375,-78,-88,10
31,RL,0,250,1,-88,-88,-88,0
31,RL,0,250,4,-80.5,-78,-85,7
31,RL,0,250,5,-80.8,-78,-85,7
31,RL,0,250,2,-81.5,-78,-85,7
31,RL,0,250,4,-83,-79,-85,6
31,RL,0,250,6,-82.3333333333333,-79,-84,5
31,RL,0,250,5,-83,-80,-84,4
31,RL,0,250,3,-82.3333333333333,-80,-84,4
31,RL,0,250,6,-81.3333333333333,-78,-84,6
31,RL,0,250,6,-80.5,-78,-84,6
31,RL,1,250,10,-80.5,-77,-86,9
31,RL,0,250,2,-80,-80,-80,0
31,RL,0,250,2,-79,-78,-80,2
31,RL,1,250,9,-81.3333333333333,-77,-87,10
31,RL,0,250,4,-82.25,-78,-86,8
31,RL,0,250,3,-83.6666666666667,-79,-86,7
31,RL,1,250,9,-82.4444444444444,-77,-90,13
31,RL,1,250,10,-83,-77,-90,13
31,RL,0,250,6,-81.1666666666667,-77,-87,10
31,RL,0,250,6,-83.3333333333333,-78,-90,12
31,RL,1,250,9,-84.7777777777778,-79,-90,11
31,RL,0,250,5,-85,-79,-90,11
31,RL,0,250,4,-85.5,-79,-90,11
31,RL,0,250,3,-88,-84,-90,6
31,RL,0,250,4,-83,-81,-84,3
31,RL,0,250,1,-84,-84,-84,0
31,RL,1,250,9,-85.5555555555556,-81,-90,9
31,RL,0,250,6,-87.8333333333333,-83,-90,7
31,RL,0,250,5,-88,-83,-90,7
31,RL,1,250,10,-84.1,-80,-90,10
31,RL,0,250,7,-83.4285714285714,-80,-90,10
31,RL,0,250,7,-83,-80,-90,10
31,RL,0,250,5,-80.8,-80,-82,2
31,RL,0,250,7,-81.8571428571429,-80,-87,7
31,RL,0,250,6,-82.8333333333333,-80,-87,7
31,RL,0,250,2,-83.5,-80,-87,7
31,RL,0,250,3,-83.3333333333333,-80,-87,7
31,RL,0,250,2,-85,-83,-87,4
31,RL,0,250,8,-85.375,-80,-90,10
31,RL,0,250,6,-85.1666666666667,-80,-90,10
31,RL,0,250,4,-86.75,-80,-90,10
31,RL,0,250,1,-89,-89,-89,0
31,RL,1,250,10,-85,-80,-90,10
31,RL,0,250,1,-80,-80,-80,0
31,RL,1,250,10,-84.5,-80,-89,9
31,RL,1,250,10,-84.6,-81,-89,8
31,RL,0,250,2,-84,-81,-87,6
31,RL,1,250,9,-83.6666666666667,-81,-89,8
31,RL,0,250,7,-84.1428571428571,-81,-89,8
31,RL,1,250,10,-83,-80,-89,9
31,RL,0,250,8,-83.5,-80,-87,7
31,RL,0,250,3,-81.6666666666667,-80,-83,3
31,RL,0,250,7,-83.7142857142857,-80,-87,7
31,RL,1,250,10,-83.1,-80,-87,7
31,RL,0,250,1,-80,-80,-80,0
31,RL,0,250,6,-84.5,-80,-87,7
31,RL,0,250,6,-84.1666666666667,-80,-87,7
31,RL,1,250,9,-83,-80,-87,7
31,RL,0,250,4,-83,-80,-84,4
31,RL,0,250,1,-84,-84,-84,0
31,RL,0,250,7,-82.5714285714286,-80,-86,6
31,RL,0,250,3,-81.6666666666667,-80,-84,4
31,RL,1,250,9,-84,-80,-90,10
31,RL,1,250,9,-84.1111111111111,-81,-90,9
31,RL,1,250,10,-84.8,-81,-90,9
31,RL,1,250,9,-85.2222222222222,-81,-90,9
31,RL,0,250,1,-86,-86,-86,0
31,RL,1,250,9,-84.5555555555556,-81,-90,9
31,RL,0,250,4,-85.25,-81,-90,9
31,RL,0,250,1,-90,-90,-90,0
31,RL,1,250,10,-83.6,-81,-86,5
31,RL,1,250,9,-83.8888888888889,-81,-86,5
31,RL,0,250,3,-84,-82,-86,4
31,RL,0,250,8,-83.75,-80,-88,8
31,RL,0,250,2,-84,-84,-84,0
31,RL,0,250,6,-84,-80,-88,8
31,RL,0,250,2,-85.5,-85,-86,1
31,RL,1,250,10,-83.2,-80,-88,8
31,RL,1,250,9,-82.8888888888889,-80,-88,8
31,RL,1,250,9,-82.2222222222222,-80,-88,8
31,RL,0,250,4,-81.5,-80,-83,3
31,RL,0,250,5,-82,-80,-83,3
31,RL,0,250,2,-82.5,-82,-83,1
31,RL,0,250,6,-84.5,-80,-90,10
31,RL,0,250,6,-84.6666666666667,-80,-90,10
31,RL,0,250,3,-87.6666666666667,-83,-90,7
31,RL,0,250,2,-83,-83,-83,0
31,RL,0,250,4,-81.75,-80,-84,4
31,RL,0,250,6,-86.3333333333333,-80,-95,15
31,RL,0,250,1,-83,-83,-83,0
31,RL,1,250,9,-85.1111111111111,-78,-95,17
31,RL,0,250,2,-86,-82,-90,8
31,RL,0,250,3,-82,-82,-82,0
31,RL,0,250,3,-80.6666666666667,-78,-82,4
31,RL,0,250,3,-80.3333333333333,-78,-82,4
31,RL,0,250,5,-80.2,-78,-84,6
31,RL,0,250,1,-81,-81,-81,0
31,RL,0,250,8,-82.75,-79,-85,6
31,RL,1,250,9,-83,-79,-85,6
31,RL,0,250,2,-83.5,-83,-84,1
31,RL,1,250,10,-83.2,-80,-85,5
31,RL,0,250,4,-84.25,-83,-85,2
31,RL,0,250,1,-84,-84,-84,0
31,RL,0,250,6,-83.6666666666667,-80,-85,5
31,RL,0,250,4,-83.25,-80,-85,5
31,RL,0,250,1,-80,-80,-80,0
31,RL,0,250,1,-84,-84,-84,0
31,RL,0,250,6,-83.1666666666667,-80,-92,12
31,RL,0,250,6,-83.1666666666667,-80,-92,12
31,RL,0,250,8,-83.75,-81,-92,11
31,RL,0,250,6,-82.6666666666667,-81,-86,5
31,RL,0,250,6,-82.8333333333333,-81,-86,5
31,RL,0,250,3,-82.6666666666667,-81,-84,3
31,RL,0,250,8,-82.625,-79,-86,7
31,RL,0,250,5,-83.2,-82,-86,4
31,RL,1,250,9,-83.4444444444444,-79,-93,14
31,RL,0,250,7,-81.7142857142857,-79,-83,4
31,RL,0,250,6,-81.6666666666667,-79,-83,4
31,RL,0,250,1,-83,-83,-83,0
31,RL,1,250,10,-84.7,-81,-93,12
31,RL,0,250,3,-85.6666666666667,-82,-93,11
31,RL,0,250,2,-87.5,-82,-93,11
31,RL,0,250,2,-81,-81,-81,0
31,RL,1,250,10,-85,-81,-92,11
31,RL,0,250,6,-85.8333333333333,-81,-92,11
31,RL,0,250,8,-84.875,-81,-92,11
31,RL,0,250,6,-85.8333333333333,-81,-92,11
31,RL,0,250,4,-85.5,-82,-88,6
31,RL,0,250,2,-86,-86,-86,0
31,RL,0,250,4,-83.75,-82,-87,5
31,RL,0,250,8,-85.125,-81,-96,15
31,RL,1,250,9,-84.3333333333333,-81,-96,15
31,RL,1,250,10,-83.5,-80,-96,16
31,RL,1,250,9,-83.6666666666667,-80,-96,16
31,RL,0,250,2,-82,-82,-82,0
31,RL,0,250,4,-86,-82,-96,14
31,RL,0,250,5,-82.4,-80,-85,5
31,RL,0,250,2,-82,-81,-83,2
31,RL,0,250,3,-82,-80,-85,5
31,RL,0,250,4,-81.5,-80,-85,5
31,RL,1,250,10,-82.9,-80,-91,11
31,RL,0,250,5,-82.2,-80,-84,4
31,RL,0,250,3,-82.3333333333333,-81,-83,2
31,RL,0,250,1,-83,-83,-83,0
31,RL,0,250,1,-84,-84,-84,0
31,RL,0,250,7,-82.8571428571429,-80,-91,11
31,RL,0,250,1,-81,-81,-81,0
31,RL,1,250,10,-82.3,-80,-91,11
31,RL,0,250,4,-81.5,-80,-83,3
31,RL,0,250,3,-81.3333333333333,-80,-83,3
31,RL,0,250,6,-81.3333333333333,-80,-83,3
31,RL,0,250,5,-81.6,-80,-83,3
31,RL,1,250,10,-82.2,-80,-93,13
31,RL,0,250,2,-81.5,-81,-82,1
31,RL,0,250,8,-82.5,-80,-93,13
31,RL,0,250,7,-82.7142857142857,-80,-93,13
31,RL,1,250,10,-83.4,-80,-93,13
31,RL,0,250,3,-85,-80,-93,13
31,RL,0,250,5,-83.6,-80,-93,13
31,RL,0,250,2,-82,-82,-82,0
31,RL,0,250,6,-84.5,-80,-92,12
31,RL,0,250,5,-85,-80,-92,12
31,RL,0,250,5,-85.8,-80,-92,12
31,RL,0,250,2,-87,-82,-92,10
31,RL,0,250,7,-82.4285714285714,-77,-90,13
31,RL,0,250,8,-83,-77,-90,13
31,RL,1,250,9,-82.5555555555556,-77,-88,11
31,RL,0,250,3,-78,-77,-79,2
31,RL,1,250,10,-82.2,-77,-88,11
31,RL,0,250,2,-82,-82,-82,0
31,RL,0,250,3,-81.3333333333333,-80,-82,2
31,RL,0,250,7,-82.8571428571429,-80,-90,10
31,RL,1,250,9,-85.1111111111111,-80,-90,10
31,RL,1,250,9,-86,-82,-90,8
31,RL,0,250,4,-88,-82,-90,8
31,RL,0,250,5,-86,-82,-90,8
31,RL,0,250,8,-84.75,-80,-90,10
31,RL,0,250,8,-83.5,-80,-88,8
31,RL,0,250,8,-82.75,-79,-88,9
31,RL,1,250,9,-82.4444444444444,-79,-84,5
31,RL,0,250,6,-81.6666666666667,-79,-84,5
31,RL,0,250,5,-81.2,-79,-84,5
31,RL,0,250,5,-82,-79,-84,5
31,RL,0,250,8,-86,-79,-93,14
31,RL,1,250,9,-86.7777777777778,-79,-95,16
31,RL,1,250,10,-87.6,-81,-95,14
31,RL,0,250,5,-88.4,-82,-93,11
31,RL,1,250,10,-88.8,-81,-95,14
31,RL,0,250,6,-89.3333333333333,-81,-95,14
31,RL,0,250,4,-87.75,-81,-95,14
31,RL,0,250,1,-81,-81,-81,0
31,RL,0,250,6,-85.8333333333333,-79,-93,14
31,RL,1,250,10,-83.5,-79,-92,13
31,RL,0,250,2,-85,-82,-88,6
31,RL,0,250,5,-80.6,-79,-84,5
31,RL,0,250,7,-81.8571428571429,-79,-84,5
31,RL,1,250,9,-82.3333333333333,-79,-85,6
31,RL,1,250,9,-82.6666666666667,-79,-85,6
31,RL,0,250,8,-82.5,-79,-85,6
31,RL,1,250,9,-82.6666666666667,-81,-85,4
31,RL,0,250,8,-82.5,-81,-85,4
31,RL,0,250,6,-82.5,-81,-85,4
31,RL,0,250,7,-81.8571428571429,-81,-85,4
31,RL,0,250,2,-81,-81,-81,0
31,RL,0,250,6,-80.6666666666667,-79,-82,3
31,RL,0,250,6,-81.3333333333333,-79,-84,5
31,RL,0,250,6,-82.1666666666667,-79,-84,5
31,RL,0,250,3,-82.6666666666667,-82,-84,2
31,RL,0,250,2,-82,-82,-82,0
31,RL,0,250,8,-83.5,-81,-86,5
31,RL,0,250,5,-83.8,-81,-86,5
31,RL,1,250,9,-83.2222222222222,-81,-86,5
31,RL,0,250,1,-86,-86,-86,0
31,RL,0,250,1,-81,-81,-81,0
31,RL,0,250,3,-83,-82,-84,2
31,RL,0,250,2,-83,-82,-84,2
31,RL,0,250,3,-82,-82,-82,0
31,RL,1,250,10,-82.7,-81,-87,6
31,RL,0,250,3,-81.3333333333333,-81,-82,1
31,RL,0,250,2,-81,-81,-81,0
31,RL,0,250,5,-82.8,-81,-87,6
31,RL,0,250,7,-80,-67,-87,20
31,RL,0,250,2,-84,-81,-87,6
31,RL,0,250,8,-79.875,-67,-87,20
31,RL,0,250,2,-81,-75,-87,12
31,RL,0,250,3,-72.6666666666667,-67,-76,9
31,RL,1,250,9,-80.4444444444444,-67,-87,20
31,RL,1,250,9,-79.8888888888889,-67,-87,20
31,RL,0,250,5,-84,-80,-92,12
31,RL,0,250,6,-78.3333333333333,-67,-87,20
31,RL,0,250,4,-80.5,-76,-85,9
31,RL,0,250,6,-82.6666666666667,-76,-92,16
31,RL,0,250,7,-83,-76,-92,16
31,RL,0,250,5,-85.2,-81,-92,11
31,LR,0,250,4,-84.5,-74,-96,22
31,LR,1,250,9,-74.8888888888889,-68,-96,28
31,LR,0,250,7,-72.8571428571429,-68,-78,10
31,LR,0,250,5,-72.8,-70,-75,5
31,LR,1,250,9,-71,-68,-75,7
31,LR,0,250,8,-71.125,-68,-75,7
31,LR,1,250,10,-71.7,-68,-76,8
31,LR,0,250,2,-68,-68,-68,0
31,LR,0,250,7,-72,-68,-76,8
31,LR,0,250,5,-73.4,-70,-76,6
31,LR,0,250,3,-73.6666666666667,-70,-76,6
31,LR,1,250,9,-72.8888888888889,-70,-76,6
31,LR,0,250,3,-72,-72,-72,0
31,LR,0,250,7,-72.1428571428571,-70,-76,6
31,LR,0,250,6,-72.1666666666667,-70,-76,6
31,LR,0,250,1,-72,-72,-72,0
31,LR,0,250,8,-72.375,-70,-77,7
31,LR,0,250,7,-72.7142857142857,-70,-77,7
31,LR,1,250,10,-76.9,-70,-92,22
31,LR,0,250,8,-77.375,-70,-92,22
31,LR,0,250,1,-75,-75,-75,0
31,LR,0,250,6,-79,-72,-92,20
31,LR,1,250,9,-80,-72,-92,20
31,LR,0,250,5,-81.8,-72,-92,20
31,LR,1,250,10,-82,-72,-92,20
31,LR,0,250,7,-83,-76,-92,16
31,LR,0,250,6,-81.5,-76,-88,12
31,LR,0,250,1,-77,-77,-77,0
31,LR,0,250,2,-84,-82,-86,4
31,LR,0,250,5,-80.2,-75,-92,17
31,LR,0,250,4,-79.75,-75,-92,17
31,LR,0,250,4,-81.75,-76,-92,16
31,LR,0,250,7,-79.8571428571429,-76,-86,10
31,LR,0,250,2,-79.5,-76,-83,7
31,LR,0,250,3,-83.3333333333333,-81,-86,5
31,LR,0,250,3,-82.3333333333333,-80,-86,6
31,LR,0,250,5,-78.2,-72,-86,14
31,LR,1,250,10,-77.5,-72,-83,11
31,LR,0,250,6,-76.5,-72,-83,11
31,LR,0,250,7,-76.7142857142857,-72,-83,11
31,LR,0,250,6,-77.5,-74,-83,9
31,LR,0,250,1,-83,-83,-83,0
31,LR,0,250,3,-76.6666666666667,-74,-79,5
31,LR,0,250,1,-74,-74,-74,0
31,LR,0,250,1,-79,-79,-79,0
31,LR,0,250,6,-79,-76,-81,5
31,LR,0,250,6,-78.3333333333333,-76,-81,5
31,LR,0,250,1,-79,-79,-79,0
31,LR,0,250,7,-76.2857142857143,-72,-80,8
31,LR,0,250,7,-75.7142857142857,-72,-80,8
31,LR,0,250,6,-75.5,-72,-80,8
31,LR,0,250,8,-74,-71,-77,6
31,LR,0,250,2,-76,-75,-77,2
31,LR,0,250,5,-72.6,-71,-75,4
31,LR,0,250,1,-72,-72,-72,0
31,LR,0,250,8,-73,-71,-75,4
31,LR,0,250,8,-73.25,-71,-75,4
31,LR,0,250,3,-73.6666666666667,-71,-75,4
31,LR,0,250,7,-73.8571428571429,-72,-76,4
31,LR,0,250,2,-72,-72,-72,0
31,LR,0,250,1,-74,-74,-74,0
31,LR,1,250,9,-73.4444444444444,-71,-76,5
31,LR,0,250,6,-72.8333333333333,-71,-76,5
31,LR,1,250,10,-73.7,-71,-78,7
31,LR,0,250,3,-72,-71,-74,3
31,LR,0,250,5,-72.6,-71,-75,4
31,LR,0,250,4,-73,-71,-75,4
31,LR,0,250,4,-74,-71,-75,4
31,LR,0,250,5,-76.2,-71,-81,10
31,LR,0,250,5,-77.2,-75,-81,6
31,LR,0,250,5,-82.6,-76,-93,17
31,LR,0,250,1,-76,-76,-76,0
31,LR,0,250,2,-84.5,-76,-93,17
31,LR,0,250,8,-84.25,-79,-87,8
31,LR,0,250,1,-86,-86,-86,0
31,LR,0,250,3,-84,-80,-86,6
31,LR,0,250,5,-85.6,-79,-92,13
31,LR,0,250,2,-85.5,-85,-86,1
31,LR,0,250,2,-82,-79,-85,6
31,LR,0,250,6,-85.1666666666667,-79,-92,13
31,LR,1,250,9,-84.5555555555556,-77,-92,15
31,LR,1,250,9,-83.7777777777778,-77,-88,11
31,LR,0,250,1,-83,-83,-83,0
31,LR,0,250,5,-83.4,-77,-88,11
31,LR,1,250,10,-83.8,-77,-88,11
31,LR,0,250,3,-81.3333333333333,-77,-86,9
31,LR,0,250,1,-81,-81,-81,0
31,LR,0,250,4,-84.5,-84,-85,1
31,LR,0,250,3,-84.3333333333333,-84,-85,1
31,LR,0,250,6,-86,-82,-90,8
31,LR,0,250,4,-85.75,-82,-90,8
31,LR,0,250,2,-89,-88,-90,2
31,LR,1,250,10,-84.4,-76,-95,19
31,LR,0,250,5,-85.6,-78,-95,17
31,LR,1,250,10,-84.6,-76,-95,19
31,LR,0,250,4,-83.25,-76,-95,19
31,LR,0,250,7,-83.4285714285714,-76,-92,16
31,LR,0,250,5,-84.8,-79,-92,13
31,LR,0,250,5,-82.6,-79,-92,13
31,LR,0,250,6,-82.6666666666667,-78,-92,14
31,LR,1,250,10,-80.4,-74,-86,12
31,LR,0,250,1,-78,-78,-78,0
31,LR,1,250,10,-78.9,-74,-86,12
31,LR,0,250,5,-81,-74,-86,12
31,LR,0,250,1,-74,-74,-74,0
31,LR,0,250,3,-83,-77,-86,9
31,LR,0,250,3,-80,-77,-86,9
31,LR,0,250,2,-76,-75,-77,2
31,LR,0,250,7,-76.4285714285714,-74,-80,6
31,LR,0,250,2,-78.5,-78,-79,1
31,LR,0,250,2,-76.5,-74,-79,5
31,LR,0,250,5,-76,-74,-80,6
31,LR,0,250,7,-79.1428571428571,-74,-84,10
31,LR,0,250,8,-78.375,-74,-84,10
31,LR,0,250,8,-77.75,-74,-84,10
31,LR,0,250,4,-78.5,-74,-84,10
31,LR,0,250,5,-77.6,-76,-80,4
31,LR,0,250,8,-78.5,-74,-83,9
31,LR,0,250,7,-78.4285714285714,-74,-83,9
31,LR,0,250,4,-79.75,-77,-83,6
31,LR,0,250,7,-79.2857142857143,-74,-83,9
31,LR,1,250,10,-79.2,-74,-83,9
31,LR,0,250,5,-79.2,-74,-83,9
31,LR,1,250,9,-77.7777777777778,-73,-82,9
31,LR,0,250,2,-78,-74,-82,8
31,LR,0,250,7,-78,-73,-82,9
31,LR,0,250,4,-78.5,-77,-81,4
31,LR,0,250,5,-77.4,-73,-81,8
31,LR,0,250,8,-76.625,-73,-81,8
31,LR,0,250,8,-77.25,-73,-86,13
31,LR,0,250,5,-78,-73,-86,13
31,LR,0,250,6,-78,-73,-86,13
31,LR,0,250,2,-74.5,-73,-76,3
31,LR,0,250,4,-78.75,-74,-86,12
31,LR,1,250,9,-78.1111111111111,-74,-84,10
31,LR,0,250,4,-77.75,-74,-84,10
31,LR,0,250,5,-79.4,-74,-84,10
31,LR,0,250,3,-81.3333333333333,-79,-84,5
31,LR,0,250,1,-79,-79,-79,0
31,LR,0,250,7,-79.1428571428571,-74,-85,11
31,LR,0,250,1,-77,-77,-77,0
31,LR,0,250,6,-78.6666666666667,-74,-85,11
31,LR,0,250,6,-78.1666666666667,-75,-85,10
31,LR,0,250,8,-79.75,-72,-89,17
31,LR,0,250,4,-77.25,-76,-79,3
31,LR,0,250,8,-79.625,-72,-89,17
31,LR,0,250,2,-82.5,-76,-89,13
31,LR,0,250,3,-77,-72,-83,11
31,LR,0,250,2,-79.5,-76,-83,7
31,LR,0,250,1,-76,-76,-76,0
31,LR,0,250,8,-78.5,-75,-86,11
31,LR,0,250,3,-76.3333333333333,-76,-77,1
31,LR,1,250,10,-78.6,-75,-86,11
31,LR,0,250,1,-76,-76,-76,0
31,LR,0,250,8,-79.125,-75,-86,11
31,LR,0,250,8,-79.125,-75,-86,11
31,LR,0,250,7,-78.5714285714286,-76,-81,5
31,LR,0,250,8,-78.5,-73,-85,12
31,LR,0,250,2,-79,-78,-80,2
31,LR,0,250,5,-78.4,-73,-85,12
31,LR,0,250,1,-76,-76,-76,0
31,LR,0,250,8,-78.5,-73,-85,12
31,LR,0,250,5,-78.4,-73,-85,12
31,LR,0,250,3,-78,-74,-80,6
31,LR,1,250,10,-79.7,-74,-86,12
31,LR,0,250,7,-80,-75,-86,11
31,LR,0,250,6,-80,-75,-86,11
31,LR,0,250,8,-79.875,-74,-86,12
31,LR,0,250,1,-79,-79,-79,0
31,LR,0,250,5,-79.6,-74,-86,12
31,LR,0,250,6,-78.3333333333333,-72,-86,14
31,LR,0,250,1,-82,-82,-82,0
31,LR,1,250,10,-79.9,-72,-87,15
31,LR,0,250,3,-74.6666666666667,-72,-77,5
31,LR,0,250,6,-82,-77,-87,10
31,LR,0,250,2,-80,-80,-80,0
31,LR,0,250,7,-84.8571428571429,-80,-89,9
31,LR,0,250,7,-85.2857142857143,-82,-89,7
31,LR,0,250,3,-86.3333333333333,-86,-87,1
31,LR,0,250,6,-84.8333333333333,-81,-89,8
31,LR,0,250,3,-85.3333333333333,-83,-89,6
31,LR,0,250,8,-79.25,-73,-84,11
31,LR,0,250,1,-81,-81,-81,0
31,LR,0,250,4,-77,-73,-80,7
31,LR,0,250,8,-77.375,-73,-80,7
31,LR,1,250,10,-77.8,-73,-84,11
31,LR,0,250,2,-75.5,-73,-78,5
31,LR,0,250,4,-78,-77,-79,2
31,LR,0,250,6,-77.1666666666667,-73,-81,8
31,LR,0,250,4,-76.25,-73,-79,6
31,LR,0,250,6,-77.6666666666667,-73,-84,11
31,LR,1,250,10,-79.4,-73,-88,15
31,LR,0,250,3,-79.3333333333333,-73,-84,11
31,LR,1,250,9,-79.6666666666667,-73,-88,15
31,LR,0,250,5,-78.8,-73,-86,13
31,LR,0,250,6,-80,-74,-88,14
31,LR,0,250,4,-79.25,-74,-88,14
31,LR,0,250,7,-78.1428571428571,-74,-88,14
31,LR,0,250,4,-78.5,-74,-88,14
31,LR,0,250,2,-75.5,-74,-77,3
31,LR,1,250,9,-78,-74,-89,15
31,LR,0,250,2,-75,-75,-75,0
31,LR,0,250,8,-78.5,-74,-89,15
31,LR,1,250,10,-79.3,-74,-89,15
31,LR,1,250,9,-79.3333333333333,-74,-89,15
31,LR,0,250,1,-78,-78,-78,0
31,LR,0,250,3,-77.6666666666667,-76,-79,3
31,LR,1,250,9,-78.7777777777778,-72,-93,21
31,LR,0,250,4,-79.75,-77,-84,7
31,LR,0,250,1,-84,-84,-84,0
31,LR,0,250,1,-77,-77,-77,0
31,LR,0,250,4,-79.5,-72,-93,21
31,LR,0,250,2,-83.5,-74,-93,19
31,LR,0,250,6,-76.1666666666667,-72,-84,12
31,LR,0,250,6,-76.3333333333333,-73,-84,11
31,LR,0,250,3,-76,-73,-80,7
31,LR,0,250,7,-79,-73,-91,18
31,LR,0,250,1,-80,-80,-80,0
31,LR,1,250,9,-78.7777777777778,-73,-91,18
31,LR,0,250,6,-77.8333333333333,-73,-91,18
31,LR,0,250,5,-78.8,-73,-91,18
31,LR,0,250,8,-80,-73,-91,18
31,LR,0,250,5,-80,-73,-91,18
31,LR,1,250,9,-80.5555555555556,-73,-86,13
31,LR,1,250,10,-81.2,-73,-86,13
31,LR,0,250,7,-81.5714285714286,-73,-86,13
31,LR,0,250,7,-81.5714285714286,-73,-86,13
31,LR,0,250,1,-86,-86,-86,0
31,LR,0,250,8,-78.25,-72,-84,12
31,LR,1,250,10,-78,-72,-84,12
31,LR,0,250,7,-76.5714285714286,-72,-83,11
31,LR,0,250,7,-75.8571428571429,-72,-83,11
31,LR,0,250,6,-74.6666666666667,-72,-77,5
31,LR,0,250,7,-76.5714285714286,-74,-83,9
31,LR,0,250,1,-74,-74,-74,0
31,LR,0,250,2,-75,-74,-76,2
31,LR,0,250,2,-80,-77,-83,6
31,LR,1,250,9,-79.4444444444444,-74,-89,15
31,LR,0,250,5,-78.6,-74,-86,12
31,LR,1,250,9,-80.2222222222222,-74,-89,15
31,LR,0,250,4,-79.25,-75,-86,11
31,LR,1,250,9,-79.2222222222222,-72,-89,17
31,LR,0,250,3,-81.6666666666667,-75,-89,14
31,LR,0,250,4,-81,-75,-89,14
31,LR,1,250,9,-79.8888888888889,-72,-89,17
31,LR,0,250,1,-85,-85,-85,0
31,LR,1,250,10,-77.4,-72,-87,15
31,LR,0,250,2,-75.5,-72,-79,7
31,LR,1,250,10,-77.1,-72,-87,15
31,LR,0,250,2,-80.5,-74,-87,13
31,LR,1,250,9,-76.4444444444444,-72,-83,11
31,LR,0,250,1,-78,-78,-78,0
31,LR,0,250,6,-77.8333333333333,-73,-83,10
31,LR,0,250,3,-78,-73,-83,10
31,LR,0,250,2,-78,-73,-83,10
31,LR,0,250,5,-77.4,-73,-83,10
31,LR,0,250,2,-77,-74,-80,6
31,LR,0,250,1,-80,-80,-80,0
31,LR,0,250,4,-74.5,-73,-77,4
31,LR,0,250,5,-75.6,-73,-77,4
31,LR,0,250,4,-75.25,-73,-77,4
31,LR,0,250,5,-78.2,-73,-86,13
31,LR,0,250,2,-76.5,-76,-77,1
31,LR,0,250,2,-78,-77,-79,2
31,LR,1,250,10,-80.6,-74,-88,14
31,LR,0,250,3,-83.6666666666667,-82,-86,4
31,LR,1,250,10,-79.4,-73,-88,15
31,LR,0,250,5,-78,-74,-88,14
31,LR,1,250,10,-78,-73,-86,13
31,LR,0,250,8,-78.375,-73,-86,13
31,LR,0,250,3,-78,-73,-86,13
31,LR,0,250,3,-79.6666666666667,-73,-86,13
31,LR,1,250,9,-79.4444444444444,-75,-85,10
31,LR,0,250,4,-78,-75,-80,5
31,LR,0,250,7,-79.7142857142857,-75,-85,10
31,LR,0,250,5,-78.6,-75,-80,5
31,LR,0,250,4,-78.5,-75,-80,5
31,LR,0,250,6,-80.5,-78,-85,7
31,LR,0,250,7,-79.4285714285714,-72,-85,13
31,LR,1,250,9,-79.3333333333333,-72,-88,16
31,LR,0,250,3,-80,-78,-81,3
31,LR,0,250,8,-79,-72,-88,16
31,LR,0,250,5,-77.8,-72,-88,16
31,LR,0,250,2,-80,-72,-88,16
31,LR,1,250,10,-79,-72,-88,16
31,LR,0,250,8,-79.625,-74,-88,14
31,LR,0,250,5,-80.4,-74,-88,14
31,LR,0,250,8,-78.875,-74,-88,14
31,LR,0,250,2,-76,-74,-78,4
31,LR,0,250,1,-74,-74,-74,0
31,LR,0,250,2,-82.5,-77,-88,11
31,LR,0,250,8,-77.375,-75,-81,6
31,LR,0,250,3,-77,-75,-81,6
31,LR,0,250,2,-78,-75,-81,6
31,LR,0,250,3,-77.6666666666667,-75,-80,5
31,LR,0,250,2,-79,-78,-80,2
31,LR,0,250,2,-76.5,-75,-78,3
31,LR,0,250,6,-75.5,-73,-78,5
31,LR,0,250,3,-75.6666666666667,-73,-78,5
31,LR,0,250,2,-74.5,-73,-76,3
31,LR,0,250,8,-79.5,-73,-100,27
31,LR,1,250,9,-79.6666666666667,-73,-100,27
31,LR,0,250,2,-76,-73,-79,6
31,LR,0,250,8,-80.125,-75,-100,25
31,LR,0,250,5,-82.2,-75,-100,25
31,LR,0,250,8,-81.125,-75,-100,25
31,LR,0,250,8,-80.25,-74,-100,26
31,LR,0,250,8,-78.75,-74,-88,14
31,LR,0,250,8,-79.625,-74,-88,14
31,LR,0,250,8,-80.875,-74,-88,14
31,LR,0,250,4,-81.5,-74,-88,14
31,LR,1,250,10,-81.4,-74,-88,14
31,LR,0,250,1,-74,-74,-74,0
31,LR,1,250,9,-81.1111111111111,-76,-86,10
31,LR,0,250,3,-82,-78,-86,8
31,LR,0,250,1,-86,-86,-86,0
31,LR,0,250,5,-80.4,-76,-83,7
31,LR,0,250,2,-82.5,-82,-83,1
31,LR,0,250,4,-80.25,-78,-82,4
31,LR,0,250,8,-79.375,-73,-88,15
31,LR,0,250,4,-80,-73,-88,15
31,LR,0,250,6,-79,-73,-88,15
31,LR,0,250,6,-78,-72,-88,16
31,LR,0,250,7,-79,-72,-83,11
31,LR,0,250,8,-79.875,-72,-87,15
31,LR,1,250,10,-79.5,-72,-87,15
31,LR,0,250,6,-80.6666666666667,-72,-87,15
31,LR,1,250,10,-80.4,-75,-87,12
31,LR,0,250,3,-82.6666666666667,-79,-87,8
31,LR,0,250,6,-80.6666666666667,-75,-87,12
31,LR,0,250,1,-79,-79,-79,0
31,LR,0,250,8,-79.25,-75,-85,10
31,LR,0,250,2,-80,-75,-85,10
31,LR,0,250,2,-82.5,-80,-85,5
31,LR,0,250,2,-77.5,-75,-80,5
31,LR,0,250,6,-77.1666666666667,-74,-82,8
31,LR,0,250,6,-78.3333333333333,-74,-82,8
31,LR,0,250,5,-77.8,-74,-82,8
31,LR,1,250,10,-78.6,-72,-98,26
31,LR,0,250,3,-76.6666666666667,-74,-82,8
31,LR,0,250,5,-78.4,-74,-82,8
31,LR,0,250,4,-79.5,-75,-82,7
31,LR,0,250,5,-81.4,-73,-98,25
31,LR,0,250,1,-79,-79,-79,0
31,LR,1,250,10,-79.8,-72,-98,26
31,LR,0,250,3,-77,-72,-86,14
31,LR,0,250,5,-77.6,-72,-86,14
31,LR,0,250,1,-86,-86,-86,0
31,LR,0,250,5,-77.8,-75,-83,8
31,LR,1,250,9,-76.4444444444444,-71,-83,12
31,LR,0,250,2,-81.5,-80,-83,3
31,LR,0,250,4,-77.5,-73,-83,10
31,LR,0,250,1,-81,-81,-81,0
31,LR,1,250,9,-77.3333333333333,-73,-83,10
31,LR,0,250,4,-81,-71,-93,22
31,LR,0,250,2,-80,-76,-84,8
31,LR,0,250,7,-77.2857142857143,-71,-84,13
31,LR,0,250,8,-79.25,-71,-93,22
31,LR,0,250,5,-82.8,-71,-93,22
31,LR,0,250,2,-87.5,-85,-90,5
26,RL,1,250,9,-74.1111111111111,-68,-81,13
26,RL,0,250,5,-72.2,-68,-78,10
26,RL,0,250,5,-75.2,-68,-81,13
26,RL,0,250,1,-68,-68,-68,0
26,RL,0,250,6,-78,-71,-83,12
26,RL,1,250,10,-78.3,-72,-83,11
26,RL,0,250,6,-78.8333333333333,-76,-83,7
26,RL,0,250,8,-77.625,-72,-83,11
26,RL,1,250,10,-76.7,-72,-80,8
26,RL,1,250,10,-76.4,-72,-79,7
26,RL,0,250,5,-76.2,-72,-79,7
26,RL,0,250,6,-75.6666666666667,-72,-79,7
26,RL,0,250,2,-76,-75,-77,2
26,RL,0,250,8,-77.25,-74,-82,8
26,RL,1,250,9,-78.2222222222222,-74,-83,9
26,RL,0,250,6,-77.8333333333333,-74,-82,8
26,RL,0,250,1,-74,-74,-74,0
26,RL,0,250,3,-78.3333333333333,-74,-82,8
26,RL,0,250,7,-80.2857142857143,-74,-84,10
26,RL,0,250,3,-77,-74,-79,5
26,RL,0,250,7,-80.7142857142857,-78,-84,6
26,RL,0,250,2,-80.5,-78,-83,5
26,RL,1,250,9,-80.8888888888889,-79,-84,5
26,RL,0,250,4,-80.25,-79,-82,3
26,RL,1,250,10,-80.2,-79,-82,3
26,RL,1,250,10,-80.5,-79,-83,4
26,RL,0,250,4,-80.25,-79,-81,2
26,RL,1,250,10,-80.2,-78,-83,5
26,RL,0,250,7,-80.1428571428571,-78,-83,5
26,RL,0,250,3,-81,-79,-83,4
26,RL,1,250,10,-80.9,-77,-90,13
26,RL,1,250,10,-80.7,-77,-90,13
26,RL,0,250,5,-81,-77,-90,13
26,RL,0,250,1,-78,-78,-78,0
26,RL,0,250,3,-83,-77,-90,13
26,RL,0,250,5,-82.6,-79,-90,11
26,RL,0,250,7,-80.7142857142857,-79,-82,3
26,RL,0,250,8,-79.75,-77,-82,5
26,RL,0,250,8,-79.125,-77,-82,5
26,RL,1,250,10,-79.8,-77,-86,9
26,RL,0,250,6,-78.5,-77,-80,3
26,RL,0,250,4,-78.5,-77,-80,3
26,RL,0,250,2,-77.5,-77,-78,1
26,RL,0,250,8,-80.25,-77,-86,9
26,RL,0,250,2,-78.5,-77,-80,3
26,RL,0,250,3,-80.6666666666667,-77,-86,9
26,RL,0,250,7,-80.8571428571429,-79,-86,7
26,RL,0,250,6,-80,-79,-82,3
26,RL,1,250,9,-79.7777777777778,-78,-82,4
26,RL,0,250,8,-80.125,-78,-83,5
26,RL,0,250,6,-79.8333333333333,-78,-83,5
26,RL,0,250,4,-79.25,-78,-80,2
26,RL,0,250,3,-79.6666666666667,-79,-80,1
26,RL,0,250,8,-82,-79,-88,9
26,RL,0,250,8,-81.75,-78,-88,10
26,RL,0,250,6,-82.6666666666667,-79,-88,9
26,RL,0,250,5,-82.6,-79,-88,9
26,RL,1,250,10,-80.5,-78,-88,10
26,RL,1,250,9,-80.3333333333333,-78,-88,10
26,RL,0,250,2,-85,-82,-88,6
26,RL,0,250,4,-79,-78,-82,4
26,RL,1,250,10,-80.5,-78,-83,5
26,RL,1,250,10,-81.3,-78,-86,8
26,RL,0,250,6,-80.6666666666667,-79,-82,3
26,RL,0,250,4,-80.5,-79,-82,3
26,RL,1,250,9,-82.4444444444444,-80,-86,6
26,RL,0,250,8,-82.625,-80,-86,6
26,RL,1,250,10,-82.7,-80,-86,6
26,RL,1,250,10,-82.7,-80,-86,6
26,RL,1,250,9,-82.7777777777778,-80,-86,6
26,RL,0,250,5,-83.2,-82,-86,4
26,RL,0,250,6,-83,-80,-86,6
26,RL,0,250,3,-82.6666666666667,-82,-83,1
26,RL,0,250,5,-82.2,-80,-84,4
26,RL,0,250,7,-80.7142857142857,-78,-84,6
26,RL,0,250,6,-80.8333333333333,-78,-84,6
26,RL,0,250,6,-80,-78,-82,4
26,RL,0,250,3,-80.3333333333333,-78,-82,4
26,RL,0,250,8,-80.75,-78,-88,10
26,RL,0,250,8,-81,-78,-88,10
26,RL,0,250,4,-81.5,-78,-88,10
26,RL,0,250,3,-79.3333333333333,-78,-80,2
26,RL,1,250,10,-81.4,-78,-84,6
26,RL,1,250,10,-81.6,-78,-84,6
26,RL,1,250,10,-81.7,-79,-84,5
26,RL,0,250,7,-81.7142857142857,-79,-83,4
26,RL,0,250,8,-81.75,-79,-83,4
26,RL,0,250,1,-82,-82,-82,0
26,RL,0,250,4,-82,-80,-83,3
26,RL,0,250,1,-82,-82,-82,0
26,RL,0,250,5,-80.4,-79,-82,3
26,RL,0,250,7,-83.5714285714286,-79,-94,15
26,RL,0,250,4,-83.5,-79,-94,15
26,RL,1,250,10,-84.2,-78,-94,16
26,RL,1,250,10,-85,-78,-94,16
26,RL,0,250,4,-81.25,-78,-84,6
26,RL,1,250,10,-83.4,-78,-90,12
26,RL,0,250,7,-84.5714285714286,-78,-90,12
26,RL,0,250,8,-84.125,-78,-90,12
26,RL,1,250,10,-83.8,-78,-90,12
26,RL,0,250,7,-82.7142857142857,-78,-88,10
26,RL,0,250,8,-83.25,-78,-94,16
26,RL,0,250,1,-81,-81,-81,0
26,RL,0,250,4,-82.5,-79,-88,9
26,RL,0,250,6,-86,-81,-94,13
26,RL,0,250,6,-85.5,-79,-94,15
26,RL,0,250,1,-94,-94,-94,0
26,RL,0,250,1,-81,-81,-81,0
26,RL,0,250,2,-84.5,-79,-90,11
26,RL,0,250,4,-80.25,-78,-83,5
26,RL,0,250,2,-80.5,-78,-83,5
26,RL,0,250,2,-82,-81,-83,2
26,RL,0,250,4,-81,-78,-84,6
26,RL,0,250,8,-81.75,-79,-84,5
26,RL,0,250,8,-81.75,-79,-84,5
26,RL,0,250,8,-81.625,-79,-84,5
26,RL,0,250,7,-82.2857142857143,-79,-84,5
26,RL,0,250,6,-81.3333333333333,-78,-84,6
26,RL,0,250,3,-81.3333333333333,-79,-84,5
26,RL,0,250,8,-82.75,-78,-86,8
26,RL,0,250,3,-80,-78,-83,5
26,RL,0,250,2,-80.5,-78,-83,5
26,RL,0,250,3,-82,-78,-85,7
26,RL,0,250,6,-84.3333333333333,-82,-86,4
26,RL,0,250,7,-83.1428571428571,-79,-86,7
26,RL,0,250,6,-82.6666666666667,-79,-86,7
26,RL,1,250,10,-80.8,-78,-86,8
26,RL,0,250,8,-80.375,-78,-85,7
26,RL,0,250,1,-85,-85,-85,0
26,RL,0,250,2,-79,-78,-80,2
26,RL,0,250,5,-79.2,-78,-81,3
26,RL,0,250,5,-81.2,-79,-86,7
26,RL,0,250,1,-79,-79,-79,0
26,RL,0,250,2,-83.5,-81,-86,5
26,RL,0,250,5,-81.6,-79,-86,7
26,RL,0,250,4,-80.5,-79,-82,3
26,RL,0,250,8,-80.75,-79,-82,3
26,RL,1,250,9,-80.6666666666667,-79,-82,3
26,RL,1,250,9,-80.4444444444444,-79,-82,3
26,RL,0,250,8,-80.625,-79,-82,3
26,RL,1,250,9,-81.3333333333333,-79,-85,6
26,RL,1,250,9,-81.2222222222222,-79,-85,6
26,RL,0,250,1,-79,-79,-79,0
26,RL,0,250,1,-80,-80,-80,0
26,RL,0,250,6,-82,-81,-85,4
26,RL,0,250,5,-81.8,-81,-85,4
26,RL,0,250,4,-81,-81,-81,0
26,RL,0,250,4,-82,-81,-85,4
26,RL,0,250,4,-82,-81,-85,4
26,RL,0,250,3,-82.3333333333333,-81,-85,4
26,RL,0,250,7,-82.4285714285714,-79,-87,8
26,RL,0,250,2,-80,-79,-81,2
26,RL,0,250,4,-82.5,-79,-87,8
26,RL,1,250,9,-82.4444444444444,-77,-91,14
26,RL,1,250,10,-83,-77,-91,14
26,RL,1,250,10,-82.8,-77,-91,14
26,RL,0,250,4,-80.5,-77,-82,5
26,RL,0,250,1,-82,-82,-82,0
26,RL,0,250,1,-77,-77,-77,0
26,RL,0,250,2,-84.5,-78,-91,13
26,RL,1,250,10,-82,-78,-85,7
26,RL,0,250,3,-83.3333333333333,-82,-85,3
26,RL,0,250,1,-85,-85,-85,0
26,RL,0,250,7,-82.4285714285714,-79,-87,8
26,RL,0,250,8,-83.125,-79,-88,9
26,RL,0,250,4,-81.5,-79,-84,5
26,RL,0,250,6,-84,-79,-88,9
26,RL,0,250,1,-79,-79,-79,0
26,RL,0,250,3,-85.6666666666667,-82,-88,6
26,RL,0,250,4,-85.25,-82,-88,6
26,RL,0,250,4,-86.75,-83,-88,5
26,RL,0,250,7,-82.2857142857143,-79,-88,9
26,RL,0,250,8,-82.25,-79,-88,9
26,RL,0,250,5,-81,-79,-85,6
26,RL,0,250,7,-81.1428571428571,-77,-86,9
26,RL,1,250,10,-81.6,-77,-86,9
26,RL,0,250,3,-81.3333333333333,-79,-85,6
26,RL,1,250,10,-81.9,-77,-86,9
26,RL,0,250,5,-81,-77,-86,9
26,RL,0,250,3,-80,-77,-82,5
26,RL,0,250,8,-82.75,-81,-84,3
26,RL,1,250,9,-82.6666666666667,-80,-84,4
26,RL,0,250,5,-83.6,-82,-84,2
26,RL,0,250,5,-83,-81,-84,3
26,RL,0,250,7,-81.8571428571429,-76,-84,8
26,RL,0,250,8,-81.5,-76,-84,8
26,RL,1,250,9,-81.1111111111111,-76,-84,8
26,RL,0,250,1,-81,-81,-81,0
26,RL,1,250,9,-81.7777777777778,-76,-85,9
26,RL,0,250,5,-80.2,-76,-83,7
26,RL,1,250,10,-82.8,-80,-86,6
26,RL,0,250,8,-83.125,-80,-86,6
26,RL,0,250,4,-82.75,-80,-85,5
26,RL,0,250,8,-83.875,-81,-86,5
26,RL,0,250,2,-83,-81,-85,4
26,RL,0,250,1,-81,-81,-81,0
26,RL,0,250,7,-84.2857142857143,-82,-86,4
26,RL,0,250,3,-84.3333333333333,-83,-85,2
26,RL,0,250,8,-81.625,-77,-86,9
26,RL,0,250,4,-84,-82,-86,4
26,RL,0,250,8,-81.25,-76,-89,13
26,RL,1,250,9,-82.7777777777778,-76,-93,17
26,RL,0,250,4,-77.5,-76,-79,3
26,RL,1,250,9,-82.2222222222222,-76,-93,17
26,RL,0,250,5,-84.2,-76,-93,17
26,RL,0,250,6,-84.3333333333333,-76,-93,17
26,RL,0,250,2,-91,-89,-93,4
26,RL,0,250,5,-81.6,-78,-84,6
26,RL,0,250,3,-80.6666666666667,-78,-82,4
26,RL,0,250,8,-80.375,-78,-84,6
26,RL,0,250,1,-78,-78,-78,0
26,RL,0,250,7,-80.8571428571429,-77,-88,11
26,RL,0,250,3,-79.3333333333333,-77,-81,4
26,RL,0,250,2,-78.5,-77,-80,3
26,RL,0,250,8,-81.875,-76,-88,12
26,RL,0,250,3,-83.3333333333333,-76,-88,12
26,RL,0,250,7,-81.4285714285714,-76,-88,12
26,RL,0,250,2,-81.5,-77,-86,9
26,RL,0,250,7,-82.8571428571429,-77,-89,12
26,RL,0,250,7,-83.7142857142857,-80,-89,9
26,RL,0,250,6,-83,-80,-89,9
26,RL,0,250,4,-83.75,-80,-89,9
26,RL,0,250,4,-83.75,-80,-89,9
26,RL,0,250,1,-83,-83,-83,0
26,RL,0,250,7,-84.4285714285714,-80,-89,9
26,RL,0,250,4,-82.75,-80,-86,6
26,RL,0,250,6,-85.3333333333333,-81,-89,8
26,RL,0,250,5,-86.2,-84,-89,5
26,RL,0,250,1,-86,-86,-86,0
26,RL,0,250,4,-86.25,-84,-89,5
26,RL,0,250,4,-84.5,-81,-89,8
26,RL,1,250,10,-83.4,-79,-86,7
26,RL,0,250,3,-83.3333333333333,-81,-85,4
26,RL,0,250,3,-83,-81,-85,4
26,RL,0,250,3,-83.3333333333333,-82,-85,3
26,RL,1,250,9,-83.5555555555556,-79,-86,7
26,RL,1,250,9,-83,-79,-86,7
26,RL,0,250,6,-83.5,-79,-86,7
26,RL,1,250,9,-83.2222222222222,-79,-87,8
26,RL,0,250,6,-82.3333333333333,-79,-86,7
26,RL,0,250,5,-83,-80,-86,6
26,RL,0,250,7,-82.5714285714286,-80,-87,7
26,RL,0,250,8,-82.625,-80,-87,7
26,RL,1,250,9,-81.8888888888889,-80,-87,7
26,RL,0,250,5,-82.2,-80,-87,7
26,RL,0,250,7,-81.8571428571429,-80,-87,7
26,RL,0,250,4,-82.5,-80,-87,7
26,RL,0,250,1,-82,-82,-82,0
26,RL,1,250,10,-81.8,-79,-86,7
26,RL,0,250,2,-80.5,-80,-81,1
26,RL,0,250,3,-81.3333333333333,-81,-82,1
26,RL,1,250,9,-81.7777777777778,-79,-86,7
26,RL,0,250,5,-82.4,-79,-86,7
26,RL,0,250,8,-82.125,-79,-86,7
26,RL,0,250,3,-82.6666666666667,-79,-86,7
26,RL,0,250,2,-81,-79,-83,4
26,RL,0,250,3,-82.3333333333333,-81,-83,2
26,RL,0,250,4,-86.5,-84,-91,7
26,RL,0,250,8,-85.125,-80,-91,11
26,RL,1,250,10,-84.4,-80,-93,13
26,RL,0,250,4,-84.75,-83,-90,7
26,RL,0,250,4,-84,-80,-90,10
26,RL,0,250,4,-84,-80,-93,13
26,RL,1,250,9,-84.5555555555556,-79,-93,14
26,RL,1,250,10,-85.3,-79,-93,14
26,RL,0,250,6,-86.3333333333333,-79,-93,14
26,RL,0,250,3,-88.3333333333333,-85,-92,7
26,RL,1,250,10,-84.1,-79,-92,13
26,RL,0,250,3,-84.6666666666667,-79,-92,13
26,RL,0,250,5,-84,-79,-91,12
26,RL,0,250,6,-83.8333333333333,-81,-91,10
26,RL,0,250,3,-86,-81,-91,10
26,RL,0,250,5,-82.2,-81,-86,5
26,RL,0,250,1,-86,-86,-86,0
26,RL,0,250,5,-81.2,-78,-84,6
26,RL,0,250,2,-81.5,-81,-82,1
26,RL,1,250,10,-82.2,-78,-97,19
26,RL,0,250,5,-84.2,-78,-97,19
26,RL,0,250,6,-82.6666666666667,-78,-97,19
26,RL,0,250,1,-81,-81,-81,0
26,RL,0,250,1,-80,-80,-80,0
26,RL,0,250,7,-81.5714285714286,-78,-90,12
26,RL,0,250,7,-81.7142857142857,-78,-90,12
26,RL,0,250,4,-83.5,-81,-90,9
26,RL,0,250,6,-82.8333333333333,-80,-90,10
26,RL,1,250,9,-84,-77,-98,21
26,RL,0,250,1,-80,-80,-80,0
26,RL,0,250,5,-84.2,-77,-98,21
26,RL,1,250,10,-83.3,-77,-98,21
26,RL,0,250,8,-82.625,-77,-98,21
26,RL,0,250,5,-84,-78,-98,20
26,RL,1,250,10,-82.8,-78,-88,10
26,RL,0,250,4,-80.75,-78,-84,6
26,RL,0,250,4,-81.75,-78,-88,10
26,RL,0,250,5,-83.8,-79,-88,9
26,RL,0,250,3,-86,-82,-88,6
26,RL,0,250,2,-82.5,-82,-83,1
26,RL,0,250,3,-81.6666666666667,-79,-83,4
26,RL,0,250,8,-80.875,-78,-83,5
26,RL,0,250,4,-80.75,-79,-82,3
26,RL,0,250,2,-81,-80,-82,2
26,RL,0,250,7,-81.7142857142857,-78,-90,12
26,RL,0,250,8,-81.25,-78,-90,12
26,RL,0,250,5,-81.4,-78,-90,12
26,RL,1,250,10,-83.1,-78,-94,16
26,RL,1,250,10,-83.1,-78,-94,16
26,RL,0,250,2,-84,-78,-90,12
26,RL,0,250,5,-84,-78,-94,16
26,RL,0,250,2,-88,-82,-94,12
26,RL,0,250,8,-83.125,-79,-94,15
26,RL,1,250,9,-81.6666666666667,-79,-86,7
26,RL,1,250,9,-81.7777777777778,-79,-86,7
26,RL,0,250,6,-80.8333333333333,-79,-84,5
26,RL,1,250,9,-81.3333333333333,-79,-84,5
26,RL,0,250,4,-81.5,-80,-84,4
26,RL,0,250,4,-82,-80,-84,4
26,RL,0,250,8,-80.25,-73,-84,11
26,RL,0,250,3,-81,-79,-83,4
26,RL,0,250,7,-79,-73,-83,10
26,RL,1,250,10,-78.7,-68,-91,23
26,RL,0,250,6,-76.5,-68,-82,14
26,RL,0,250,1,-80,-80,-80,0
26,RL,0,250,2,-74.5,-73,-76,3
26,RL,0,250,1,-68,-68,-68,0
26,RL,1,250,10,-79.2,-68,-91,23
26,RL,0,250,2,-84.5,-78,-91,13
26,RL,0,250,3,-83,-78,-91,13
26,RL,0,250,5,-83,-78,-91,13
26,LR,0,250,3,-77.3333333333333,-72,-82,10
26,LR,0,250,5,-83.2,-72,-93,21
26,LR,0,250,1,-93,-93,-93,0
26,LR,0,250,8,-81.75,-70,-90,20
26,LR,0,250,6,-83,-75,-90,15
26,LR,0,250,5,-81.8,-75,-90,15
26,LR,0,250,6,-79.1666666666667,-70,-90,20
26,LR,1,250,9,-74.7777777777778,-69,-90,21
26,LR,0,250,1,-90,-90,-90,0
26,LR,0,250,8,-72.5,-69,-80,11
26,LR,0,250,3,-71.6666666666667,-70,-73,3
26,LR,0,250,6,-71.6666666666667,-69,-73,4
26,LR,0,250,8,-70.625,-67,-73,6
26,LR,0,250,2,-70,-69,-71,2
26,LR,1,250,9,-70.7777777777778,-67,-74,7
26,LR,0,250,7,-70.8571428571429,-67,-74,7
26,LR,0,250,5,-70.6,-67,-74,7
26,LR,0,250,1,-67,-67,-67,0
26,LR,1,250,9,-72.4444444444444,-67,-81,14
26,LR,0,250,6,-73,-70,-81,11
26,LR,0,250,3,-71.3333333333333,-70,-74,4
26,LR,0,250,1,-70,-70,-70,0
26,LR,1,250,10,-73.7,-69,-81,12
26,LR,0,250,2,-75.5,-70,-81,11
26,LR,0,250,3,-72.3333333333333,-70,-76,6
26,LR,0,250,4,-73.75,-71,-76,5
26,LR,1,250,9,-73.1111111111111,-69,-80,11
26,LR,0,250,6,-73.8333333333333,-69,-80,11
26,LR,0,250,8,-75.25,-69,-87,18
26,LR,1,250,9,-74.7777777777778,-69,-87,18
26,LR,0,250,4,-71.75,-69,-74,5
26,LR,0,250,6,-76,-72,-87,15
26,LR,0,250,2,-72,-72,-72,0
26,LR,0,250,4,-77.5,-72,-87,15
26,LR,1,250,10,-77.3,-71,-87,16
26,LR,0,250,7,-76.2857142857143,-73,-86,13
26,LR,1,250,10,-76.7,-71,-86,15
26,LR,0,250,1,-76,-76,-76,0
26,LR,0,250,3,-80.3333333333333,-74,-86,12
26,LR,0,250,3,-75.3333333333333,-71,-81,10
26,LR,0,250,6,-77,-71,-83,12
26,LR,1,250,10,-76.8,-72,-83,11
26,LR,0,250,2,-81,-79,-83,4
26,LR,1,250,9,-77,-72,-83,11
26,LR,0,250,7,-76.1428571428571,-72,-83,11
26,LR,1,250,10,-76.3,-72,-83,11
26,LR,0,250,6,-76.3333333333333,-72,-83,11
26,LR,0,250,4,-78,-74,-83,9
26,LR,0,250,6,-77.6666666666667,-74,-83,9
26,LR,0,250,8,-79,-75,-86,11
26,LR,0,250,5,-78.4,-76,-86,10
26,LR,0,250,6,-79.1666666666667,-75,-86,11
26,LR,0,250,5,-79.8,-75,-86,11
26,LR,0,250,8,-80.875,-75,-88,13
26,LR,0,250,6,-78.8333333333333,-75,-84,9
26,LR,0,250,4,-79.75,-75,-84,9
26,LR,0,250,8,-78.625,-71,-88,17
26,LR,0,250,2,-80,-77,-83,6
26,LR,0,250,3,-80.3333333333333,-76,-88,12
26,LR,0,250,8,-76.125,-71,-88,17
26,LR,0,250,4,-77.25,-71,-88,17
26,LR,0,250,5,-74.4,-71,-79,8
26,LR,0,250,5,-74.8,-71,-79,8
26,LR,0,250,6,-74,-71,-78,7
26,LR,1,250,10,-73.1,-70,-78,8
26,LR,1,250,10,-73,-70,-77,7
26,LR,0,250,7,-72.4285714285714,-70,-76,6
26,LR,0,250,8,-73,-70,-77,7
26,LR,0,250,1,-73,-73,-73,0
26,LR,0,250,7,-72.1428571428571,-70,-77,7
26,LR,0,250,3,-70.3333333333333,-70,-71,1
26,LR,1,250,9,-73.6666666666667,-70,-78,8
26,LR,0,250,3,-73.3333333333333,-70,-77,7
26,LR,0,250,4,-74,-70,-78,8
26,LR,0,250,4,-74.25,-72,-78,6
26,LR,0,250,3,-73,-72,-75,3
26,LR,0,250,3,-74.6666666666667,-72,-77,5
26,LR,0,250,8,-83.875,-72,-96,24
26,LR,0,250,8,-86.375,-78,-96,18
26,LR,0,250,1,-86,-86,-86,0
26,LR,0,250,8,-84.125,-78,-91,13
26,LR,0,250,4,-82,-78,-91,13
26,LR,0,250,1,-91,-91,-91,0
26,LR,0,250,2,-79.5,-78,-81,3
26,LR,1,250,9,-84.3333333333333,-78,-91,13
26,LR,0,250,3,-82.6666666666667,-82,-83,1
26,LR,0,250,8,-83.625,-79,-91,12
26,LR,1,250,10,-84.6,-79,-93,14
26,LR,0,250,4,-83.75,-83,-85,2
26,LR,0,250,8,-83.875,-79,-93,14
26,LR,0,250,2,-83,-83,-83,0
26,LR,0,250,6,-83.8333333333333,-79,-93,14
26,LR,1,250,9,-82.6666666666667,-74,-93,19
26,LR,1,250,10,-84.1,-74,-94,20
26,LR,0,250,7,-83.2857142857143,-74,-93,19
26,LR,0,250,7,-84.8571428571429,-74,-94,20
26,LR,0,250,8,-81.375,-74,-94,20
26,LR,1,250,9,-82.3333333333333,-76,-94,18
26,LR,0,250,4,-83.25,-76,-94,18
26,LR,0,250,7,-80.4285714285714,-77,-82,5
26,LR,1,250,9,-80.8888888888889,-76,-90,14
26,LR,0,250,7,-80.8571428571429,-76,-90,14
26,LR,0,250,7,-80.7142857142857,-76,-90,14
26,LR,0,250,5,-81.4,-76,-90,14
26,LR,0,250,7,-80.5714285714286,-76,-90,14
26,LR,0,250,2,-76.5,-76,-77,1
26,LR,0,250,2,-83,-76,-90,14
26,LR,0,250,5,-82.2,-77,-90,13
26,LR,0,250,3,-79.6666666666667,-77,-81,4
26,LR,0,250,8,-77.375,-73,-82,9
26,LR,0,250,3,-78,-75,-82,7
26,LR,0,250,1,-82,-82,-82,0
26,LR,0,250,4,-74.25,-73,-75,2
26,LR,0,250,3,-74,-73,-75,2
26,LR,0,250,3,-77,-74,-82,8
26,LR,0,250,3,-78.6666666666667,-74,-82,8
26,LR,0,250,5,-79.4,-73,-84,11
26,LR,0,250,7,-78.1428571428571,-73,-84,11
26,LR,0,250,3,-78.3333333333333,-73,-84,11
26,LR,0,250,2,-78.5,-73,-84,11
26,LR,0,250,6,-80.1666666666667,-75,-86,11
26,LR,0,250,3,-79.6666666666667,-75,-86,11
26,LR,0,250,1,-75,-75,-75,0
26,LR,0,250,1,-79,-79,-79,0
26,LR,0,250,5,-81.6,-79,-86,7
26,LR,0,250,2,-83,-80,-86,6
26,LR,0,250,4,-80.75,-79,-84,5
26,LR,0,250,2,-81.5,-79,-84,5
26,LR,1,250,10,-77.4,-73,-82,9
26,LR,1,250,9,-77.2222222222222,-73,-82,9
26,LR,0,250,7,-77.1428571428571,-73,-82,9
26,LR,0,250,7,-77.4285714285714,-73,-82,9
26,LR,0,250,1,-73,-73,-73,0
26,LR,0,250,2,-80.5,-79,-82,3
26,LR,0,250,4,-77.5,-73,-80,7
26,LR,0,250,3,-77,-73,-80,7
26,LR,1,250,9,-78.5555555555556,-72,-95,23
26,LR,0,250,3,-77,-72,-80,8
26,LR,0,250,3,-76.6666666666667,-72,-79,7
26,LR,0,250,6,-80.3333333333333,-74,-95,21
26,LR,0,250,7,-78.8571428571429,-74,-95,21
26,LR,0,250,1,-95,-95,-95,0
26,LR,1,250,10,-75.4,-71,-83,12
26,LR,1,250,9,-75.2222222222222,-71,-83,12
26,LR,0,250,2,-74,-74,-74,0
26,LR,0,250,1,-71,-71,-71,0
26,LR,0,250,3,-74,-72,-77,5
26,LR,0,250,7,-77,-72,-83,11
26,LR,1,250,9,-78.6666666666667,-73,-84,11
26,LR,0,250,8,-79.375,-73,-84,11
26,LR,1,250,9,-82,-73,-94,21
26,LR,0,250,7,-82.4285714285714,-78,-94,16
26,LR,0,250,7,-82.1428571428571,-74,-94,20
26,LR,0,250,4,-83.75,-78,-94,16
26,LR,0,250,5,-82.6,-74,-94,20
26,LR,0,250,2,-91,-88,-94,6
26,LR,0,250,2,-81,-74,-88,14
26,LR,0,250,6,-79.1666666666667,-73,-84,11
26,LR,0,250,5,-78.2,-73,-83,10
26,LR,0,250,1,-83,-83,-83,0
26,LR,0,250,1,-77,-77,-77,0
26,LR,0,250,2,-75,-73,-77,4
26,LR,1,250,9,-74.4444444444444,-70,-77,7
26,LR,0,250,1,-77,-77,-77,0
26,LR,0,250,2,-74,-74,-74,0
26,LR,1,250,10,-75.5,-70,-82,12
26,LR,0,250,7,-74.8571428571429,-70,-77,7
26,LR,0,250,1,-77,-77,-77,0
26,LR,0,250,2,-75,-74,-76,2
26,LR,0,250,1,-74,-74,-74,0
26,LR,0,250,8,-78.125,-75,-82,7
26,LR,0,250,3,-78.6666666666667,-75,-82,7
26,LR,0,250,7,-79.8571428571429,-75,-85,10
26,LR,0,250,8,-81.875,-75,-96,21
26,LR,1,250,10,-82.3,-75,-96,21
26,LR,1,250,10,-82.3,-75,-96,21
26,LR,0,250,6,-84.5,-80,-96,16
26,LR,0,250,5,-85.4,-80,-96,16
26,LR,1,250,9,-82.2222222222222,-75,-96,21
26,LR,1,250,10,-79.6,-75,-86,11
26,LR,1,250,10,-79.7,-75,-86,11
26,LR,0,250,4,-80,-75,-85,10
26,LR,0,250,5,-79,-75,-86,11
26,LR,0,250,1,-75,-75,-75,0
26,LR,0,250,2,-76,-75,-77,2
26,LR,0,250,8,-80.25,-73,-89,16
26,LR,0,250,5,-81,-73,-89,16
26,LR,0,250,5,-81.8,-73,-89,16
26,LR,1,250,9,-78.8888888888889,-72,-89,17
26,LR,0,250,2,-87.5,-86,-89,3
26,LR,0,250,4,-77,-74,-80,6
26,LR,0,250,6,-75.5,-72,-80,8
26,LR,0,250,5,-75.4,-72,-80,8
26,LR,0,250,7,-76.8571428571429,-72,-79,7
26,LR,0,250,8,-78.125,-72,-89,17
26,LR,0,250,4,-78,-77,-79,2
26,LR,0,250,2,-78.5,-78,-79,1
26,LR,0,250,3,-78.3333333333333,-78,-79,1
26,LR,0,250,4,-79.75,-74,-89,15
26,LR,0,250,8,-76.25,-72,-89,17
26,LR,0,250,2,-81.5,-74,-89,15
26,LR,0,250,8,-75.375,-72,-88,16
26,LR,0,250,1,-72,-72,-72,0
26,LR,0,250,1,-72,-72,-72,0
26,LR,0,250,3,-78,-73,-88,15
26,LR,0,250,2,-80.5,-73,-88,15
26,LR,0,250,2,-79,-70,-88,18
26,LR,0,250,3,-77.3333333333333,-73,-86,13
26,LR,0,250,4,-84.25,-77,-93,16
26,LR,0,250,8,-83.125,-77,-93,16
26,LR,1,250,10,-79.3,-73,-91,18
26,LR,1,250,10,-79.9,-73,-91,18
26,LR,0,250,5,-82.8,-80,-91,11
26,LR,0,250,4,-83.5,-80,-91,11
26,LR,0,250,1,-80,-80,-80,0
26,LR,1,250,9,-77.1111111111111,-73,-91,18
26,LR,0,250,6,-75.3333333333333,-73,-83,10
26,LR,0,250,6,-75.8333333333333,-73,-83,10
26,LR,1,250,10,-76.7,-72,-86,14
26,LR,0,250,4,-77.25,-74,-83,9
26,LR,0,250,2,-74,-74,-74,0
26,LR,0,250,8,-76.125,-72,-86,14
26,LR,0,250,3,-77.3333333333333,-73,-81,8
26,LR,0,250,1,-73,-73,-73,0
26,LR,0,250,8,-78.5,-72,-87,15
26,LR,0,250,6,-79,-72,-87,15
26,LR,0,250,5,-80.4,-72,-87,15
26,LR,0,250,8,-79.875,-72,-87,15
26,LR,0,250,8,-80.625,-72,-87,15
26,LR,0,250,2,-79.5,-72,-87,15
26,LR,0,250,6,-81.3333333333333,-78,-87,9
26,LR,0,250,2,-81.5,-79,-84,5
26,LR,0,250,1,-79,-79,-79,0
26,LR,1,250,10,-74.1,-70,-82,12
26,LR,0,250,2,-78,-78,-78,0
26,LR,1,250,10,-73.5,-70,-81,11
26,LR,0,250,5,-72,-70,-75,5
26,LR,1,250,10,-74.2,-70,-81,11
26,LR,0,250,8,-73.875,-70,-81,11
26,LR,0,250,7,-74.4285714285714,-70,-81,11
26,LR,0,250,4,-72.25,-71,-73,2
26,LR,0,250,4,-74.25,-71,-81,10
26,LR,0,250,2,-81,-81,-81,0
26,LR,0,250,2,-80,-79,-81,2
26,LR,0,250,4,-77.25,-73,-81,8
26,LR,0,250,5,-77.8,-71,-88,17
26,LR,0,250,2,-79.5,-71,-88,17
26,LR,1,250,9,-76.8888888888889,-72,-88,16
26,LR,0,250,7,-75.2857142857143,-72,-82,10
26,LR,1,250,10,-75.8,-72,-82,10
26,LR,0,250,6,-74.8333333333333,-73,-78,5
26,LR,0,250,8,-75.125,-72,-78,6
26,LR,0,250,2,-75,-73,-77,4
26,LR,1,250,9,-76.3333333333333,-72,-84,12
26,LR,1,250,9,-76.8888888888889,-72,-84,12
26,LR,0,250,4,-75,-72,-78,6
26,LR,1,250,9,-78.2222222222222,-72,-84,12
26,LR,1,250,9,-78.3333333333333,-72,-84,12
26,LR,0,250,3,-78.3333333333333,-72,-84,12
26,LR,0,250,7,-79.2857142857143,-74,-84,10
26,LR,1,250,10,-78.1,-74,-84,10
26,LR,0,250,4,-78.5,-74,-82,8
26,LR,0,250,8,-77.375,-74,-79,5
26,LR,0,250,6,-77,-74,-79,5
26,LR,0,250,5,-76.6,-74,-78,4
26,LR,1,250,9,-77.3333333333333,-71,-86,15
26,LR,0,250,4,-77,-74,-78,4
26,LR,0,250,5,-77.2,-73,-83,10
26,LR,0,250,5,-75.8,-71,-83,12
26,LR,0,250,6,-77.3333333333333,-71,-86,15
26,LR,0,250,7,-78.8571428571429,-71,-92,21
26,LR,1,250,9,-77.8888888888889,-71,-92,21
26,LR,0,250,1,-71,-71,-71,0
26,LR,0,250,5,-80.2,-73,-92,19
26,LR,0,250,4,-78.75,-73,-92,19
26,LR,0,250,6,-78.6666666666667,-74,-92,18
26,LR,0,250,3,-77.3333333333333,-76,-80,4
26,LR,0,250,4,-76.5,-74,-80,6
26,LR,0,250,7,-74.4285714285714,-70,-79,9
26,LR,0,250,7,-74,-70,-79,9
26,LR,0,250,2,-73,-70,-76,6
26,LR,0,250,6,-75.8333333333333,-70,-79,9
26,LR,1,250,10,-76.6,-70,-89,19
26,LR,1,250,9,-77.3333333333333,-72,-89,17
26,LR,1,250,9,-77,-72,-89,17
26,LR,0,250,5,-75.6,-72,-79,7
26,LR,1,250,10,-77.9,-72,-89,17
26,LR,1,250,10,-78.9,-72,-89,17
26,LR,1,250,10,-79.6,-73,-89,16
26,LR,0,250,3,-80.6666666666667,-73,-89,16
26,LR,1,250,10,-79.2,-73,-89,16
26,LR,0,250,3,-79,-73,-89,16
26,LR,0,250,8,-78.75,-73,-85,12
26,LR,0,250,5,-78.6,-73,-81,8
26,LR,0,250,3,-80,-79,-81,2
26,LR,0,250,6,-80,-77,-85,8
26,LR,1,250,9,-79.1111111111111,-73,-85,12
26,LR,0,250,3,-80.3333333333333,-77,-85,8
26,LR,0,250,4,-80,-76,-85,9
26,LR,0,250,7,-78.8571428571429,-73,-83,10
26,LR,0,250,1,-80,-80,-80,0
26,LR,0,250,2,-74.5,-73,-76,3
26,LR,0,250,2,-78,-73,-83,10
26,LR,0,250,5,-80,-77,-83,6
26,LR,0,250,2,-80.5,-79,-82,3
26,LR,0,250,7,-79.5714285714286,-74,-86,12
26,LR,1,250,10,-78.8,-74,-86,12
26,LR,1,250,10,-80,-74,-86,12
26,LR,0,250,2,-81.5,-77,-86,9
26,LR,0,250,2,-76,-75,-77,2
26,LR,0,250,6,-78.1666666666667,-74,-83,9
26,LR,0,250,1,-83,-83,-83,0
26,LR,1,250,10,-78.9,-73,-86,13
26,LR,0,250,6,-80.3333333333333,-74,-86,12
26,LR,0,250,5,-80.2,-74,-86,12
26,LR,1,250,10,-77.1,-72,-86,14
26,LR,0,250,2,-79.5,-77,-82,5
26,LR,0,250,3,-77.6666666666667,-73,-82,9
26,LR,0,250,8,-74.625,-72,-82,10
26,LR,0,250,1,-82,-82,-82,0
26,LR,1,250,10,-77.1,-72,-86,14
26,LR,0,250,5,-74,-72,-77,5
26,LR,0,250,1,-75,-75,-75,0
26,LR,0,250,8,-78,-72,-86,14
26,LR,0,250,6,-79.6666666666667,-72,-86,14
26,LR,1,250,9,-77.5555555555556,-72,-86,14
26,LR,0,250,3,-82,-75,-86,11
26,LR,1,250,10,-77.9,-72,-85,13
26,LR,0,250,3,-80,-72,-85,13
26,LR,1,250,10,-77.1,-72,-86,14
26,LR,0,250,1,-72,-72,-72,0
26,LR,0,250,1,-76,-76,-76,0
26,LR,1,250,9,-77.5555555555556,-72,-86,14
26,LR,0,250,3,-79.6666666666667,-76,-82,6
26,LR,0,250,6,-75.6666666666667,-72,-81,9
26,LR,1,250,10,-77.9,-72,-85,13
26,LR,0,250,3,-87.3333333333333,-82,-92,10
26,LR,0,250,3,-87.6666666666667,-83,-92,9
31,RL,1,300,9,-77.4444444444444,-74,-86,12
31,RL,0,300,8,-77.375,-74,-81,7
31,RL,0,300,6,-77.3333333333333,-74,-80,6
31,RL,0,300,5,-77.8,-74,-80,6
31,RL,0,300,5,-79.2,-77,-81,4
31,RL,0,300,2,-77.5,-77,-78,1
31,RL,0,300,8,-81.375,-77,-87,10
31,RL,0,300,2,-80.5,-80,-81,1
31,RL,0,300,6,-82.3333333333333,-77,-87,10
31,RL,0,300,5,-83.4,-79,-87,8
31,RL,0,300,2,-87,-87,-87,0
31,RL,0,300,4,-82.25,-78,-87,9
31,RL,0,300,1,-81,-81,-81,0
31,RL,1,300,10,-80.1,-76,-84,8
31,RL,0,300,2,-77,-76,-78,2
31,RL,0,300,4,-79,-76,-82,6
31,RL,0,300,6,-80.8333333333333,-79,-83,4
31,RL,0,300,3,-80.6666666666667,-79,-82,3
31,RL,1,300,9,-81.7777777777778,-79,-84,5
31,RL,0,300,4,-82.25,-81,-84,3
31,RL,1,300,9,-81.2222222222222,-79,-84,5
31,RL,0,300,7,-81,-79,-84,5
31,RL,0,300,6,-80.5,-79,-84,5
31,RL,1,300,9,-80.1111111111111,-78,-84,6
31,RL,1,300,10,-79.5,-78,-82,4
31,RL,0,300,3,-78.6666666666667,-78,-79,1
31,RL,0,300,3,-79.3333333333333,-78,-82,4
31,RL,0,300,2,-80,-78,-82,4
31,RL,0,300,5,-80.4,-78,-82,4
31,RL,1,300,9,-79.3333333333333,-78,-80,2
31,RL,0,300,1,-78,-78,-78,0
31,RL,0,300,6,-79.3333333333333,-78,-80,2
31,RL,0,300,4,-79,-78,-80,2
31,RL,0,300,8,-79.25,-78,-80,2
31,RL,0,300,4,-79.5,-79,-80,1
31,RL,0,300,1,-79,-79,-79,0
31,RL,1,300,10,-79.6,-78,-83,5
31,RL,1,300,10,-79.7,-78,-83,5
31,RL,1,300,10,-79.5,-78,-83,5
31,RL,0,300,8,-79.75,-78,-83,5
31,RL,0,300,8,-79.625,-78,-83,5
31,RL,0,300,4,-78.75,-78,-79,1
31,RL,0,300,3,-79,-79,-79,0
31,RL,0,300,2,-79,-79,-79,0
31,RL,0,300,4,-80.25,-78,-83,5
31,RL,0,300,1,-81,-81,-81,0
31,RL,0,300,2,-79,-78,-80,2
31,RL,0,300,3,-80,-79,-81,2
31,RL,0,300,1,-79,-79,-79,0
31,RL,0,300,5,-79.4,-78,-81,3
31,RL,0,300,6,-79.1666666666667,-78,-81,3
31,RL,0,300,3,-79.3333333333333,-78,-80,2
31,RL,0,300,5,-79,-78,-81,3
31,RL,0,300,6,-78.5,-77,-81,4
31,RL,0,300,8,-79,-77,-82,5
31,RL,0,300,8,-78.625,-77,-82,5
31,RL,0,300,7,-78.7142857142857,-77,-82,5
31,RL,0,300,5,-79,-77,-82,5
31,RL,0,300,6,-78.6666666666667,-76,-82,6
31,RL,0,300,2,-79.5,-78,-81,3
31,RL,0,300,4,-77.5,-76,-80,4
31,RL,0,300,5,-78.4,-76,-81,5
31,RL,0,300,4,-79,-76,-81,5
31,RL,0,300,8,-80.25,-79,-81,2
31,RL,1,300,10,-79.8,-77,-82,5
31,RL,1,300,10,-79.9,-77,-82,5
31,RL,1,300,9,-79.8888888888889,-77,-82,5
31,RL,0,300,2,-80.5,-80,-81,1
31,RL,0,300,3,-81,-80,-82,2
31,RL,1,300,10,-79.5,-77,-82,5
31,RL,0,300,8,-79.25,-77,-82,5
31,RL,0,300,6,-79.6666666666667,-77,-82,5
31,RL,0,300,7,-79.4285714285714,-77,-82,5
31,RL,0,300,4,-80.5,-77,-82,5
31,RL,0,300,6,-79.3333333333333,-77,-82,5
31,RL,0,300,6,-79.5,-78,-82,4
31,RL,0,300,5,-79,-78,-80,2
31,RL,0,300,5,-79.2,-79,-80,1
31,RL,0,300,8,-80.25,-79,-83,4
31,RL,0,300,5,-80.2,-79,-82,3
31,RL,0,300,5,-80.8,-79,-83,4
31,RL,0,300,4,-81.25,-79,-83,4
31,RL,1,300,9,-80.3333333333333,-78,-83,5
31,RL,0,300,8,-79.75,-78,-81,3
31,RL,0,300,6,-80,-78,-81,3
31,RL,0,300,5,-80,-78,-81,3
31,RL,0,300,2,-80.5,-80,-81,1
31,RL,1,300,10,-80.7,-79,-82,3
31,RL,1,300,9,-80.6666666666667,-79,-82,3
31,RL,0,300,6,-80.6666666666667,-79,-82,3
31,RL,0,300,8,-81.375,-79,-83,4
31,RL,0,300,5,-80.8,-79,-82,3
31,RL,0,300,1,-81,-81,-81,0
31,RL,0,300,4,-81,-79,-83,4
31,RL,0,300,4,-81,-80,-82,2
31,RL,0,300,2,-81,-80,-82,2
31,RL,0,300,6,-81.5,-80,-83,3
31,RL,0,300,8,-82,-80,-84,4
31,RL,0,300,6,-82.5,-81,-84,3
31,RL,0,300,1,-83,-83,-83,0
31,RL,1,300,10,-81.6,-79,-84,5
31,RL,0,300,1,-82,-82,-82,0
31,RL,0,300,5,-81.8,-79,-84,5
31,RL,0,300,8,-81.5,-79,-84,5
31,RL,0,300,3,-80.3333333333333,-79,-81,2
31,RL,0,300,5,-80.8,-79,-82,3
31,RL,1,300,10,-80.8,-79,-83,4
31,RL,0,300,1,-82,-82,-82,0
31,RL,0,300,4,-81.5,-81,-83,2
31,RL,0,300,3,-81.6666666666667,-81,-83,2
31,RL,0,300,8,-80.875,-80,-83,3
31,RL,1,300,9,-80.6666666666667,-80,-82,2
31,RL,0,300,2,-80.5,-80,-81,1
31,RL,0,300,6,-80.6666666666667,-80,-82,2
31,RL,0,300,7,-80.8571428571429,-80,-82,2
31,RL,0,300,2,-81,-80,-82,2
31,RL,0,300,5,-80.8,-80,-82,2
31,RL,0,300,3,-81,-80,-82,2
31,RL,0,300,7,-80.7142857142857,-78,-82,4
31,RL,0,300,2,-81.5,-81,-82,1
31,RL,0,300,8,-80.5,-78,-82,4
31,RL,0,300,2,-81,-80,-82,2
31,RL,0,300,2,-81.5,-81,-82,1
31,RL,1,300,10,-82.1,-78,-86,8
31,RL,0,300,6,-82,-78,-86,8
31,RL,0,300,5,-83.2,-80,-86,6
31,RL,0,300,5,-84,-82,-86,4
31,RL,1,300,9,-82.4444444444444,-80,-86,6
31,RL,0,300,1,-82,-82,-82,0
31,RL,1,300,10,-82.8,-80,-86,6
31,RL,0,300,6,-82.3333333333333,-80,-86,6
31,RL,1,300,10,-83.3,-80,-87,7
31,RL,0,300,4,-82.5,-81,-86,5
31,RL,0,300,7,-83.4285714285714,-81,-86,5
31,RL,0,300,1,-81,-81,-81,0
31,RL,0,300,7,-84.4285714285714,-82,-87,5
31,RL,1,300,10,-83.6,-81,-87,6
31,RL,0,300,3,-83.6666666666667,-82,-86,4
31,RL,0,300,4,-84.5,-82,-87,5
31,RL,0,300,1,-87,-87,-87,0
31,RL,1,300,10,-83.4,-80,-86,6
31,RL,0,300,2,-84,-84,-84,0
31,RL,0,300,8,-83.625,-80,-86,6
31,RL,0,300,1,-84,-84,-84,0
31,RL,0,300,1,-80,-80,-80,0
31,RL,0,300,3,-84,-83,-85,2
31,RL,0,300,3,-83.3333333333333,-83,-84,1
31,RL,0,300,6,-86,-83,-90,7
31,RL,0,300,5,-86.6,-83,-90,7
31,RL,0,300,3,-88,-84,-90,6
31,RL,1,300,10,-85.5,-83,-92,9
31,RL,0,300,5,-83.6,-83,-84,1
31,RL,0,300,8,-85.75,-83,-92,9
31,RL,0,300,4,-86.5,-84,-92,8
31,RL,0,300,4,-86.25,-83,-92,9
31,RL,0,300,6,-87,-83,-92,9
31,RL,1,300,10,-85.7,-81,-92,11
31,RL,0,300,7,-85.1428571428571,-81,-88,7
31,RL,0,300,7,-85.4285714285714,-81,-88,7
31,RL,0,300,7,-85.1428571428571,-81,-88,7
31,RL,0,300,6,-85,-81,-89,8
31,RL,0,300,4,-84,-81,-86,5
31,RL,0,300,2,-83,-81,-85,4
31,RL,0,300,4,-87,-84,-90,6
31,RL,0,300,5,-86,-82,-90,8
31,RL,1,300,10,-83.8,-79,-90,11
31,RL,0,300,2,-86,-82,-90,8
31,RL,0,300,2,-83.5,-82,-85,3
31,RL,0,300,2,-82,-79,-85,6
31,RL,1,300,9,-82,-79,-85,6
31,RL,0,300,5,-83.8,-83,-85,2
31,RL,0,300,4,-84,-83,-85,2
31,RL,0,300,8,-82.875,-78,-86,8
31,RL,0,300,3,-83.6666666666667,-82,-85,3
31,RL,0,300,1,-85,-85,-85,0
31,RL,0,300,2,-80.5,-79,-82,3
31,RL,1,300,9,-82.7777777777778,-78,-86,8
31,RL,0,300,2,-81.5,-78,-85,7
31,RL,0,300,8,-83.75,-82,-86,4
31,RL,0,300,7,-83.5714285714286,-82,-86,4
31,RL,0,300,8,-82.25,-81,-83,2
31,RL,0,300,8,-82.75,-81,-87,6
31,RL,0,300,1,-83,-83,-83,0
31,RL,0,300,1,-82,-82,-82,0
31,RL,0,300,5,-84.4,-81,-90,9
31,RL,0,300,7,-83.5714285714286,-81,-90,9
31,RL,0,300,8,-81.5,-81,-82,1
31,RL,0,300,4,-81.75,-81,-82,1
31,RL,0,300,8,-81.625,-81,-82,1
31,RL,0,300,3,-81.6666666666667,-81,-82,1
31,RL,0,300,3,-81.3333333333333,-81,-82,1
31,RL,0,300,3,-81.3333333333333,-81,-82,1
31,RL,0,300,8,-83.125,-81,-86,5
31,RL,0,300,3,-81.6666666666667,-81,-82,1
31,RL,0,300,7,-84.1428571428571,-81,-86,5
31,RL,1,300,9,-83.5555555555556,-81,-86,5
31,RL,0,300,8,-83.75,-81,-86,5
31,RL,1,300,9,-83.7777777777778,-81,-88,7
31,RL,0,300,5,-83.4,-81,-86,5
31,RL,0,300,3,-84.6666666666667,-82,-86,4
31,RL,1,300,9,-84.5555555555556,-81,-91,10
31,RL,1,300,9,-84.5555555555556,-81,-91,10
31,RL,1,300,9,-85.8888888888889,-81,-94,13
31,RL,1,300,10,-88.1,-82,-94,12
31,RL,0,300,1,-82,-82,-82,0
31,RL,0,300,6,-87.8333333333333,-82,-94,12
31,RL,0,300,2,-88,-82,-94,12
31,RL,1,300,10,-85,-82,-94,12
31,RL,0,300,3,-89.6666666666667,-82,-94,12
31,RL,0,300,7,-84.2857142857143,-82,-93,11
31,RL,0,300,5,-83,-82,-84,2
31,RL,0,300,7,-84.1428571428571,-82,-94,12
31,RL,1,300,10,-83.5,-82,-94,12
31,RL,0,300,5,-84.4,-82,-94,12
31,RL,0,300,3,-86,-82,-94,12
31,RL,0,300,6,-82,-82,-82,0
31,RL,0,300,4,-82,-82,-82,0
31,RL,0,300,7,-82.4285714285714,-82,-83,1
31,RL,1,300,10,-82.1,-81,-83,2
31,RL,0,300,3,-82.6666666666667,-82,-83,1
31,RL,1,300,10,-82.2,-81,-84,3
31,RL,1,300,10,-81.9,-80,-84,4
31,RL,0,300,6,-81.8333333333333,-81,-83,2
31,RL,0,300,2,-82,-82,-82,0
31,RL,0,300,8,-80.875,-79,-84,5
31,RL,0,300,1,-84,-84,-84,0
31,RL,0,300,6,-81.8333333333333,-79,-87,8
31,RL,0,300,8,-82.5,-79,-87,8
31,RL,0,300,6,-82.8333333333333,-80,-87,7
31,RL,0,300,5,-83.4,-81,-87,6
31,RL,0,300,4,-84,-81,-87,6
31,RL,0,300,3,-83,-81,-84,3
31,RL,0,300,6,-82.1666666666667,-79,-84,5
31,RL,0,300,2,-82.5,-81,-84,3
31,RL,1,300,10,-81,-79,-83,4
31,RL,0,300,8,-81,-79,-82,3
31,RL,1,300,10,-81.2,-79,-82,3
31,RL,0,300,2,-80,-79,-81,2
31,RL,0,300,5,-81.4,-79,-82,3
31,RL,0,300,1,-79,-79,-79,0
31,RL,0,300,4,-81.75,-81,-82,1
31,RL,1,300,9,-81.3333333333333,-79,-82,3
31,RL,0,300,4,-81,-79,-82,3
31,RL,0,300,6,-81.1666666666667,-79,-82,3
31,RL,0,300,5,-81,-79,-82,3
31,RL,0,300,6,-81.5,-79,-83,4
31,RL,0,300,4,-81.75,-80,-83,3
31,RL,0,300,1,-80,-80,-80,0
31,RL,1,300,10,-82.1,-80,-84,4
31,RL,0,300,2,-83,-83,-83,0
31,RL,0,300,3,-81.6666666666667,-80,-83,3
31,RL,0,300,4,-81.5,-80,-84,4
31,RL,0,300,7,-82.1428571428571,-80,-84,4
31,RL,0,300,5,-82.2,-80,-84,4
31,RL,0,300,3,-83,-82,-84,2
31,RL,0,300,2,-82.5,-82,-83,1
31,RL,0,300,4,-82.5,-82,-83,1
31,RL,0,300,3,-82.3333333333333,-82,-83,1
31,RL,0,300,7,-81.5714285714286,-79,-83,4
31,RL,1,300,9,-81.2222222222222,-79,-83,4
31,RL,0,300,2,-81,-79,-83,4
31,RL,0,300,6,-80.5,-79,-82,3
31,RL,1,300,10,-81.2,-80,-84,4
31,RL,0,300,1,-82,-82,-82,0
31,RL,0,300,6,-80.6666666666667,-80,-82,2
31,RL,0,300,2,-81,-80,-82,2
31,RL,0,300,2,-81,-80,-82,2
31,RL,0,300,8,-81.875,-80,-84,4
31,RL,0,300,8,-82.25,-80,-84,4
31,RL,0,300,8,-81.75,-80,-83,3
31,RL,0,300,5,-82.2,-80,-83,3
31,RL,0,300,2,-81,-80,-82,2
31,RL,0,300,4,-81.5,-80,-83,3
31,RL,0,300,1,-83,-83,-83,0
31,RL,0,300,1,-80,-80,-80,0
31,RL,1,300,10,-81,-78,-84,6
31,RL,0,300,4,-83,-80,-84,4
31,RL,0,300,4,-81.5,-78,-84,6
31,RL,0,300,3,-80.6666666666667,-78,-84,6
31,RL,0,300,2,-81,-78,-84,6
31,RL,0,300,5,-79.6,-78,-82,4
31,RL,1,300,10,-82.3,-78,-86,8
31,RL,0,300,6,-81.3333333333333,-79,-84,5
31,RL,1,300,9,-82.7777777777778,-79,-86,7
31,RL,0,300,3,-80.3333333333333,-79,-82,3
31,RL,0,300,2,-81,-80,-82,2
31,RL,0,300,6,-83.6666666666667,-80,-86,6
31,RL,0,300,1,-84,-84,-84,0
31,RL,0,300,1,-85,-85,-85,0
31,RL,0,300,3,-84.3333333333333,-81,-86,5
31,RL,0,300,7,-84,-81,-88,7
31,RL,0,300,7,-83.7142857142857,-81,-88,7
31,RL,1,300,9,-83.8888888888889,-81,-88,7
31,RL,0,300,3,-83.3333333333333,-81,-85,4
31,RL,0,300,5,-84.2,-82,-85,3
31,RL,0,300,8,-83.5,-82,-85,3
31,RL,0,300,2,-83.5,-82,-85,3
31,RL,0,300,7,-83.7142857142857,-82,-85,3
31,RL,0,300,6,-83.5,-82,-85,3
31,RL,0,300,3,-83.3333333333333,-83,-84,1
31,RL,1,300,9,-84.2222222222222,-81,-89,8
31,RL,0,300,4,-84.5,-82,-86,4
31,RL,0,300,6,-84.8333333333333,-81,-89,8
31,RL,0,300,2,-83.5,-81,-86,5
31,RL,0,300,8,-84.875,-81,-91,10
31,RL,1,300,9,-86.3333333333333,-81,-91,10
31,RL,0,300,2,-81,-81,-81,0
31,RL,0,300,3,-85.3333333333333,-81,-90,9
31,RL,0,300,1,-90,-90,-90,0
31,RL,1,300,9,-86.1111111111111,-82,-90,8
31,RL,1,300,10,-85.5,-82,-90,8
31,RL,0,300,5,-85.8,-82,-90,8
31,RL,0,300,1,-85,-85,-85,0
31,RL,0,300,3,-84.6666666666667,-82,-86,4
31,RL,0,300,1,-86,-86,-86,0
31,RL,0,300,1,-82,-82,-82,0
31,RL,0,300,4,-84.5,-83,-87,4
31,RL,0,300,2,-85,-83,-87,4
31,RL,0,300,8,-84.375,-81,-88,7
31,RL,0,300,3,-82.3333333333333,-81,-84,3
31,RL,1,300,9,-81,-74,-88,14
31,RL,0,300,5,-82.4,-74,-88,14
31,RL,0,300,7,-79.5714285714286,-74,-88,14
31,RL,0,300,5,-78.4,-74,-83,9
31,RL,0,300,5,-77.2,-74,-79,5
31,RL,1,300,10,-79.7,-77,-83,6
31,RL,0,300,6,-79.5,-77,-83,6
31,RL,0,300,1,-77,-77,-77,0
31,RL,0,300,4,-80.75,-79,-83,4
31,RL,0,300,3,-82.3333333333333,-81,-83,2
31,RL,0,300,5,-80.8,-78,-83,5
31,RL,0,300,3,-81,-79,-83,4
31,RL,0,300,2,-80,-79,-81,2
31,RL,1,300,10,-82.6,-77,-94,17
31,RL,0,300,8,-83.25,-77,-94,17
31,RL,0,300,3,-84.3333333333333,-77,-94,17
31,RL,0,300,1,-94,-94,-94,0
31,RL,1,300,9,-81.6666666666667,-77,-85,8
31,RL,0,300,7,-82.4285714285714,-78,-85,7
31,RL,1,300,10,-81.5,-78,-85,7
31,RL,0,300,8,-81,-78,-83,5
31,RL,0,300,7,-80.7142857142857,-78,-82,4
31,RL,0,300,1,-78,-78,-78,0
31,RL,0,300,8,-80.75,-78,-82,4
31,RL,0,300,2,-81.5,-81,-82,1
31,RL,0,300,1,-81,-81,-81,0
31,RL,1,300,9,-80.1111111111111,-77,-83,6
31,RL,0,300,8,-79.875,-77,-83,6
31,RL,0,300,8,-79.5,-77,-83,6
31,RL,0,300,7,-79.7142857142857,-77,-83,6
31,RL,0,300,2,-78,-78,-78,0
31,RL,0,300,4,-80.25,-78,-83,5
31,RL,0,300,8,-81.5,-78,-84,6
31,RL,0,300,4,-81.5,-78,-84,6
31,RL,0,300,8,-81.25,-78,-84,6
31,RL,0,300,2,-83,-82,-84,2
31,RL,1,300,10,-81.8,-79,-84,5
31,RL,1,300,10,-81.4,-79,-84,5
31,RL,0,300,7,-81.2857142857143,-80,-84,4
31,RL,1,300,10,-81.8,-80,-84,4
31,RL,0,300,4,-81.25,-80,-84,4
31,RL,0,300,5,-81.6,-80,-84,4
31,RL,0,300,6,-81.5,-80,-84,4
31,RL,0,300,7,-81.5714285714286,-80,-84,4
31,RL,0,300,3,-82.6666666666667,-80,-84,4
31,RL,0,300,4,-82.5,-81,-84,3
31,RL,0,300,3,-82,-81,-84,3
31,RL,0,300,8,-81.375,-81,-84,3
31,RL,0,300,3,-81,-81,-81,0
31,RL,0,300,8,-81.875,-81,-84,3
31,RL,0,300,8,-82.375,-81,-85,4
31,RL,0,300,1,-81,-81,-81,0
31,RL,0,300,2,-81,-81,-81,0
31,RL,1,300,9,-82.7777777777778,-80,-85,5
31,RL,0,300,3,-83.6666666666667,-82,-85,3
31,RL,0,300,1,-84,-84,-84,0
31,RL,0,300,8,-82.875,-80,-85,5
31,RL,0,300,3,-82,-82,-82,0
31,RL,1,300,10,-82.2,-80,-84,4
31,RL,0,300,5,-82.8,-80,-84,4
31,RL,0,300,3,-84,-84,-84,0
31,RL,0,300,1,-84,-84,-84,0
31,RL,0,300,5,-82,-80,-84,4
31,RL,0,300,4,-81.5,-80,-84,4
31,RL,0,300,7,-82.2857142857143,-80,-84,4
31,RL,0,300,1,-82,-82,-82,0
31,RL,0,300,7,-81.4285714285714,-80,-84,4
31,RL,0,300,7,-82,-80,-85,5
31,RL,0,300,3,-80.6666666666667,-80,-82,2
31,RL,0,300,4,-81.75,-80,-85,5
31,RL,0,300,5,-82.6,-80,-85,5
31,RL,0,300,6,-82.1666666666667,-80,-85,5
31,RL,0,300,8,-82,-80,-84,4
31,RL,0,300,4,-81.25,-80,-83,3
31,RL,0,300,7,-81.4285714285714,-80,-84,4
31,RL,0,300,4,-82,-80,-84,4
31,RL,0,300,1,-84,-84,-84,0
31,RL,0,300,5,-81.8,-80,-84,4
31,RL,0,300,4,-82.25,-80,-84,4
31,RL,1,300,9,-80.6666666666667,-79,-83,4
31,RL,0,300,3,-80.6666666666667,-80,-81,1
31,RL,0,300,1,-81,-81,-81,0
31,RL,0,300,4,-81,-79,-84,5
31,RL,1,300,10,-81.8,-79,-86,7
31,RL,0,300,5,-82,-81,-84,3
31,RL,0,300,3,-82.3333333333333,-81,-84,3
31,RL,0,300,6,-81.1666666666667,-81,-82,1
31,RL,0,300,2,-81.5,-81,-82,1
31,RL,1,300,9,-82.1111111111111,-81,-86,5
31,RL,0,300,7,-82.2857142857143,-81,-86,5
31,RL,0,300,4,-82.5,-81,-86,5
31,RL,0,300,5,-82.8,-81,-86,5
31,RL,0,300,5,-83.4,-82,-88,6
31,RL,1,300,9,-83.6666666666667,-81,-88,7
31,RL,0,300,4,-85,-82,-88,6
31,RL,0,300,4,-84.5,-81,-88,7
31,RL,0,300,5,-83.6,-81,-88,7
31,RL,0,300,7,-81.7142857142857,-80,-87,7
31,RL,0,300,3,-83,-81,-87,6
31,RL,1,300,10,-82.1,-80,-87,7
31,RL,0,300,4,-80.75,-80,-82,2
31,RL,0,300,1,-82,-82,-82,0
31,RL,0,300,1,-80,-80,-80,0
31,RL,0,300,2,-82,-80,-84,4
31,RL,0,300,7,-81.8571428571429,-80,-84,4
31,RL,0,300,2,-82,-80,-84,4
31,RL,1,300,10,-81.4,-80,-85,5
31,RL,0,300,1,-83,-83,-83,0
31,RL,0,300,3,-80.6666666666667,-80,-81,1
31,RL,0,300,3,-81,-81,-81,0
31,RL,1,300,9,-81.4444444444444,-80,-85,5
31,RL,0,300,8,-81.5,-80,-85,5
31,RL,0,300,1,-85,-85,-85,0
31,RL,0,300,6,-81,-80,-82,2
31,RL,0,300,6,-81,-80,-82,2
31,RL,1,300,10,-80.4,-79,-82,3
31,RL,0,300,2,-81,-81,-81,0
31,RL,0,300,7,-80,-79,-82,3
31,RL,0,300,7,-79.7142857142857,-79,-82,3
31,RL,0,300,6,-79.6666666666667,-79,-82,3
31,RL,0,300,4,-80,-79,-82,3
31,RL,0,300,3,-80.3333333333333,-79,-82,3
31,RL,1,300,9,-80.5555555555556,-79,-84,5
31,RL,0,300,3,-79.6666666666667,-79,-81,2
31,RL,0,300,1,-79,-79,-79,0
31,RL,0,300,7,-80.8571428571429,-79,-84,5
31,RL,0,300,8,-80,-77,-84,7
31,RL,0,300,4,-80.25,-79,-84,5
31,RL,0,300,5,-79.4,-77,-84,7
31,RL,1,300,10,-82.4,-77,-89,12
31,RL,1,300,10,-82.1,-77,-89,12
31,RL,0,300,2,-77.5,-77,-78,1
31,RL,0,300,4,-81.5,-77,-86,9
31,RL,0,300,8,-85.25,-79,-89,10
31,RL,0,300,1,-79,-79,-79,0
31,RL,0,300,8,-84.25,-80,-89,9
31,RL,0,300,1,-86,-86,-86,0
31,RL,0,300,4,-82.5,-80,-86,6
31,RL,0,300,3,-81.3333333333333,-80,-82,2
31,RL,0,300,3,-85.6666666666667,-80,-89,9
31,RL,1,300,10,-84.6,-81,-89,8
31,RL,0,300,8,-84.5,-81,-88,7
31,RL,0,300,3,-86,-82,-88,6
31,RL,0,300,2,-88,-88,-88,0
31,RL,0,300,7,-82.7142857142857,-81,-87,6
31,RL,0,300,6,-83,-81,-87,6
31,RL,0,300,8,-83.125,-81,-88,7
31,RL,0,300,4,-82.5,-81,-87,6
31,RL,0,300,3,-83,-81,-87,6
31,RL,0,300,7,-84.1428571428571,-81,-88,7
31,RL,0,300,5,-84,-81,-88,7
31,RL,1,300,9,-85.2222222222222,-81,-89,8
31,RL,0,300,6,-84.1666666666667,-81,-89,8
31,RL,1,300,9,-86,-82,-89,7
31,RL,1,300,9,-85.2222222222222,-81,-89,8
31,RL,1,300,9,-84.3333333333333,-81,-88,7
31,RL,0,300,2,-86,-86,-86,0
31,RL,0,300,5,-84.6,-82,-86,4
31,RL,0,300,8,-82.625,-81,-86,5
31,RL,0,300,1,-82,-82,-82,0
31,RL,1,300,9,-82.7777777777778,-81,-90,9
31,RL,0,300,2,-81,-81,-81,0
31,RL,0,300,4,-83.25,-81,-90,9
31,RL,1,300,9,-82.8888888888889,-81,-90,9
31,RL,0,300,2,-85.5,-81,-90,9
31,RL,1,300,9,-83.5555555555556,-81,-90,9
31,RL,0,300,7,-82.5714285714286,-81,-84,3
31,RL,1,300,10,-82.9,-81,-84,3
31,RL,0,300,5,-83.4,-81,-84,3
31,RL,0,300,7,-83.4285714285714,-81,-84,3
31,RL,0,300,3,-84,-84,-84,0
31,RL,0,300,7,-82.7142857142857,-80,-84,4
31,RL,0,300,2,-84,-84,-84,0
31,RL,1,300,10,-81.1,-78,-84,6
31,RL,1,300,10,-80.6,-78,-84,6
31,RL,0,300,2,-83,-83,-83,0
31,RL,0,300,2,-81.5,-80,-83,3
31,RL,0,300,5,-80.2,-78,-84,6
31,RL,0,300,5,-80,-78,-84,6
31,RL,0,300,1,-84,-84,-84,0
31,RL,0,300,5,-78.8,-78,-79,1
31,RL,1,300,10,-80.2,-76,-88,12
31,RL,0,300,6,-78.5,-76,-82,6
31,RL,1,300,9,-80,-76,-88,12
31,RL,0,300,6,-81.1666666666667,-76,-88,12
31,RL,0,300,4,-81.25,-77,-88,11
31,RL,0,300,6,-80.5,-77,-88,11
31,RL,0,300,2,-83,-78,-88,10
31,RL,0,300,1,-88,-88,-88,0
31,RL,0,300,5,-84.8,-77,-100,23
31,RL,1,300,9,-82.4444444444444,-77,-100,23
31,RL,0,300,6,-84,-77,-100,23
31,RL,0,300,6,-83.5,-77,-100,23
31,RL,0,300,1,-81,-81,-81,0
31,RL,0,300,1,-81,-81,-81,0
31,RL,0,300,5,-78,-76,-81,5
31,RL,0,300,2,-78.5,-77,-80,3
31,RL,0,300,7,-81.5714285714286,-76,-88,12
31,RL,0,300,1,-83,-83,-83,0
31,RL,0,300,3,-80.3333333333333,-80,-81,1
31,RL,0,300,8,-80.125,-78,-84,6
31,RL,0,300,3,-81,-79,-84,5
31,RL,1,300,10,-82.1,-78,-92,14
31,RL,0,300,2,-79,-79,-79,0
31,RL,0,300,7,-80.8571428571429,-78,-85,7
31,RL,1,300,10,-84.3,-78,-92,14
31,RL,0,300,6,-84.1666666666667,-79,-92,13
31,RL,0,300,1,-82,-82,-82,0
31,RL,0,300,8,-85.875,-82,-92,10
31,RL,1,300,10,-82.7,-76,-92,16
31,RL,1,300,10,-81.2,-76,-89,13
31,RL,0,300,4,-85.75,-83,-89,6
31,RL,0,300,3,-85,-83,-89,6
31,RL,1,300,10,-77.4,-74,-83,9
31,RL,0,300,1,-83,-83,-83,0
31,RL,1,300,9,-75.7777777777778,-74,-78,4
31,RL,0,300,5,-76.6,-75,-78,3
31,RL,0,300,3,-77.3333333333333,-77,-78,1
31,RL,0,300,1,-77,-77,-77,0
31,RL,0,300,1,-77,-77,-77,0
31,RL,0,300,1,-75,-75,-75,0
31,RL,0,300,4,-75.75,-74,-80,6
31,RL,0,300,1,-74,-74,-74,0
31,RL,0,300,3,-79.6666666666667,-74,-85,11
31,RL,1,300,9,-88.7777777777778,-80,-99,19
31,RL,0,300,5,-93.4,-90,-99,9
31,RL,1,300,10,-86.2,-77,-99,22
31,RL,0,300,7,-85.5714285714286,-77,-93,16
31,RL,0,300,7,-84.2857142857143,-77,-93,16
31,RL,1,300,9,-82.4444444444444,-77,-93,16
31,RL,0,300,2,-83.5,-80,-87,7
31,RL,0,300,3,-81.3333333333333,-77,-87,10
31,RL,1,300,9,-80.3333333333333,-77,-83,6
31,RL,0,300,8,-80.75,-79,-83,4
31,RL,1,300,9,-80.4444444444444,-79,-83,4
31,RL,0,300,3,-80,-79,-82,3
31,RL,0,300,4,-80.25,-79,-83,4
31,RL,0,300,8,-80.5,-79,-83,4
31,RL,0,300,4,-80.25,-79,-81,2
31,RL,0,300,5,-80.4,-79,-83,4
31,RL,1,300,9,-79.7777777777778,-77,-82,5
31,RL,0,300,2,-80,-80,-80,0
31,RL,0,300,8,-79.5,-77,-82,5
31,RL,0,300,4,-80,-77,-82,5
31,RL,0,300,8,-78.75,-77,-82,5
31,RL,1,300,9,-78.7777777777778,-77,-82,5
31,RL,0,300,8,-79,-77,-82,5
31,RL,0,300,6,-78.8333333333333,-77,-81,4
31,RL,0,300,1,-77,-77,-77,0
31,RL,0,300,1,-79,-79,-79,0
31,RL,0,300,5,-79.8,-77,-82,5
31,RL,0,300,2,-80.5,-80,-81,1
31,RL,0,300,7,-79.7142857142857,-77,-82,5
31,RL,0,300,3,-80.3333333333333,-80,-81,1
31,RL,0,300,7,-80.1428571428571,-77,-85,8
31,RL,0,300,7,-80.8571428571429,-77,-85,8
31,RL,0,300,4,-78.75,-77,-80,3
31,RL,1,300,10,-81.4,-77,-86,9
31,RL,0,300,1,-80,-80,-80,0
31,RL,0,300,8,-82,-77,-86,9
31,RL,0,300,3,-80.3333333333333,-77,-85,8
31,RL,0,300,5,-80.8,-77,-86,9
31,RL,0,300,8,-80.875,-77,-86,9
31,RL,0,300,1,-82,-82,-82,0
31,RL,1,300,10,-80.5,-77,-86,9
31,RL,0,300,4,-80.5,-79,-83,4
31,RL,0,300,1,-80,-80,-80,0
31,RL,1,300,9,-80.2222222222222,-78,-83,5
31,RL,0,300,1,-79,-79,-79,0
31,RL,0,300,2,-80.5,-79,-82,3
31,RL,0,300,4,-81,-78,-83,5
31,RL,0,300,3,-80.6666666666667,-78,-83,5
31,RL,0,300,4,-80,-78,-83,5
31,RL,1,300,9,-81,-78,-83,5
31,RL,0,300,4,-80.25,-78,-81,3
31,RL,0,300,2,-81,-81,-81,0
31,RL,0,300,4,-82,-81,-83,2
31,RL,0,300,4,-82.5,-81,-83,2
31,RL,0,300,3,-83,-83,-83,0
31,RL,1,300,10,-83.5,-80,-88,8
31,RL,1,300,10,-84.1,-80,-89,9
31,RL,1,300,9,-84.2222222222222,-80,-89,9
31,RL,0,300,7,-83.7142857142857,-80,-88,8
31,RL,0,300,1,-83,-83,-83,0
31,RL,0,300,3,-82.6666666666667,-80,-84,4
31,RL,1,300,10,-85.6,-79,-90,11
31,RL,0,300,5,-85.6,-79,-90,11
31,RL,1,300,9,-84.7777777777778,-79,-90,11
31,RL,0,300,3,-86.6666666666667,-80,-90,10
31,RL,0,300,2,-86.5,-83,-90,7
31,RL,0,300,3,-83.3333333333333,-79,-88,9
31,RL,0,300,4,-82.5,-79,-88,9
31,RL,0,300,2,-81.5,-79,-84,5
31,RL,0,300,2,-83,-81,-85,4
31,RL,0,300,6,-82.1666666666667,-79,-85,6
31,RL,0,300,8,-80.375,-77,-83,6
31,RL,0,300,5,-81,-79,-83,4
31,RL,0,300,1,-82,-82,-82,0
31,RL,1,300,9,-78.8888888888889,-77,-84,7
31,RL,0,300,6,-78.3333333333333,-77,-80,3
31,RL,0,300,7,-80.8571428571429,-77,-90,13
31,RL,0,300,8,-82.625,-77,-90,13
31,RL,0,300,2,-79.5,-79,-80,1
31,RL,0,300,6,-84,-78,-90,12
31,RL,0,300,3,-84,-78,-90,12
31,RL,0,300,8,-84.5,-78,-95,17
31,RL,1,300,9,-86.2222222222222,-79,-97,18
31,RL,0,300,6,-84.6666666666667,-79,-95,16
31,RL,0,300,3,-85.6666666666667,-79,-95,16
31,RL,0,300,4,-83.75,-79,-95,16
31,RL,0,300,2,-80.5,-80,-81,1
31,RL,0,300,7,-85,-81,-97,16
31,RL,0,300,5,-85.6,-81,-97,16
31,RL,0,300,7,-82.5714285714286,-78,-88,10
31,RL,1,300,10,-80.4,-76,-86,10
31,RL,0,300,8,-79.625,-76,-85,9
31,RL,0,300,3,-77.6666666666667,-76,-79,3
31,RL,0,300,2,-77.5,-76,-79,3
31,RL,0,300,6,-80,-77,-83,6
31,RL,0,300,4,-79.75,-77,-83,6
31,RL,1,300,10,-81.3,-78,-84,6
31,RL,0,300,7,-81,-78,-84,6
31,RL,0,300,5,-81.2,-78,-84,6
31,RL,1,300,10,-80.1,-78,-84,6
31,RL,0,300,5,-82,-78,-84,6
31,RL,1,300,10,-80.8,-77,-86,9
31,RL,0,300,2,-82.5,-81,-84,3
31,RL,0,300,4,-79,-78,-81,3
31,RL,0,300,8,-80,-77,-86,9
31,RL,0,300,1,-78,-78,-78,0
31,RL,1,300,10,-79,-75,-86,11
31,RL,0,300,5,-81,-77,-86,9
31,RL,0,300,5,-80.6,-76,-86,10
31,RL,0,300,5,-79.4,-76,-84,8
31,RL,0,300,6,-76.3333333333333,-75,-80,5
31,RL,0,300,6,-77,-75,-80,5
31,RL,0,300,4,-75.5,-75,-76,1
31,RL,1,300,9,-77.1111111111111,-75,-81,6
31,RL,0,300,6,-76.8333333333333,-76,-80,4
31,RL,0,300,6,-77.8333333333333,-76,-81,5
31,RL,0,300,6,-77.8333333333333,-76,-81,5
31,RL,0,300,4,-77.75,-76,-81,5
31,RL,1,300,10,-81.6,-77,-91,14
31,RL,0,300,5,-80.4,-79,-81,2
31,RL,0,300,6,-82,-79,-91,12
31,RL,0,300,7,-84.2857142857143,-79,-91,12
31,RL,0,300,8,-83.125,-78,-91,13
31,RL,0,300,8,-83.375,-78,-91,13
31,RL,0,300,7,-83.8571428571429,-78,-91,13
31,RL,1,300,10,-86.5,-78,-98,20
31,RL,0,300,5,-83,-78,-97,19
31,RL,0,300,6,-86.1666666666667,-78,-98,20
31,RL,0,300,8,-86.125,-77,-98,21
31,RL,0,300,8,-85.75,-77,-98,21
31,RL,0,300,7,-86.4285714285714,-77,-98,21
31,RL,0,300,6,-84.6666666666667,-77,-98,21
31,RL,1,300,10,-79.5,-77,-92,15
31,RL,0,300,7,-79.8571428571429,-77,-92,15
31,RL,0,300,3,-78.6666666666667,-77,-81,4
31,RL,0,300,2,-77.5,-77,-78,1
31,RL,0,300,4,-77.25,-77,-78,1
31,RL,0,300,5,-77,-77,-77,0
31,RL,1,300,9,-79.6666666666667,-77,-84,7
31,RL,0,300,6,-79.1666666666667,-77,-83,6
31,RL,1,300,10,-82.2,-77,-88,11
31,RL,0,300,5,-81.6,-79,-84,5
31,RL,0,300,4,-81.25,-79,-84,5
31,RL,0,300,8,-81.75,-77,-88,11
31,RL,0,300,4,-82.5,-77,-88,11
31,RL,0,300,8,-81.25,-77,-88,11
31,RL,0,300,6,-79.3333333333333,-77,-83,6
31,RL,0,300,2,-81,-79,-83,4
31,RL,0,300,3,-79,-78,-80,2
31,RL,0,300,5,-83.2,-79,-91,12
31,RL,0,300,6,-82.3333333333333,-77,-91,14
31,RL,0,300,3,-81,-77,-84,7
31,RL,0,300,8,-82,-77,-91,14
31,RL,0,300,3,-79.6666666666667,-77,-81,4
31,RL,0,300,7,-81.4285714285714,-75,-91,16
31,RL,0,300,5,-81.6,-75,-91,16
31,RL,0,300,1,-86,-86,-86,0
31,RL,0,300,6,-79.8333333333333,-75,-86,11
31,RL,0,300,1,-77,-77,-77,0
31,RL,0,300,3,-79,-75,-86,11
31,RL,0,300,2,-81,-76,-86,10
31,RL,1,300,9,-81.3333333333333,-75,-91,16
31,RL,0,300,5,-80,-75,-86,11
31,RL,0,300,2,-84,-82,-86,4
31,RL,1,300,9,-81.5555555555556,-75,-87,12
31,RL,0,300,7,-84.1428571428571,-75,-97,22
31,LR,0,300,1,-82,-82,-82,0
31,LR,0,300,4,-82,-80,-84,4
31,LR,0,300,4,-80,-76,-84,8
31,LR,1,300,9,-82.3333333333333,-76,-96,20
31,LR,0,300,6,-82,-76,-96,20
31,LR,0,300,2,-77.5,-76,-79,3
31,LR,0,300,2,-88.5,-81,-96,15
31,LR,0,300,3,-86.6666666666667,-80,-96,16
31,LR,0,300,5,-80.8,-77,-84,7
31,LR,0,300,6,-79.8333333333333,-75,-87,12
31,LR,0,300,2,-79.5,-77,-82,5
31,LR,0,300,6,-78.6666666666667,-75,-87,12
31,LR,0,300,6,-78.8333333333333,-75,-87,12
31,LR,0,300,4,-77.25,-75,-78,3
31,LR,0,300,2,-78,-78,-78,0
31,LR,0,300,7,-80.4285714285714,-78,-83,5
31,LR,0,300,5,-80.4,-78,-83,5
31,LR,1,300,10,-82,-77,-86,9
31,LR,0,300,2,-81.5,-80,-83,3
31,LR,0,300,1,-80,-80,-80,0
31,LR,1,300,9,-83.6666666666667,-77,-88,11
31,LR,0,300,2,-84.5,-83,-86,3
31,LR,0,300,5,-82.6,-77,-86,9
31,LR,0,300,1,-86,-86,-86,0
31,LR,0,300,5,-83,-77,-88,11
31,LR,1,300,9,-82.3333333333333,-74,-92,18
31,LR,0,300,1,-79,-79,-79,0
31,LR,0,300,4,-81,-74,-88,14
31,LR,0,300,5,-81,-74,-89,15
31,LR,0,300,1,-76,-76,-76,0
31,LR,0,300,7,-84.2857142857143,-74,-92,18
31,LR,0,300,4,-87.25,-80,-92,12
31,LR,0,300,3,-86,-78,-92,14
31,LR,0,300,2,-83.5,-78,-89,11
31,LR,0,300,6,-76.8333333333333,-72,-82,10
31,LR,0,300,6,-76,-72,-82,10
31,LR,0,300,6,-76.3333333333333,-72,-82,10
31,LR,0,300,6,-77.1666666666667,-72,-84,12
31,LR,0,300,6,-78.1666666666667,-72,-84,12
31,LR,0,300,6,-79.1666666666667,-73,-84,11
31,LR,1,300,10,-79.9,-73,-86,13
31,LR,0,300,8,-80.375,-77,-86,9
31,LR,0,300,7,-80.8571428571429,-77,-86,9
31,LR,0,300,4,-79,-77,-81,4
31,LR,1,300,10,-81.1,-77,-86,9
31,LR,0,300,8,-81.25,-77,-86,9
31,LR,0,300,2,-83,-80,-86,6
31,LR,0,300,3,-81.6666666666667,-80,-83,3
31,LR,0,300,6,-81.3333333333333,-80,-83,3
31,LR,0,300,2,-81,-80,-82,2
31,LR,1,300,9,-82.5555555555556,-76,-88,12
31,LR,0,300,8,-82.875,-76,-88,12
31,LR,0,300,6,-83,-76,-88,12
31,LR,0,300,6,-85.5,-76,-93,17
31,LR,0,300,3,-83,-76,-88,12
31,LR,0,300,2,-89,-85,-93,8
31,LR,0,300,2,-92.5,-92,-93,1
31,LR,0,300,8,-81.5,-78,-92,14
31,LR,1,300,10,-82.6,-78,-90,12
31,LR,0,300,7,-81.5714285714286,-78,-90,12
31,LR,0,300,5,-80.2,-78,-82,4
31,LR,0,300,3,-80.3333333333333,-79,-82,3
31,LR,0,300,3,-83.6666666666667,-79,-90,11
31,LR,0,300,7,-88.2857142857143,-82,-94,12
31,LR,1,300,9,-89.6666666666667,-82,-96,14
31,LR,0,300,6,-90.3333333333333,-84,-96,12
31,LR,0,300,1,-86,-86,-86,0
31,LR,0,300,6,-90.1666666666667,-82,-96,14
31,LR,0,300,6,-90.5,-82,-96,14
31,LR,1,300,10,-84.7,-74,-94,20
31,LR,0,300,2,-93.5,-93,-94,1
31,LR,0,300,4,-87,-80,-94,14
31,LR,0,300,3,-84.6666666666667,-80,-88,8
31,LR,1,300,10,-82.5,-74,-90,16
31,LR,0,300,5,-82.6,-80,-84,4
31,LR,0,300,4,-82.25,-80,-84,4
31,LR,0,300,8,-83.125,-76,-90,14
31,LR,0,300,4,-81.5,-76,-87,11
31,LR,0,300,6,-83.8333333333333,-76,-90,14
31,LR,0,300,3,-84.3333333333333,-76,-90,14
31,LR,0,300,7,-81.5714285714286,-75,-90,15
31,LR,0,300,2,-87.5,-85,-90,5
31,LR,0,300,4,-79.5,-75,-85,10
31,LR,0,300,1,-82,-82,-82,0
31,LR,1,300,10,-79.3,-74,-88,14
31,LR,0,300,5,-82.4,-76,-88,12
31,LR,0,300,2,-82,-76,-88,12
31,LR,1,300,9,-80.1111111111111,-74,-88,14
31,LR,0,300,1,-84,-84,-84,0
31,LR,1,300,9,-78.4444444444444,-74,-87,13
31,LR,0,300,1,-76,-76,-76,0
31,LR,1,300,10,-80.1,-74,-87,13
31,LR,0,300,6,-79,-74,-87,13
31,LR,0,300,5,-80,-77,-87,10
31,LR,0,300,4,-80.75,-77,-87,10
31,LR,1,300,10,-81.9,-77,-87,10
31,LR,0,300,8,-81.125,-77,-86,9
31,LR,0,300,8,-81.875,-79,-86,7
31,LR,0,300,3,-82.6666666666667,-80,-86,6
31,LR,0,300,8,-80.625,-76,-83,7
31,LR,0,300,4,-81.25,-79,-83,4
31,LR,0,300,7,-80.1428571428571,-76,-83,7
31,LR,0,300,4,-82,-81,-83,2
31,LR,0,300,6,-78.8333333333333,-74,-83,9
31,LR,1,300,9,-78.6666666666667,-74,-83,9
31,LR,0,300,6,-77.6666666666667,-74,-81,7
31,LR,1,300,10,-78.4,-74,-82,8
31,LR,1,300,9,-78.6666666666667,-74,-82,8
31,LR,0,300,5,-79.6,-77,-82,5
31,LR,0,300,5,-79.2,-77,-82,5
31,LR,0,300,3,-80.3333333333333,-77,-82,5
31,LR,1,300,10,-80.9,-77,-89,12
31,LR,0,300,8,-80.875,-77,-89,12
31,LR,0,300,1,-80,-80,-80,0
31,LR,0,300,8,-80.625,-77,-89,12
31,LR,0,300,4,-82.5,-78,-89,11
31,LR,0,300,1,-78,-78,-78,0
31,LR,0,300,2,-84.5,-80,-89,9
31,LR,1,300,10,-80.9,-73,-90,17
31,LR,0,300,2,-78,-77,-79,2
31,LR,0,300,8,-80,-73,-90,17
31,LR,0,300,3,-80.3333333333333,-80,-81,1
31,LR,1,300,9,-79.6666666666667,-73,-90,17
31,LR,0,300,8,-79.5,-73,-90,17
31,LR,0,300,1,-90,-90,-90,0
31,LR,1,300,10,-81,-72,-96,24
31,LR,0,300,7,-78.4285714285714,-72,-84,12
31,LR,0,300,2,-78,-76,-80,4
31,LR,0,300,7,-83.2857142857143,-72,-96,24
31,LR,1,300,9,-85.3333333333333,-79,-96,17
31,LR,0,300,1,-80,-80,-80,0
31,LR,1,300,10,-86.3,-79,-96,17
31,LR,0,300,6,-85.3333333333333,-79,-96,17
31,LR,0,300,5,-83.2,-79,-94,15
31,LR,0,300,3,-86,-79,-94,15
31,LR,0,300,7,-84,-79,-96,17
31,LR,0,300,4,-84.5,-79,-96,17
31,LR,0,300,8,-81.875,-73,-96,23
31,LR,0,300,7,-82,-73,-96,23
31,LR,1,300,10,-80.2,-73,-88,15
31,LR,0,300,8,-78.5,-73,-85,12
31,LR,0,300,7,-79.2857142857143,-74,-85,11
31,LR,0,300,3,-77.6666666666667,-76,-79,3
31,LR,0,300,1,-78,-78,-78,0
31,LR,0,300,6,-80,-73,-88,15
31,LR,0,300,4,-82,-74,-88,14
31,LR,0,300,4,-79.75,-73,-88,15
31,LR,0,300,4,-78.5,-73,-83,10
31,LR,0,300,7,-82.4285714285714,-77,-91,14
31,LR,0,300,3,-80.3333333333333,-77,-83,6
31,LR,1,300,10,-83,-77,-91,14
31,LR,0,300,8,-83.25,-77,-91,14
31,LR,0,300,6,-83,-77,-91,14
31,LR,0,300,5,-84.2,-77,-91,14
31,LR,0,300,3,-84.3333333333333,-79,-88,9
31,LR,0,300,5,-80.2,-76,-88,12
31,LR,0,300,7,-76.1428571428571,-72,-81,9
31,LR,0,300,1,-81,-81,-81,0
31,LR,0,300,2,-75.5,-75,-76,1
31,LR,0,300,7,-76,-72,-82,10
31,LR,0,300,7,-75.7142857142857,-72,-82,10
31,LR,0,300,7,-78.1428571428571,-72,-94,22
31,LR,0,300,1,-79,-79,-79,0
31,LR,1,300,10,-79.4,-72,-94,22
31,LR,0,300,3,-83,-73,-94,21
31,LR,1,300,9,-80.7777777777778,-73,-94,21
31,LR,0,300,2,-84.5,-75,-94,19
31,LR,0,300,5,-79,-75,-82,7
31,LR,0,300,6,-80.8333333333333,-78,-87,9
31,LR,0,300,6,-81.3333333333333,-78,-87,9
31,LR,0,300,6,-83.5,-78,-92,14
31,LR,0,300,2,-83,-79,-87,8
31,LR,0,300,5,-82.6,-77,-92,15
31,LR,0,300,3,-84,-77,-92,15
31,LR,0,300,5,-83.4,-77,-92,15
31,LR,1,300,10,-80.8,-77,-86,9
31,LR,0,300,4,-81.5,-78,-86,8
31,LR,1,300,10,-80.6,-77,-86,9
31,LR,1,300,9,-80.5555555555556,-77,-86,9
31,LR,0,300,6,-80.3333333333333,-77,-86,9
31,LR,0,300,2,-82,-78,-86,8
31,LR,0,300,3,-79.6666666666667,-77,-81,4
31,LR,0,300,4,-80.75,-77,-85,8
31,LR,0,300,5,-80.4,-77,-85,8
31,LR,0,300,4,-83.75,-79,-93,14
31,LR,0,300,1,-79,-79,-79,0
31,LR,1,300,9,-83.5555555555556,-74,-94,20
31,LR,1,300,10,-84.7,-74,-94,20
31,LR,0,300,4,-79.5,-75,-84,9
31,LR,0,300,3,-79,-75,-84,9
31,LR,0,300,7,-87.4285714285714,-78,-94,16
31,LR,0,300,3,-92.3333333333333,-91,-94,3
31,LR,0,300,4,-89,-85,-92,7
31,LR,0,300,6,-82.3333333333333,-76,-88,12
31,LR,0,300,7,-83.2857142857143,-76,-88,12
31,LR,0,300,4,-80.25,-76,-84,8
31,LR,0,300,1,-81,-81,-81,0
31,LR,1,300,10,-81.3,-75,-89,14
31,LR,1,300,9,-81.8888888888889,-75,-89,14
31,LR,1,300,10,-82.3,-75,-89,14
31,LR,0,300,4,-82.5,-75,-89,14
31,LR,0,300,4,-81,-75,-89,14
31,LR,0,300,7,-81.4285714285714,-75,-89,14
31,LR,0,300,8,-81.625,-75,-92,17
31,LR,0,300,2,-79.5,-79,-80,1
31,LR,0,300,8,-82.625,-75,-92,17
31,LR,0,300,3,-80.3333333333333,-75,-84,9
31,LR,0,300,6,-82.8333333333333,-75,-92,17
31,LR,0,300,3,-82.3333333333333,-75,-92,17
31,LR,0,300,2,-86,-80,-92,12
31,LR,0,300,7,-84.4285714285714,-77,-92,15
31,LR,0,300,5,-81.8,-77,-86,9
31,LR,0,300,6,-83,-77,-90,13
31,LR,0,300,5,-83.2,-77,-90,13
31,LR,1,300,10,-83.9,-77,-92,15
31,LR,0,300,4,-82,-77,-88,11
31,LR,0,300,2,-79.5,-77,-82,5
31,LR,0,300,7,-84.2857142857143,-80,-92,12
31,LR,0,300,3,-84.3333333333333,-80,-92,12
31,LR,0,300,5,-85.4,-80,-92,12
31,LR,0,300,4,-86.75,-80,-92,12
31,LR,1,300,9,-82.7777777777778,-78,-91,13
31,LR,0,300,4,-86.25,-79,-91,12
31,LR,1,300,10,-81.7,-78,-91,13
31,LR,0,300,1,-91,-91,-91,0
31,LR,0,300,6,-79.5,-78,-82,4
31,LR,1,300,9,-80.6666666666667,-78,-86,8
31,LR,0,300,3,-79,-78,-81,3
31,LR,0,300,6,-81.3333333333333,-78,-86,8
31,LR,0,300,2,-81.5,-79,-84,5
31,LR,0,300,3,-83.6666666666667,-81,-86,5
31,LR,0,300,4,-81.25,-78,-86,8
31,LR,0,300,7,-82,-78,-98,20
31,LR,1,300,9,-81.3333333333333,-78,-98,20
31,LR,0,300,5,-82.6,-78,-98,20
31,LR,0,300,2,-88.5,-79,-98,19
31,LR,0,300,7,-82.5714285714286,-79,-98,19
31,LR,0,300,7,-79.7142857142857,-78,-83,5
31,LR,0,300,2,-79,-79,-79,0
31,LR,0,300,5,-81.8,-78,-90,12
31,LR,0,300,4,-81.5,-78,-90,12
31,LR,0,300,7,-80.4285714285714,-78,-90,12
31,LR,0,300,8,-79.625,-75,-90,15
31,LR,0,300,4,-79.25,-78,-82,4
31,LR,1,300,10,-79.1,-75,-90,15
31,LR,0,300,3,-79.3333333333333,-78,-82,4
31,LR,0,300,3,-77,-75,-78,3
31,LR,0,300,4,-80,-75,-90,15
31,LR,0,300,2,-77.5,-77,-78,1
31,LR,0,300,5,-80.2,-76,-90,14
31,LR,0,300,5,-80.6,-76,-90,14
31,LR,0,300,2,-77.5,-76,-79,3
31,LR,0,300,1,-78,-78,-78,0
31,LR,0,300,7,-79.8571428571429,-78,-84,6
31,LR,0,300,5,-80.4,-78,-84,6
31,LR,0,300,3,-79.6666666666667,-78,-83,5
31,LR,0,300,6,-78.8333333333333,-77,-83,6
31,LR,0,300,3,-80.3333333333333,-79,-83,4
31,LR,0,300,2,-78,-77,-79,2
31,LR,0,300,5,-81.8,-77,-93,16
31,LR,0,300,7,-81,-77,-93,16
31,LR,0,300,8,-81.125,-78,-93,15
31,LR,0,300,5,-79.4,-78,-83,5
31,LR,0,300,5,-79.8,-78,-83,5
31,LR,0,300,5,-78.8,-78,-81,3
31,LR,0,300,5,-78.8,-78,-81,3
31,LR,0,300,5,-79.2,-78,-81,3
31,LR,0,300,3,-79.3333333333333,-78,-81,3
31,LR,0,300,4,-79,-78,-80,2
31,LR,0,300,7,-77.5714285714286,-74,-80,6
31,LR,1,300,9,-79.6666666666667,-74,-88,14
31,LR,0,300,4,-77,-74,-79,5
31,LR,0,300,1,-74,-74,-74,0
31,LR,0,300,8,-81.25,-75,-88,13
31,LR,0,300,6,-82.8333333333333,-76,-88,12
31,LR,0,300,7,-83.7142857142857,-75,-88,13
31,LR,0,300,6,-81.1666666666667,-75,-88,13
31,LR,0,300,8,-80.875,-75,-88,13
31,LR,0,300,6,-80,-75,-87,12
31,LR,0,300,1,-87,-87,-87,0
31,LR,0,300,3,-78.6666666666667,-77,-82,5
31,LR,0,300,4,-78.75,-77,-82,5
31,LR,0,300,7,-79,-74,-89,15
31,LR,0,300,2,-80.5,-79,-82,3
31,LR,0,300,4,-79,-74,-89,15
31,LR,0,300,7,-77.7142857142857,-74,-89,15
31,LR,0,300,2,-74,-74,-74,0
31,LR,0,300,3,-76,-74,-78,4
31,LR,1,300,9,-78.5555555555556,-75,-88,13
31,LR,0,300,4,-79.25,-76,-88,12
31,LR,1,300,9,-79.8888888888889,-75,-88,13
31,LR,1,300,9,-80.4444444444444,-75,-88,13
31,LR,0,300,1,-77,-77,-77,0
31,LR,0,300,5,-79.2,-75,-84,9
31,LR,0,300,8,-79.75,-75,-84,9
31,LR,1,300,9,-79.6666666666667,-76,-84,8
31,LR,1,300,9,-79.5555555555556,-76,-83,7
31,LR,0,300,4,-79.25,-76,-83,7
31,LR,1,300,10,-79.8,-76,-86,10
31,LR,1,300,9,-79.4444444444444,-76,-86,10
31,LR,1,300,9,-80.1111111111111,-76,-86,10
31,LR,1,300,10,-80.4,-76,-86,10
31,LR,0,300,1,-82,-82,-82,0
31,LR,0,300,5,-81,-76,-86,10
31,LR,0,300,6,-80.6666666666667,-76,-86,10
31,LR,0,300,6,-81,-76,-86,10
31,LR,0,300,3,-83.6666666666667,-82,-86,4
31,LR,0,300,3,-82.6666666666667,-80,-86,6
31,LR,1,300,9,-78.4444444444444,-76,-80,4
31,LR,0,300,2,-78.5,-78,-79,1
31,LR,0,300,8,-78.5,-76,-80,4
31,LR,0,300,8,-78.875,-76,-82,6
31,LR,0,300,5,-78.2,-76,-80,4
31,LR,0,300,2,-78.5,-77,-80,3
31,LR,0,300,8,-80.5,-76,-84,8
31,LR,0,300,2,-80.5,-79,-82,3
31,LR,0,300,1,-82,-82,-82,0
31,LR,0,300,3,-79.6666666666667,-76,-82,6
31,LR,0,300,1,-76,-76,-76,0
31,LR,0,300,7,-83.7142857142857,-80,-92,12
31,LR,0,300,7,-83.1428571428571,-78,-92,14
31,LR,0,300,6,-83,-78,-92,14
31,LR,0,300,3,-82.6666666666667,-80,-85,5
31,LR,1,300,9,-84.5555555555556,-77,-92,15
31,LR,0,300,2,-85,-78,-92,14
31,LR,1,300,9,-83.7777777777778,-77,-92,15
31,LR,0,300,3,-85.6666666666667,-82,-89,7
31,LR,0,300,5,-85.8,-82,-89,7
31,LR,0,300,6,-84.5,-78,-89,11
31,LR,1,300,10,-83.2,-77,-91,14
31,LR,1,300,9,-84.1111111111111,-78,-91,13
26,RL,0,300,5,-79.2,-75,-87,12
26,RL,1,300,10,-80,-77,-87,10
26,RL,0,300,1,-87,-87,-87,0
26,RL,1,300,9,-78.8888888888889,-77,-82,5
26,RL,0,300,8,-79.125,-77,-82,5
26,RL,0,300,7,-79.4285714285714,-77,-82,5
26,RL,0,300,1,-82,-82,-82,0
26,RL,0,300,1,-79,-79,-79,0
26,RL,0,300,3,-79.6666666666667,-78,-82,4
26,RL,1,300,9,-78.2222222222222,-76,-82,6
26,RL,0,300,5,-78.8,-77,-82,5
26,RL,0,300,8,-77.75,-76,-80,4
26,RL,0,300,4,-78.5,-77,-80,3
26,RL,0,300,3,-77.6666666666667,-76,-79,3
26,RL,0,300,3,-77.3333333333333,-76,-79,3
26,RL,0,300,8,-77.375,-76,-78,2
26,RL,0,300,4,-77.5,-77,-78,1
26,RL,0,300,3,-77.3333333333333,-77,-78,1
26,RL,0,300,7,-77.5714285714286,-77,-79,2
26,RL,0,300,5,-77.4,-77,-78,1
26,RL,0,300,2,-78,-78,-78,0
26,RL,0,300,5,-77.6,-77,-79,2
26,RL,0,300,8,-78,-77,-80,3
26,RL,0,300,5,-78,-77,-79,2
26,RL,1,300,9,-77.7777777777778,-76,-80,4
26,RL,0,300,3,-77.6666666666667,-77,-79,2
26,RL,0,300,3,-78.6666666666667,-77,-80,3
26,RL,0,300,6,-78,-76,-80,4
26,RL,0,300,1,-80,-80,-80,0
26,RL,0,300,5,-77.2,-76,-80,4
26,RL,1,300,9,-78.4444444444444,-76,-80,4
26,RL,1,300,10,-79.3,-76,-83,7
26,RL,0,300,6,-79,-77,-80,3
26,RL,0,300,1,-79,-79,-79,0
26,RL,0,300,4,-79.5,-79,-80,1
26,RL,0,300,2,-79,-79,-79,0
26,RL,0,300,6,-79.1666666666667,-76,-83,7
26,RL,0,300,7,-79.1428571428571,-76,-83,7
26,RL,0,300,1,-80,-80,-80,0
26,RL,0,300,7,-78.7142857142857,-75,-83,8
26,RL,0,300,3,-78.3333333333333,-76,-82,6
26,RL,0,300,1,-77,-77,-77,0
26,RL,0,300,3,-80,-76,-82,6
26,RL,1,300,9,-79.3333333333333,-75,-82,7
26,RL,0,300,5,-80,-78,-82,4
26,RL,0,300,3,-80.3333333333333,-78,-82,4
26,RL,1,300,9,-80.1111111111111,-79,-82,3
26,RL,0,300,4,-79.75,-79,-81,2
26,RL,0,300,1,-81,-81,-81,0
26,RL,0,300,4,-80.25,-79,-82,3
26,RL,0,300,8,-80.25,-79,-82,3
26,RL,0,300,6,-80.3333333333333,-79,-82,3
26,RL,0,300,2,-79.5,-79,-80,1
26,RL,1,300,9,-80.1111111111111,-79,-81,2
26,RL,0,300,8,-80.25,-79,-81,2
26,RL,0,300,6,-80,-79,-81,2
26,RL,1,300,9,-80.5555555555556,-79,-83,4
26,RL,0,300,8,-80.625,-79,-83,4
26,RL,0,300,3,-80.3333333333333,-79,-81,2
26,RL,0,300,7,-81.1428571428571,-79,-83,4
26,RL,0,300,1,-81,-81,-81,0
26,RL,1,300,10,-80.4,-77,-83,6
26,RL,0,300,3,-81.3333333333333,-79,-83,4
26,RL,0,300,6,-81.1666666666667,-77,-83,6
26,RL,0,300,2,-81.5,-81,-82,1
26,RL,0,300,4,-79.75,-78,-82,4
26,RL,0,300,5,-79.4,-78,-81,3
26,RL,0,300,5,-81.4,-79,-84,5
26,RL,0,300,3,-81.3333333333333,-79,-84,5
26,RL,0,300,3,-83,-81,-84,3
26,RL,0,300,5,-84,-82,-86,4
26,RL,0,300,8,-83.25,-80,-86,6
26,RL,0,300,5,-83.6,-81,-86,5
26,RL,0,300,3,-83,-81,-86,5
26,RL,0,300,4,-82,-80,-85,5
26,RL,1,300,10,-83.5,-80,-88,8
26,RL,1,300,9,-83.7777777777778,-80,-88,8
26,RL,0,300,4,-82.5,-80,-86,6
26,RL,1,300,10,-83.9,-80,-88,8
26,RL,1,300,10,-84.4,-80,-89,9
26,RL,0,300,6,-84.6666666666667,-82,-88,6
26,RL,0,300,1,-88,-88,-88,0
26,RL,0,300,7,-84.2857142857143,-82,-89,7
26,RL,1,300,9,-86.4444444444444,-82,-94,12
26,RL,1,300,10,-85.6,-81,-94,13
26,RL,0,300,1,-83,-83,-83,0
26,RL,0,300,7,-86.7142857142857,-81,-94,13
26,RL,0,300,5,-88.8,-85,-94,9
26,RL,0,300,7,-86.7142857142857,-81,-94,13
26,RL,0,300,1,-90,-90,-90,0
26,RL,0,300,3,-87,-81,-94,13
26,RL,0,300,8,-82.75,-79,-86,7
26,RL,0,300,4,-83.75,-82,-86,4
26,RL,0,300,5,-83,-79,-86,7
26,RL,0,300,1,-79,-79,-79,0
26,RL,0,300,6,-83.8333333333333,-81,-87,6
26,RL,0,300,2,-84,-84,-84,0
26,RL,0,300,7,-84.2857142857143,-81,-90,9
26,RL,0,300,4,-85.75,-81,-90,9
26,RL,0,300,7,-84.8571428571429,-80,-90,10
26,RL,0,300,1,-90,-90,-90,0
26,RL,0,300,3,-85.3333333333333,-82,-88,6
26,RL,0,300,8,-82.375,-80,-88,8
26,RL,0,300,7,-82.4285714285714,-80,-88,8
26,RL,1,300,10,-82.7,-80,-95,15
26,RL,1,300,10,-83.4,-80,-95,15
26,RL,0,300,2,-80.5,-80,-81,1
26,RL,1,300,9,-85.2222222222222,-80,-95,15
26,RL,0,300,3,-80.6666666666667,-80,-82,2
26,RL,0,300,8,-86.125,-80,-95,15
26,RL,0,300,1,-80,-80,-80,0
26,RL,0,300,5,-89.2,-81,-95,14
26,RL,1,300,9,-84.7777777777778,-80,-95,15
26,RL,1,300,9,-85.1111111111111,-80,-95,15
26,RL,0,300,4,-83,-80,-86,6
26,RL,1,300,10,-81.4,-78,-86,8
26,RL,0,300,7,-81.7142857142857,-78,-86,8
26,RL,0,300,8,-80.5,-78,-84,6
26,RL,0,300,6,-81,-78,-84,6
26,RL,0,300,8,-79.875,-77,-84,7
26,RL,0,300,7,-79.8571428571429,-77,-84,7
26,RL,0,300,7,-79.1428571428571,-77,-81,4
26,RL,1,300,9,-79.2222222222222,-77,-81,4
26,RL,1,300,10,-79.4,-77,-82,5
26,RL,0,300,2,-78.5,-77,-80,3
26,RL,0,300,7,-79.8571428571429,-79,-82,3
26,RL,0,300,7,-79.7142857142857,-79,-82,3
26,RL,0,300,7,-80,-79,-82,3
26,RL,0,300,6,-80.1666666666667,-79,-82,3
26,RL,1,300,9,-81.1111111111111,-79,-83,4
26,RL,0,300,7,-81.1428571428571,-79,-83,4
26,RL,1,300,9,-81.7777777777778,-80,-83,3
26,RL,0,300,2,-82,-81,-83,2
26,RL,0,300,1,-83,-83,-83,0
26,RL,0,300,5,-82,-81,-83,2
26,RL,0,300,7,-82.1428571428571,-81,-83,2
26,RL,0,300,4,-81.5,-81,-82,1
26,RL,0,300,5,-82.2,-81,-83,2
26,RL,1,300,9,-82,-80,-83,3
26,RL,0,300,5,-82.4,-81,-83,2
26,RL,0,300,5,-82.2,-80,-83,3
26,RL,0,300,5,-81.8,-80,-83,3
26,RL,1,300,9,-80.5555555555556,-78,-83,5
26,RL,1,300,9,-80.4444444444444,-78,-83,5
26,RL,0,300,3,-81.3333333333333,-80,-83,3
26,RL,0,300,6,-80,-78,-83,5
26,RL,0,300,8,-80.125,-78,-83,5
26,RL,1,300,9,-79.8888888888889,-78,-82,4
26,RL,0,300,2,-80,-78,-82,4
26,RL,0,300,6,-79.5,-78,-81,3
26,RL,0,300,6,-80.1666666666667,-78,-82,4
26,RL,0,300,5,-80.6,-79,-82,3
26,RL,0,300,7,-81.4285714285714,-79,-85,6
26,RL,0,300,6,-81.6666666666667,-79,-85,6
26,RL,0,300,1,-79,-79,-79,0
26,RL,0,300,1,-79,-79,-79,0
26,RL,0,300,6,-83.8333333333333,-81,-86,5
26,RL,0,300,6,-84,-81,-86,5
26,RL,1,300,9,-83.5555555555556,-80,-86,6
26,RL,0,300,1,-81,-81,-81,0
26,RL,0,300,6,-83.5,-80,-86,6
26,RL,1,300,10,-83.1,-80,-85,5
26,RL,1,300,9,-82.8888888888889,-80,-85,5
26,RL,0,300,4,-84.5,-84,-85,1
26,RL,0,300,1,-84,-84,-84,0
26,RL,0,300,5,-82.6,-80,-85,5
26,RL,0,300,3,-81.6666666666667,-80,-85,5
26,RL,1,300,10,-84.1,-80,-92,12
26,RL,0,300,7,-84.1428571428571,-80,-92,12
26,RL,0,300,4,-84.25,-80,-92,12
26,RL,0,300,3,-84.3333333333333,-80,-92,12
26,RL,0,300,5,-86.6,-81,-92,11
26,RL,1,300,10,-85.4,-81,-92,11
26,RL,0,300,5,-85.8,-84,-88,4
26,RL,0,300,3,-85.3333333333333,-84,-88,4
26,RL,0,300,3,-85.6666666666667,-84,-88,4
26,RL,0,300,7,-83.8571428571429,-81,-88,7
26,RL,1,300,9,-82.6666666666667,-78,-88,10
26,RL,0,300,8,-82.375,-78,-88,10
26,RL,0,300,6,-81.6666666666667,-78,-85,7
26,RL,1,300,10,-80.8,-76,-85,9
26,RL,0,300,3,-82.6666666666667,-81,-85,4
26,RL,0,300,7,-80.2857142857143,-76,-85,9
26,RL,0,300,5,-78.8,-76,-82,6
26,RL,0,300,6,-79.5,-76,-83,7
26,RL,0,300,5,-79.8,-76,-83,7
26,RL,0,300,1,-76,-76,-76,0
26,RL,0,300,3,-80.3333333333333,-76,-83,7
26,RL,1,300,10,-79.3,-75,-82,7
26,RL,0,300,8,-79.5,-76,-82,6
26,RL,0,300,1,-81,-81,-81,0
26,RL,0,300,5,-79.6,-77,-82,5
26,RL,0,300,8,-79.375,-75,-82,7
26,RL,0,300,2,-81,-80,-82,2
26,RL,0,300,8,-79.25,-75,-81,6
26,RL,0,300,1,-81,-81,-81,0
26,RL,0,300,1,-75,-75,-75,0
26,RL,0,300,1,-77,-77,-77,0
26,RL,0,300,4,-79.5,-78,-81,3
26,RL,0,300,8,-79.875,-78,-83,5
26,RL,0,300,1,-78,-78,-78,0
26,RL,0,300,5,-79.4,-78,-83,5
26,RL,0,300,4,-79.75,-78,-83,5
26,RL,1,300,9,-80.8888888888889,-78,-83,5
26,RL,0,300,6,-81.5,-80,-83,3
26,RL,0,300,2,-81.5,-80,-83,3
26,RL,0,300,7,-80.5714285714286,-78,-83,5
26,RL,0,300,6,-80.1666666666667,-78,-83,5
26,RL,0,300,4,-80,-79,-81,2
26,RL,0,300,6,-81.3333333333333,-78,-84,6
26,RL,0,300,4,-82.5,-81,-84,3
26,RL,0,300,1,-81,-81,-81,0
26,RL,0,300,4,-81.75,-79,-84,5
26,RL,0,300,2,-81,-79,-83,4
26,RL,1,300,10,-81.2,-79,-84,5
26,RL,0,300,1,-82,-82,-82,0
26,RL,0,300,5,-81.4,-79,-84,5
26,RL,0,300,7,-79.8571428571429,-79,-83,4
26,RL,1,300,9,-80.1111111111111,-78,-83,5
26,RL,0,300,6,-80.5,-79,-83,4
26,RL,0,300,6,-80.1666666666667,-79,-82,3
26,RL,0,300,4,-80.25,-79,-82,3
26,RL,0,300,1,-81,-81,-81,0
26,RL,0,300,8,-80.5,-78,-82,4
26,RL,0,300,8,-81.25,-78,-88,10
26,RL,0,300,3,-79.3333333333333,-78,-81,3
26,RL,0,300,1,-81,-81,-81,0
26,RL,1,300,9,-82,-79,-88,9
26,RL,0,300,7,-82.4285714285714,-79,-88,9
26,RL,1,300,10,-81.3,-79,-84,5
26,RL,0,300,5,-81.6,-79,-84,5
26,RL,1,300,10,-81.2,-79,-84,5
26,RL,0,300,1,-79,-79,-79,0
26,RL,0,300,8,-81.125,-79,-84,5
26,RL,0,300,7,-81.2857142857143,-79,-84,5
26,RL,0,300,6,-80.8333333333333,-79,-83,4
26,RL,1,300,10,-79.6,-77,-83,6
26,RL,0,300,2,-82.5,-82,-83,1
26,RL,0,300,1,-82,-82,-82,0
26,RL,0,300,8,-78.75,-77,-80,3
26,RL,0,300,7,-78.7142857142857,-77,-80,3
26,RL,0,300,2,-79,-79,-79,0
26,RL,0,300,5,-79.8,-77,-86,9
26,RL,0,300,1,-77,-77,-77,0
26,RL,0,300,8,-81.5,-79,-86,7
26,RL,0,300,3,-83,-81,-86,5
26,RL,0,300,4,-82,-80,-85,5
26,RL,0,300,3,-82.3333333333333,-80,-85,5
26,RL,0,300,3,-81.6666666666667,-80,-85,5
26,RL,0,300,5,-82.4,-79,-86,7
26,RL,1,300,10,-83.2,-79,-90,11
26,RL,1,300,10,-83,-80,-90,10
26,RL,0,300,2,-86.5,-83,-90,7
26,RL,0,300,5,-81.2,-80,-83,3
26,RL,0,300,3,-80.6666666666667,-80,-82,2
26,RL,0,300,4,-81.5,-80,-83,3
26,RL,0,300,1,-82,-82,-82,0
26,RL,0,300,6,-82.6666666666667,-80,-87,7
26,RL,0,300,6,-81.8333333333333,-76,-87,11
26,RL,0,300,7,-80.2857142857143,-76,-87,11
26,RL,1,300,9,-78.7777777777778,-74,-87,13
26,RL,0,300,7,-79.1428571428571,-74,-87,13
26,RL,1,300,10,-80,-74,-92,18
26,RL,0,300,7,-80.1428571428571,-74,-92,18
26,RL,0,300,7,-80.1428571428571,-74,-92,18
26,RL,0,300,4,-80.25,-74,-92,18
26,RL,0,300,6,-81.1666666666667,-75,-92,17
26,RL,0,300,8,-79.375,-74,-86,12
26,RL,0,300,8,-78.875,-74,-83,9
26,RL,0,300,4,-78.5,-74,-83,9
26,RL,0,300,1,-83,-83,-83,0
26,RL,0,300,3,-80.3333333333333,-79,-82,3
26,RL,0,300,4,-79.5,-77,-82,5
26,RL,0,300,1,-79,-79,-79,0
26,RL,1,300,9,-84.4444444444444,-77,-97,20
26,RL,0,300,1,-83,-83,-83,0
26,RL,0,300,3,-81.3333333333333,-77,-86,9
26,RL,0,300,6,-85.6666666666667,-75,-97,22
26,RL,1,300,10,-83.3,-75,-97,22
26,RL,0,300,1,-86,-86,-86,0
26,RL,1,300,9,-82.3333333333333,-75,-97,22
26,RL,1,300,10,-80.4,-75,-97,22
26,RL,0,300,7,-78.7142857142857,-75,-81,6
26,RL,1,300,10,-78.4,-76,-81,5
26,RL,0,300,1,-80,-80,-80,0
26,RL,0,300,7,-78,-76,-80,4
26,RL,0,300,5,-77.8,-76,-80,4
26,RL,0,300,6,-77.3333333333333,-76,-80,4
26,RL,0,300,3,-76.3333333333333,-76,-77,1
26,RL,0,300,5,-78,-76,-82,6
26,RL,0,300,6,-79.5,-76,-84,8
26,RL,0,300,3,-79,-77,-82,5
26,RL,0,300,8,-80.375,-75,-86,11
26,RL,0,300,2,-83,-82,-84,2
26,RL,0,300,7,-80.1428571428571,-75,-86,11
26,RL,1,300,9,-81.2222222222222,-75,-90,15
26,RL,1,300,10,-81.8,-75,-90,15
26,RL,0,300,1,-75,-75,-75,0
26,RL,0,300,7,-83.1428571428571,-78,-90,12
26,RL,0,300,5,-82.8,-78,-90,12
26,RL,0,300,3,-83.3333333333333,-78,-90,12
26,RL,0,300,4,-84.75,-82,-90,8
26,RL,1,300,10,-81.3,-76,-85,9
26,RL,0,300,5,-81,-76,-85,9
26,RL,0,300,7,-81.1428571428571,-76,-85,9
26,RL,0,300,5,-81.2,-80,-83,3
26,RL,0,300,7,-82.1428571428571,-79,-86,7
26,RL,1,300,10,-82.4,-79,-86,7
26,RL,0,300,4,-82.5,-79,-86,7
26,RL,0,300,2,-81.5,-79,-84,5
26,RL,1,300,9,-81.7777777777778,-76,-86,10
26,RL,0,300,6,-82.1666666666667,-76,-86,10
26,RL,1,300,9,-82.1111111111111,-76,-87,11
26,RL,1,300,10,-83.8,-76,-98,22
26,RL,0,300,1,-83,-83,-83,0
26,RL,0,300,4,-81.25,-76,-86,10
26,RL,1,300,9,-85.2222222222222,-78,-98,20
26,RL,0,300,7,-86.1428571428571,-81,-98,17
26,RL,1,300,9,-86.2222222222222,-78,-98,20
26,RL,0,300,4,-88.25,-82,-98,16
26,RL,0,300,8,-83.875,-78,-88,10
26,RL,0,300,8,-83.75,-78,-88,10
26,RL,0,300,3,-85.3333333333333,-82,-88,6
26,RL,0,300,6,-82.8333333333333,-78,-88,10
26,RL,0,300,3,-84.6666666666667,-78,-88,10
26,RL,0,300,1,-78,-78,-78,0
26,RL,1,300,9,-81,-75,-88,13
26,RL,0,300,7,-79.7142857142857,-75,-82,7
26,RL,1,300,9,-80.7777777777778,-75,-83,8
26,RL,1,300,10,-80.5,-75,-83,8
26,RL,0,300,5,-81,-78,-83,5
26,RL,0,300,6,-82.1666666666667,-80,-83,3
26,RL,0,300,4,-82.5,-82,-83,1
26,RL,0,300,7,-80.7142857142857,-75,-83,8
26,RL,1,300,10,-78.8,-75,-83,8
26,RL,1,300,9,-77.4444444444444,-75,-82,7
26,RL,0,300,8,-77.5,-75,-80,5
26,RL,1,300,10,-79.7,-76,-88,12
26,RL,0,300,2,-77.5,-77,-78,1
26,RL,0,300,3,-78.6666666666667,-77,-80,3
26,RL,0,300,8,-81.125,-76,-88,12
26,RL,0,300,3,-82,-79,-88,9
26,RL,1,300,10,-79.9,-76,-88,12
26,RL,0,300,4,-81.5,-79,-83,4
26,RL,0,300,6,-79.3333333333333,-76,-83,7
26,RL,0,300,4,-79.75,-76,-83,7
26,RL,0,300,8,-80,-76,-88,12
26,RL,1,300,10,-81.6,-76,-94,18
26,RL,0,300,7,-82.1428571428571,-76,-94,18
26,RL,0,300,5,-80.8,-76,-88,12
26,RL,0,300,8,-83.25,-76,-94,18
26,RL,0,300,1,-80,-80,-80,0
26,RL,1,300,10,-83.8,-77,-94,17
26,RL,0,300,2,-89,-84,-94,10
26,RL,0,300,8,-83.25,-77,-94,17
26,RL,0,300,1,-83,-83,-83,0
26,RL,0,300,2,-80.5,-79,-82,3
26,RL,0,300,1,-79,-79,-79,0
26,RL,0,300,4,-82,-77,-87,10
26,RL,1,300,9,-83.7777777777778,-77,-94,17
26,RL,0,300,5,-81.4,-77,-87,10
26,RL,0,300,4,-83.75,-80,-87,7
26,RL,0,300,5,-83.6,-80,-87,7
26,LR,1,300,9,-80.1111111111111,-77,-86,9
26,LR,0,300,5,-78.8,-77,-81,4
26,LR,1,300,10,-78.6,-74,-86,12
26,LR,1,300,9,-78.7777777777778,-74,-86,12
26,LR,0,300,2,-79.5,-79,-80,1
26,LR,0,300,4,-80.75,-77,-86,9
26,LR,1,300,9,-78.5555555555556,-74,-86,12
26,LR,0,300,3,-77.6666666666667,-76,-80,4
26,LR,1,300,9,-77.2222222222222,-74,-80,6
26,LR,1,300,9,-77.1111111111111,-74,-80,6
26,LR,0,300,2,-77,-74,-80,6
26,LR,0,300,8,-77.25,-74,-80,6
26,LR,0,300,2,-77,-76,-78,2
26,LR,0,300,2,-78,-76,-80,4
26,LR,1,300,10,-78.4,-74,-88,14
26,LR,0,300,1,-74,-74,-74,0
26,LR,0,300,3,-76.6666666666667,-74,-79,5
26,LR,0,300,2,-76.5,-74,-79,5
26,LR,1,300,9,-80.2222222222222,-74,-88,14
26,LR,0,300,4,-78,-74,-82,8
26,LR,1,300,10,-81.2,-74,-88,14
26,LR,1,300,10,-81.2,-74,-88,14
26,LR,0,300,1,-78,-78,-78,0
26,LR,0,300,3,-86,-82,-88,6
26,LR,0,300,1,-82,-82,-82,0
26,LR,0,300,3,-80.6666666666667,-76,-88,12
26,LR,1,300,9,-80.4444444444444,-72,-94,22
26,LR,0,300,6,-80.8333333333333,-74,-94,20
26,LR,0,300,2,-83,-82,-84,2
26,LR,0,300,7,-80.2857142857143,-72,-94,22
26,LR,0,300,4,-77.5,-72,-89,17
26,LR,0,300,4,-79.75,-72,-89,17
26,LR,0,300,4,-81.25,-74,-89,15
26,LR,0,300,3,-78.6666666666667,-74,-84,10
26,LR,0,300,3,-78.6666666666667,-74,-84,10
26,LR,0,300,3,-77,-74,-79,5
26,LR,0,300,5,-78.4,-73,-88,15
26,LR,0,300,7,-77,-72,-88,16
26,LR,1,300,9,-76,-72,-88,16
26,LR,0,300,2,-75.5,-73,-78,5
26,LR,0,300,4,-74.75,-72,-78,6
26,LR,0,300,6,-74.1666666666667,-72,-78,6
26,LR,0,300,3,-74,-72,-77,5
26,LR,0,300,7,-74.2857142857143,-72,-78,6
26,LR,0,300,3,-74.6666666666667,-73,-78,5
26,LR,0,300,4,-74.75,-72,-78,6
26,LR,0,300,3,-74.6666666666667,-72,-76,4
26,LR,0,300,5,-78.6,-76,-88,12
26,LR,0,300,6,-78.6666666666667,-76,-88,12
26,LR,0,300,3,-80.3333333333333,-76,-88,12
26,LR,0,300,2,-76.5,-76,-77,1
26,LR,0,300,7,-80.2857142857143,-76,-85,9
26,LR,0,300,6,-81,-78,-85,7
26,LR,0,300,6,-80.6666666666667,-77,-85,8
26,LR,0,300,5,-80.2,-77,-84,7
26,LR,0,300,2,-80.5,-77,-84,7
26,LR,0,300,8,-81.25,-77,-90,13
26,LR,0,300,4,-83.5,-77,-90,13
26,LR,0,300,5,-82.2,-77,-90,13
26,LR,0,300,4,-81.5,-77,-90,13
26,LR,0,300,4,-79,-77,-80,3
26,LR,0,300,8,-82.125,-78,-90,12
26,LR,0,300,5,-81.2,-78,-84,6
26,LR,0,300,7,-84,-78,-91,13
26,LR,0,300,7,-85.1428571428571,-81,-91,10
26,LR,0,300,8,-86.625,-81,-96,15
26,LR,1,300,9,-85.4444444444444,-78,-96,18
26,LR,0,300,2,-85.5,-81,-90,9
26,LR,1,300,10,-84.8,-73,-96,23
26,LR,0,300,3,-91,-86,-96,10
26,LR,0,300,1,-86,-86,-86,0
26,LR,1,300,9,-81.5555555555556,-72,-96,24
26,LR,0,300,1,-82,-82,-82,0
26,LR,1,300,9,-78.4444444444444,-72,-87,15
26,LR,0,300,3,-77.3333333333333,-72,-87,15
26,LR,0,300,1,-87,-87,-87,0
26,LR,0,300,1,-81,-81,-81,0
26,LR,0,300,2,-76,-73,-79,6
26,LR,0,300,4,-76.75,-75,-80,5
26,LR,1,300,9,-79,-73,-88,15
26,LR,0,300,8,-78.875,-73,-88,15
26,LR,0,300,8,-79.875,-73,-88,15
26,LR,1,300,10,-79.9,-73,-88,15
26,LR,0,300,8,-79.5,-73,-88,15
26,LR,1,300,10,-80.3,-73,-95,22
26,LR,0,300,3,-78.6666666666667,-73,-88,15
26,LR,0,300,7,-80,-73,-88,15
26,LR,1,300,9,-83.1111111111111,-75,-95,20
26,LR,0,300,1,-83,-83,-83,0
26,LR,0,300,6,-81.8333333333333,-75,-95,20
26,LR,0,300,3,-80.3333333333333,-76,-84,8
26,LR,0,300,8,-83.25,-76,-95,19
26,LR,0,300,4,-85.5,-80,-95,15
26,LR,0,300,1,-95,-95,-95,0
26,LR,1,300,9,-80.7777777777778,-72,-86,14
26,LR,0,300,8,-80.875,-72,-86,14
26,LR,0,300,4,-82.5,-81,-85,4
26,LR,0,300,8,-79.375,-72,-86,14
26,LR,0,300,3,-80,-72,-86,14
26,LR,0,300,1,-72,-72,-72,0
26,LR,0,300,5,-77,-74,-83,9
26,LR,0,300,2,-76,-74,-78,4
26,LR,1,300,9,-78.1111111111111,-74,-84,10
26,LR,0,300,5,-78.6,-74,-82,8
26,LR,0,300,7,-79.2857142857143,-76,-84,8
26,LR,1,300,9,-79.5555555555556,-76,-84,8
26,LR,0,300,4,-80,-76,-84,8
26,LR,0,300,4,-79.5,-76,-84,8
26,LR,0,300,6,-79.1666666666667,-76,-84,8
26,LR,0,300,8,-77.75,-76,-83,7
26,LR,0,300,3,-79.6666666666667,-78,-83,5
26,LR,0,300,6,-77.8333333333333,-75,-83,8
26,LR,0,300,3,-78.3333333333333,-76,-83,7
26,LR,0,300,5,-76.6,-75,-79,4
26,LR,1,300,10,-77.7,-72,-84,12
26,LR,1,300,10,-77.7,-72,-84,12
26,LR,0,300,8,-77.75,-72,-84,12
26,LR,0,300,5,-78,-72,-84,12
26,LR,0,300,8,-77.25,-72,-84,12
26,LR,0,300,1,-80,-80,-80,0
26,LR,0,300,6,-77.6666666666667,-72,-84,12
26,LR,1,300,9,-78.8888888888889,-72,-86,14
26,LR,0,300,5,-76.2,-72,-81,9
26,LR,0,300,8,-77.875,-72,-86,14
26,LR,0,300,1,-76,-76,-76,0
26,LR,0,300,3,-76.3333333333333,-72,-81,9
26,LR,0,300,3,-81.6666666666667,-78,-86,8
26,LR,0,300,3,-80.6666666666667,-78,-86,8
26,LR,0,300,3,-80.6666666666667,-78,-86,8
26,LR,0,300,1,-78,-78,-78,0
26,LR,0,300,6,-78.3333333333333,-73,-83,10
26,LR,0,300,4,-79,-73,-83,10
26,LR,0,300,7,-80.8571428571429,-73,-94,21
26,LR,0,300,4,-83,-76,-94,18
26,LR,1,300,9,-81.5555555555556,-76,-94,18
26,LR,0,300,5,-81.4,-76,-94,18
26,LR,0,300,3,-85,-76,-94,18
26,LR,0,300,7,-80.8571428571429,-76,-87,11
26,LR,0,300,4,-80.75,-76,-87,11
26,LR,0,300,3,-82.3333333333333,-76,-87,11
26,LR,0,300,3,-82.6666666666667,-77,-87,10
26,LR,0,300,1,-87,-87,-87,0
26,LR,0,300,3,-80.3333333333333,-77,-83,6
26,LR,0,300,8,-81.125,-75,-88,13
26,LR,0,300,4,-79.75,-75,-83,8
26,LR,0,300,4,-79.5,-75,-82,7
26,LR,0,300,1,-81,-81,-81,0
26,LR,0,300,4,-82.25,-79,-88,9
26,LR,0,300,1,-82,-82,-82,0
26,LR,0,300,5,-83,-76,-88,12
26,LR,0,300,4,-84,-76,-88,12
26,LR,1,300,10,-83.8,-76,-98,22
26,LR,0,300,6,-86.1666666666667,-78,-98,20
26,LR,0,300,4,-86.75,-78,-98,20
26,LR,0,300,1,-98,-98,-98,0
26,LR,0,300,1,-83,-83,-83,0
26,LR,0,300,8,-80.125,-73,-86,13
26,LR,0,300,4,-82.75,-78,-86,8
26,LR,0,300,3,-81.6666666666667,-78,-86,8
26,LR,1,300,9,-80.1111111111111,-73,-86,13
26,LR,0,300,8,-79.375,-73,-82,9
26,LR,1,300,10,-79.2,-73,-82,9
26,LR,0,300,1,-73,-73,-73,0
26,LR,0,300,5,-80.8,-79,-82,3
26,LR,0,300,2,-81,-80,-82,2
26,LR,0,300,5,-79.4,-76,-82,6
26,LR,0,300,8,-81.75,-76,-86,10
26,LR,1,300,10,-80.7,-73,-86,13
26,LR,0,300,8,-80.375,-73,-86,13
26,LR,0,300,4,-82.25,-76,-86,10
26,LR,0,300,2,-85,-84,-86,2
26,LR,0,300,5,-80.6,-73,-86,13
26,LR,0,300,7,-80,-73,-85,12
26,LR,0,300,1,-84,-84,-84,0
26,LR,0,300,2,-79,-77,-81,4
26,LR,0,300,4,-81.25,-76,-85,9
26,LR,1,300,10,-80.7,-76,-86,10
26,LR,0,300,3,-80.6666666666667,-76,-85,9
26,LR,1,300,9,-79.4444444444444,-76,-86,10
26,LR,0,300,7,-80.4285714285714,-77,-86,9
26,LR,1,300,10,-81,-76,-91,15
26,LR,0,300,7,-80,-76,-86,10
26,LR,0,300,2,-81,-79,-83,4
26,LR,1,300,10,-82.1,-76,-91,15
26,LR,0,300,7,-82.1428571428571,-76,-91,15
26,LR,0,300,2,-79,-76,-82,6
26,LR,0,300,4,-83,-77,-91,14
26,LR,0,300,1,-82,-82,-82,0
26,LR,1,300,9,-82.5555555555556,-75,-91,16
26,LR,0,300,2,-85,-80,-90,10
26,LR,0,300,2,-79,-75,-83,8
26,LR,0,300,4,-80,-77,-83,6
26,LR,0,300,6,-77,-72,-87,15
26,LR,0,300,7,-76.4285714285714,-72,-87,15
26,LR,1,300,10,-77.1,-72,-87,15
26,LR,0,300,3,-77.3333333333333,-72,-87,15
26,LR,0,300,2,-72.5,-72,-73,1
26,LR,0,300,5,-76.4,-73,-79,6
26,LR,0,300,5,-78.4,-78,-79,1
26,LR,0,300,5,-77.8,-76,-79,3
26,LR,0,300,8,-79.5,-75,-87,12
26,LR,1,300,10,-79.7,-75,-87,12
26,LR,0,300,4,-77.75,-75,-81,6
26,LR,0,300,4,-78.5,-75,-82,7
26,LR,0,300,8,-81.25,-75,-87,12
26,LR,0,300,1,-81,-81,-81,0
26,LR,1,300,9,-80.7777777777778,-75,-87,12
26,LR,0,300,8,-80.625,-75,-87,12
26,LR,0,300,3,-79.6666666666667,-75,-82,7
26,LR,0,300,6,-80.5,-76,-86,10
26,LR,0,300,4,-81,-76,-86,10
26,LR,0,300,6,-80.6666666666667,-76,-87,11
26,LR,0,300,7,-80,-76,-87,11
26,LR,0,300,1,-76,-76,-76,0
26,LR,1,300,10,-81.4,-77,-89,12
26,LR,0,300,2,-79,-78,-80,2
26,LR,0,300,4,-82.25,-78,-89,11
26,LR,0,300,8,-81.125,-75,-89,14
26,LR,1,300,9,-79.6666666666667,-75,-86,11
26,LR,0,300,3,-81,-78,-86,8
26,LR,0,300,1,-78,-78,-78,0
26,LR,0,300,5,-79.2,-75,-83,8
26,LR,0,300,6,-81.5,-76,-90,14
26,LR,0,300,7,-80.2857142857143,-76,-90,14
26,LR,0,300,7,-79.7142857142857,-76,-90,14
26,LR,0,300,5,-81,-77,-90,13
26,LR,1,300,9,-79.4444444444444,-77,-89,12
26,LR,0,300,1,-80,-80,-80,0
26,LR,0,300,7,-81.2857142857143,-78,-89,11
26,LR,0,300,8,-80.875,-77,-89,12
26,LR,0,300,6,-80.1666666666667,-78,-89,11
26,LR,1,300,9,-79.8888888888889,-77,-89,12
26,LR,0,300,1,-89,-89,-89,0
26,LR,0,300,2,-78,-77,-79,2
26,LR,0,300,2,-77.5,-77,-78,1
26,LR,0,300,7,-79.2857142857143,-76,-82,6
26,LR,0,300,8,-79.875,-76,-85,9
26,LR,0,300,8,-79.875,-74,-87,13
26,LR,1,300,10,-79,-74,-87,13
26,LR,0,300,3,-80.3333333333333,-76,-85,9
26,LR,0,300,6,-80,-74,-87,13
26,LR,1,300,10,-79.2,-74,-88,14
26,LR,0,300,4,-79.5,-74,-87,13
26,LR,1,300,10,-81.4,-74,-96,22
26,LR,0,300,1,-76,-76,-76,0
26,LR,0,300,1,-81,-81,-81,0
26,LR,0,300,2,-76,-74,-78,4
26,LR,0,300,6,-85.3333333333333,-77,-96,19
26,LR,1,300,10,-82.8,-75,-96,21
26,LR,0,300,2,-93,-90,-96,6
26,LR,0,300,6,-82.5,-75,-94,19
26,LR,0,300,6,-81,-75,-94,19
26,LR,0,300,6,-80.5,-75,-94,19
26,LR,0,300,7,-82.2857142857143,-75,-94,19
26,LR,0,300,3,-83.6666666666667,-76,-94,18
26,LR,0,300,3,-83.3333333333333,-79,-92,13
26,LR,0,300,7,-79.4285714285714,-76,-92,16
26,LR,0,300,6,-77,-76,-78,2
26,LR,0,300,2,-76.5,-76,-77,1
26,LR,0,300,3,-77,-77,-77,0
26,LR,0,300,8,-77.875,-77,-79,2
26,LR,0,300,5,-78,-77,-79,2
26,LR,0,300,7,-78.2857142857143,-77,-79,2
26,LR,0,300,3,-78,-77,-79,2
26,LR,0,300,7,-77.7142857142857,-76,-79,3
26,LR,0,300,5,-77.6,-76,-79,3
26,LR,0,300,5,-77.4,-76,-79,3
26,LR,0,300,8,-77.75,-74,-83,9
26,LR,0,300,1,-77,-77,-77,0
26,LR,1,300,9,-77.8888888888889,-73,-88,15
26,LR,0,300,4,-78.25,-74,-83,9
26,LR,0,300,4,-76.25,-74,-83,9
26,LR,0,300,5,-78.4,-73,-88,15
26,LR,0,300,8,-77.625,-73,-88,15
26,LR,0,300,8,-78.125,-73,-88,15
26,LR,0,300,5,-78.6,-73,-88,15
26,LR,1,300,10,-78.7,-74,-83,9
26,LR,0,300,5,-79.6,-76,-82,6
26,LR,0,300,8,-79.625,-74,-83,9
26,LR,0,300,1,-80,-80,-80,0
26,LR,1,300,9,-80.1111111111111,-72,-88,16
26,LR,0,300,2,-82.5,-82,-83,1
26,LR,0,300,2,-81,-79,-83,4
26,LR,1,300,9,-80.4444444444444,-72,-88,16
26,LR,0,300,6,-81,-72,-88,16
26,LR,0,300,6,-80.5,-72,-88,16
26,LR,1,300,10,-81.6,-72,-88,16
26,LR,0,300,6,-80.6666666666667,-72,-88,16
26,LR,0,300,5,-82.4,-76,-88,12
26,LR,0,300,5,-83.6,-76,-88,12
26,LR,0,300,3,-83.6666666666667,-76,-88,12
26,LR,0,300,7,-82.1428571428571,-75,-88,13
26,LR,1,300,10,-81.1,-75,-87,12
26,LR,0,300,3,-81.3333333333333,-76,-87,11
26,LR,0,300,1,-76,-76,-76,0
26,LR,0,300,7,-80.1428571428571,-75,-82,7
26,LR,0,300,1,-75,-75,-75,0
26,LR,1,300,9,-80.3333333333333,-74,-82,8
26,LR,0,300,3,-81.6666666666667,-81,-82,1
26,LR,0,300,1,-82,-82,-82,0
26,LR,0,300,3,-80.6666666666667,-79,-82,3
26,LR,0,300,2,-80,-79,-81,2
26,LR,0,300,7,-78.2857142857143,-74,-82,8
26,LR,0,300,2,-77.5,-74,-81,7
26,LR,1,300,9,-78.3333333333333,-74,-82,8
26,LR,0,300,8,-78,-74,-82,8
26,LR,0,300,2,-79,-76,-82,6
26,LR,0,300,3,-77.6666666666667,-75,-82,7
26,LR,0,300,1,-76,-76,-76,0
26,LR,0,300,5,-78.8,-75,-82,7
26,LR,0,300,6,-79.3333333333333,-78,-82,4
26,LR,0,300,5,-79.4,-78,-82,4
26,LR,0,300,7,-78.8571428571429,-78,-80,2
26,LR,0,300,3,-78.6666666666667,-78,-79,1
26,LR,1,300,9,-79,-74,-86,12
26,LR,0,300,8,-79.125,-74,-86,12
26,LR,0,300,5,-78,-74,-82,8
26,LR,0,300,6,-78.1666666666667,-73,-86,13
26,LR,0,300,1,-79,-79,-79,0
26,LR,0,300,4,-78.25,-73,-86,13
26,LR,0,300,2,-79.5,-73,-86,13
26,LR,0,300,8,-80.25,-73,-91,18
26,LR,0,300,2,-78.5,-78,-79,1
26,LR,1,300,9,-78.6666666666667,-73,-86,13
26,LR,1,300,10,-79.9,-73,-91,18
26,LR,0,300,6,-79.6666666666667,-73,-91,18
26,LR,0,300,7,-79,-73,-91,18
26,LR,1,300,10,-80.3,-73,-91,18
26,LR,0,300,6,-83,-75,-91,16
26,LR,0,300,5,-82.6,-75,-89,14
31,RL,0,350,6,-81.5,-77,-85,8
31,RL,0,350,6,-82.6666666666667,-78,-85,7
31,RL,0,350,7,-84.2857142857143,-82,-89,7
31,RL,0,350,7,-84.4285714285714,-83,-89,6
31,RL,0,350,4,-84,-83,-85,2
31,RL,0,350,3,-84,-83,-85,2
31,RL,0,350,1,-83,-83,-83,0
31,RL,0,350,2,-86,-83,-89,6
31,RL,1,350,9,-81.5555555555556,-77,-86,9
31,RL,1,350,9,-82,-77,-87,10
31,RL,0,350,5,-82.4,-78,-86,8
31,RL,0,350,7,-84.7142857142857,-81,-89,8
31,RL,0,350,2,-83.5,-81,-86,5
31,RL,0,350,4,-86.25,-83,-89,6
31,RL,1,350,9,-83.3333333333333,-78,-89,11
31,RL,0,350,3,-80.6666666666667,-78,-84,6
31,RL,0,350,5,-82.8,-78,-87,9
31,RL,0,350,5,-84,-82,-87,5
31,RL,0,350,8,-84.875,-81,-91,10
31,RL,0,350,5,-85.2,-82,-91,9
31,RL,0,350,3,-86,-83,-91,8
31,RL,0,350,7,-86.2857142857143,-81,-91,10
31,RL,0,350,1,-86,-86,-86,0
31,RL,1,350,9,-84.5555555555556,-81,-90,9
31,RL,0,350,6,-85,-81,-90,9
31,RL,0,350,2,-86,-84,-88,4
31,RL,0,350,4,-83.5,-83,-84,1
31,RL,1,350,10,-85.3,-81,-95,14
31,RL,0,350,5,-85.4,-83,-95,12
31,RL,1,350,10,-86,-81,-95,14
31,RL,0,350,1,-83,-83,-83,0
31,RL,0,350,4,-89,-85,-95,10
31,RL,0,350,3,-87,-85,-91,6
31,RL,0,350,5,-85,-81,-93,12
31,RL,0,350,8,-84.625,-79,-97,18
31,RL,0,350,1,-93,-93,-93,0
31,RL,0,350,2,-89,-81,-97,16
31,RL,0,350,8,-84.125,-79,-97,18
31,RL,0,350,1,-83,-83,-83,0
31,RL,1,350,9,-81.8888888888889,-79,-84,5
31,RL,0,350,7,-81.8571428571429,-79,-84,5
31,RL,0,350,1,-79,-79,-79,0
31,RL,0,350,5,-83,-82,-84,2
31,RL,0,350,8,-81.5,-78,-84,6
31,RL,0,350,4,-82,-80,-84,4
31,RL,0,350,1,-82,-82,-82,0
31,RL,0,350,3,-81,-80,-82,2
31,RL,0,350,2,-80.5,-80,-81,1
31,RL,0,350,8,-79.5,-77,-82,5
31,RL,0,350,8,-78.75,-77,-82,5
31,RL,1,350,9,-78.5555555555556,-77,-82,5
31,RL,0,350,3,-78.6666666666667,-77,-82,5
31,RL,0,350,6,-78.3333333333333,-77,-82,5
31,RL,0,350,3,-78,-77,-80,3
31,RL,0,350,5,-77.8,-77,-80,3
31,RL,0,350,1,-80,-80,-80,0
31,RL,0,350,7,-77.4285714285714,-76,-79,3
31,RL,1,350,10,-77.2,-76,-79,3
31,RL,0,350,8,-77.125,-76,-79,3
31,RL,1,350,10,-77.1,-76,-79,3
31,RL,0,350,4,-76.75,-76,-78,2
31,RL,0,350,4,-76.75,-76,-78,2
31,RL,0,350,6,-76.8333333333333,-76,-78,2
31,RL,0,350,5,-77,-76,-78,2
31,RL,0,350,4,-77.25,-77,-78,1
31,RL,1,350,9,-77.1111111111111,-76,-78,2
31,RL,0,350,3,-76.6666666666667,-76,-77,1
31,RL,0,350,2,-76.5,-76,-77,1
31,RL,0,350,6,-77.1666666666667,-76,-78,2
31,RL,1,350,9,-77.7777777777778,-76,-80,4
31,RL,0,350,5,-77.8,-77,-78,1
31,RL,0,350,8,-79.25,-77,-82,5
31,RL,0,350,8,-79.375,-77,-82,5
31,RL,1,350,10,-79.7,-78,-82,4
31,RL,1,350,9,-79.7777777777778,-77,-82,5
31,RL,0,350,2,-80.5,-80,-81,1
31,RL,0,350,8,-79.375,-77,-82,5
31,RL,0,350,1,-82,-82,-82,0
31,RL,1,350,10,-78.9,-77,-80,3
31,RL,0,350,2,-80,-80,-80,0
31,RL,0,350,4,-78.25,-77,-80,3
31,RL,0,350,6,-78.3333333333333,-77,-80,3
31,RL,1,350,9,-78.8888888888889,-77,-81,4
31,RL,0,350,1,-77,-77,-77,0
31,RL,0,350,6,-79.1666666666667,-77,-80,3
31,RL,0,350,3,-79,-77,-80,3
31,RL,0,350,8,-79.75,-77,-84,7
31,RL,0,350,7,-80.1428571428571,-77,-84,7
31,RL,0,350,2,-79,-79,-79,0
31,RL,0,350,3,-80.3333333333333,-79,-81,2
31,RL,1,350,10,-81.6,-77,-84,7
31,RL,1,350,10,-81.7,-77,-84,7
31,RL,0,350,6,-81.8333333333333,-77,-84,7
31,RL,0,350,3,-82,-80,-83,3
31,RL,0,350,5,-82,-80,-84,4
31,RL,1,350,9,-81.2222222222222,-77,-84,7
31,RL,0,350,4,-82.25,-80,-84,4
31,RL,1,350,9,-80.1111111111111,-77,-83,6
31,RL,0,350,8,-79.75,-77,-82,5
31,RL,0,350,2,-81,-80,-82,2
31,RL,0,350,5,-78.8,-77,-80,3
31,RL,0,350,6,-78.5,-77,-80,3
31,RL,0,350,5,-78.2,-77,-80,3
31,RL,0,350,2,-78.5,-77,-80,3
31,RL,0,350,1,-80,-80,-80,0
31,RL,1,350,9,-79.5555555555556,-77,-81,4
31,RL,0,350,8,-79.5,-77,-81,4
31,RL,0,350,5,-79.6,-78,-80,2
31,RL,0,350,1,-80,-80,-80,0
31,RL,0,350,6,-79.8333333333333,-78,-81,3
31,RL,0,350,5,-80.2,-80,-81,1
31,RL,0,350,4,-80.75,-80,-82,2
31,RL,0,350,8,-79.875,-78,-82,4
31,RL,1,350,10,-79.2,-78,-82,4
31,RL,0,350,3,-79.3333333333333,-78,-80,2
31,RL,0,350,1,-80,-80,-80,0
31,RL,0,350,8,-78.5,-78,-79,1
31,RL,0,350,4,-78.5,-78,-79,1
31,RL,0,350,3,-78.3333333333333,-78,-79,1
31,RL,0,350,3,-78.3333333333333,-78,-79,1
31,RL,0,350,1,-78,-78,-78,0
31,RL,0,350,5,-79.4,-78,-81,3
31,RL,0,350,1,-78,-78,-78,0
31,RL,1,350,10,-80,-78,-83,5
31,RL,0,350,5,-80.2,-80,-81,1
31,RL,0,350,4,-80,-80,-80,0
31,RL,0,350,7,-80,-78,-83,5
31,RL,0,350,7,-80.2857142857143,-78,-83,5
31,RL,0,350,3,-79.3333333333333,-78,-80,2
31,RL,0,350,6,-80.6666666666667,-78,-83,5
31,RL,0,350,7,-80.7142857142857,-78,-83,5
31,RL,0,350,8,-80.875,-78,-83,5
31,RL,0,350,5,-80.8,-78,-82,4
31,RL,0,350,2,-81.5,-81,-82,1
31,RL,0,350,8,-79.75,-78,-81,3
31,RL,0,350,8,-79.375,-78,-81,3
31,RL,1,350,10,-78.8,-78,-81,3
31,RL,1,350,9,-78.4444444444444,-77,-80,3
31,RL,0,350,4,-78.25,-78,-79,1
31,RL,0,350,1,-78,-78,-78,0
31,RL,0,350,4,-78,-78,-78,0
31,RL,0,350,6,-77.8333333333333,-77,-78,1
31,RL,0,350,4,-77.75,-77,-78,1
31,RL,0,350,7,-77.8571428571429,-77,-78,1
31,RL,0,350,6,-77.8333333333333,-77,-78,1
31,RL,0,350,3,-78,-78,-78,0
31,RL,0,350,3,-78,-78,-78,0
31,RL,0,350,4,-78.5,-78,-80,2
31,RL,0,350,7,-80,-78,-82,4
31,RL,0,350,6,-80.3333333333333,-78,-82,4
31,RL,0,350,3,-81,-80,-82,2
31,RL,0,350,3,-81.3333333333333,-81,-82,1
31,RL,0,350,5,-80.2,-79,-82,3
31,RL,0,350,7,-80.4285714285714,-79,-83,4
31,RL,0,350,3,-81.3333333333333,-80,-83,3
31,RL,0,350,7,-80.8571428571429,-79,-82,3
31,RL,0,350,3,-80.6666666666667,-79,-82,3
31,RL,0,350,7,-81.8571428571429,-81,-83,2
31,RL,0,350,5,-81.8,-81,-83,2
31,RL,1,350,9,-84.4444444444444,-81,-88,7
31,RL,0,350,8,-84.75,-81,-88,7
31,RL,1,350,10,-85.1,-82,-88,6
31,RL,1,350,9,-85.4444444444444,-82,-88,6
31,RL,1,350,10,-85.8,-82,-88,6
31,RL,0,350,5,-87.2,-86,-88,2
31,RL,0,350,5,-86.6,-84,-88,4
31,RL,0,350,4,-86.25,-84,-88,4
31,RL,1,350,10,-84.6,-80,-89,9
31,RL,0,350,1,-86,-86,-86,0
31,RL,1,350,10,-84.5,-80,-89,9
31,RL,0,350,4,-84.5,-82,-86,4
31,RL,0,350,4,-85.75,-82,-89,7
31,RL,0,350,7,-84.4285714285714,-80,-89,9
31,RL,0,350,7,-85.5714285714286,-80,-89,9
31,RL,1,350,10,-84.8,-80,-88,8
31,RL,0,350,4,-87.25,-86,-88,2
31,RL,0,350,4,-85.75,-80,-88,8
31,RL,0,350,2,-88,-88,-88,0
31,RL,0,350,5,-84.6,-80,-88,8
31,RL,0,350,7,-84.2857142857143,-80,-92,12
31,RL,0,350,5,-86,-82,-92,10
31,RL,1,350,9,-84.6666666666667,-80,-92,12
31,RL,0,350,3,-85.3333333333333,-80,-92,12
31,RL,0,350,7,-83.4285714285714,-80,-87,7
31,RL,0,350,1,-84,-84,-84,0
31,RL,0,350,1,-84,-84,-84,0
31,RL,1,350,9,-82.6666666666667,-78,-88,10
31,RL,0,350,2,-85.5,-85,-86,1
31,RL,0,350,6,-81.3333333333333,-78,-88,10
31,RL,0,350,2,-79.5,-78,-81,3
31,RL,0,350,4,-78.5,-78,-80,2
31,RL,0,350,8,-87.875,-78,-96,18
31,RL,0,350,8,-88.125,-78,-96,18
31,RL,0,350,5,-90.6,-80,-96,16
31,RL,0,350,6,-91.1666666666667,-80,-96,16
31,RL,1,350,10,-86.3,-77,-96,19
31,RL,0,350,3,-94.3333333333333,-93,-96,3
31,RL,0,350,5,-87,-80,-94,14
31,RL,0,350,6,-83,-77,-94,17
31,RL,0,350,2,-80,-80,-80,0
31,RL,1,350,10,-83.5,-77,-90,13
31,RL,0,350,4,-82,-77,-88,11
31,RL,1,350,9,-84.5555555555556,-77,-90,13
31,RL,1,350,10,-85.1,-81,-90,9
31,RL,0,350,6,-85.5,-81,-90,9
31,RL,0,350,8,-85,-81,-90,9
31,RL,1,350,9,-83.5555555555556,-81,-87,6
31,RL,1,350,10,-83.6,-80,-87,7
31,RL,0,350,5,-84.6,-83,-87,4
31,RL,1,350,9,-82.7777777777778,-80,-87,7
31,RL,0,350,4,-82,-81,-83,2
31,RL,1,350,9,-81.5555555555556,-80,-85,5
31,RL,1,350,9,-83.3333333333333,-80,-90,10
31,RL,0,350,2,-82.5,-80,-85,5
31,RL,0,350,7,-83.4285714285714,-80,-90,10
31,RL,0,350,3,-81,-81,-81,0
31,RL,0,350,8,-83,-80,-90,10
31,RL,0,350,6,-83.8333333333333,-80,-90,10
31,RL,0,350,2,-85.5,-81,-90,9
31,RL,0,350,2,-90,-90,-90,0
31,RL,0,350,6,-82.1666666666667,-80,-90,10
31,RL,0,350,3,-80.3333333333333,-80,-81,1
31,RL,1,350,9,-82.5555555555556,-79,-88,9
31,RL,0,350,7,-83.4285714285714,-81,-88,7
31,RL,0,350,7,-83.1428571428571,-79,-88,9
31,RL,0,350,3,-85,-82,-88,6
31,RL,0,350,5,-83.2,-79,-88,9
31,RL,0,350,5,-80.8,-76,-86,10
31,RL,0,350,2,-82.5,-79,-86,7
31,RL,0,350,3,-79.6666666666667,-76,-82,6
31,RL,0,350,5,-80,-77,-82,5
31,RL,0,350,2,-80,-78,-82,4
31,RL,0,350,4,-78,-76,-81,5
31,RL,0,350,6,-77,-76,-81,5
31,RL,0,350,8,-77.875,-76,-86,10
31,RL,0,350,7,-77.4285714285714,-76,-86,10
31,RL,0,350,6,-77.6666666666667,-76,-86,10
31,RL,0,350,5,-78,-76,-86,10
31,RL,0,350,6,-77.5,-75,-86,11
31,RL,0,350,6,-81.5,-75,-86,11
31,RL,0,350,8,-79.875,-75,-86,11
31,RL,0,350,4,-81.75,-75,-86,11
31,RL,0,350,2,-85.5,-85,-86,1
31,RL,1,350,9,-83.7777777777778,-76,-92,16
31,RL,1,350,10,-82.7,-76,-92,16
31,RL,0,350,4,-85.5,-78,-92,14
31,RL,0,350,4,-88.25,-78,-92,14
31,RL,1,350,10,-82.4,-75,-92,17
31,RL,1,350,10,-80.8,-75,-92,17
31,RL,1,350,10,-79.9,-75,-91,16
31,RL,0,350,2,-81,-76,-86,10
31,RL,0,350,4,-80.75,-76,-86,10
31,RL,0,350,7,-78,-75,-83,8
31,RL,0,350,8,-78.5,-75,-83,8
31,RL,1,350,10,-78.3,-75,-88,13
31,RL,1,350,9,-79,-76,-88,12
31,RL,0,350,3,-78,-76,-82,6
31,RL,1,350,9,-78.6666666666667,-76,-88,12
31,RL,0,350,4,-79.5,-76,-88,12
31,RL,0,350,5,-79.8,-76,-88,12
31,RL,0,350,1,-78,-78,-78,0
31,RL,0,350,5,-82.2,-78,-97,19
31,RL,1,350,10,-82,-78,-97,19
31,RL,0,350,8,-81.875,-78,-97,19
31,RL,0,350,5,-84.2,-78,-97,19
31,RL,0,350,3,-81.6666666666667,-78,-89,11
31,RL,0,350,5,-80.4,-78,-89,11
31,RL,0,350,7,-80.8571428571429,-78,-89,11
31,RL,0,350,3,-80.6666666666667,-78,-86,8
31,RL,1,350,9,-78.1111111111111,-76,-86,10
31,RL,0,350,7,-78.2857142857143,-76,-86,10
31,RL,0,350,7,-78.1428571428571,-76,-86,10
31,RL,1,350,10,-78.3,-76,-85,9
31,RL,0,350,5,-76.8,-76,-78,2
31,RL,1,350,9,-78.2222222222222,-76,-85,9
31,RL,0,350,6,-77.8333333333333,-76,-84,8
31,RL,1,350,10,-78.9,-76,-85,9
31,RL,0,350,5,-79.8,-76,-85,9
31,RL,0,350,8,-79.375,-76,-85,9
31,RL,0,350,5,-81,-76,-85,9
31,RL,0,350,8,-78.25,-76,-85,9
31,RL,0,350,4,-78.25,-76,-83,7
31,RL,0,350,8,-77.125,-76,-83,7
31,RL,0,350,5,-77.6,-76,-83,7
31,RL,0,350,1,-77,-77,-77,0
31,RL,0,350,2,-76,-76,-76,0
31,RL,0,350,5,-76.8,-76,-80,4
31,RL,1,350,10,-77.4,-76,-80,4
31,RL,0,350,6,-77.5,-76,-80,4
31,RL,0,350,7,-77.5714285714286,-76,-80,4
31,RL,1,350,9,-77.6666666666667,-76,-80,4
31,RL,0,350,3,-78,-76,-80,4
31,RL,0,350,8,-79.25,-76,-88,12
31,RL,1,350,9,-80.1111111111111,-76,-88,12
31,RL,0,350,7,-80,-76,-88,12
31,RL,0,350,6,-80.6666666666667,-77,-88,11
31,RL,1,350,10,-83.2,-77,-88,11
31,RL,0,350,4,-81.25,-77,-88,11
31,RL,0,350,4,-82.75,-80,-88,8
31,RL,0,350,6,-84.8333333333333,-80,-88,8
31,RL,0,350,4,-83.75,-80,-88,8
31,RL,0,350,8,-83.125,-78,-88,10
31,RL,0,350,5,-84.8,-79,-88,9
31,RL,0,350,8,-80.625,-77,-86,9
31,RL,0,350,1,-85,-85,-85,0
31,RL,1,350,10,-80.3,-77,-83,6
31,RL,0,350,5,-80,-77,-83,6
31,RL,0,350,5,-80,-77,-83,6
31,RL,0,350,4,-81,-79,-83,4
31,RL,0,350,4,-81.25,-79,-83,4
31,RL,0,350,3,-80.6666666666667,-79,-83,4
31,RL,0,350,6,-81.5,-78,-83,5
31,RL,0,350,8,-82,-78,-87,9
31,RL,0,350,6,-81.8333333333333,-78,-87,9
31,RL,0,350,2,-80.5,-78,-83,5
31,RL,1,350,9,-81.8888888888889,-77,-87,10
31,RL,0,350,2,-85,-83,-87,4
31,RL,0,350,6,-81.5,-77,-85,8
31,RL,0,350,3,-80.3333333333333,-77,-82,5
31,RL,0,350,4,-82.25,-77,-85,8
31,RL,0,350,7,-82.2857142857143,-78,-85,7
31,RL,1,350,9,-81.3333333333333,-78,-85,7
31,RL,0,350,3,-82.3333333333333,-78,-85,7
31,RL,0,350,5,-80.4,-78,-84,6
31,RL,0,350,1,-84,-84,-84,0
31,RL,0,350,4,-80.25,-78,-81,3
31,RL,0,350,8,-81.25,-78,-90,12
31,RL,0,350,4,-82,-78,-90,12
31,RL,0,350,7,-82.5714285714286,-79,-90,11
31,RL,0,350,5,-83.6,-79,-90,11
31,RL,0,350,7,-82,-79,-87,8
31,RL,1,350,10,-81.4,-78,-87,9
31,RL,1,350,10,-81.3,-78,-87,9
31,RL,0,350,8,-81.875,-78,-87,9
31,RL,0,350,6,-81.5,-78,-85,7
31,RL,0,350,4,-82.5,-80,-85,5
31,RL,0,350,1,-80,-80,-80,0
31,RL,0,350,8,-80.5,-78,-83,5
31,RL,0,350,1,-82,-82,-82,0
31,RL,0,350,5,-79.6,-78,-83,5
31,RL,0,350,1,-79,-79,-79,0
31,RL,0,350,1,-78,-78,-78,0
31,RL,0,350,6,-81.1666666666667,-80,-82,2
31,RL,1,350,9,-81.2222222222222,-80,-82,2
31,RL,1,350,10,-80.8,-77,-82,5
31,RL,0,350,8,-81.125,-80,-82,2
31,RL,0,350,5,-81.2,-81,-82,1
31,RL,0,350,3,-81.3333333333333,-81,-82,1
31,RL,1,350,9,-79.8888888888889,-77,-82,5
31,RL,0,350,7,-80.1428571428571,-77,-82,5
31,RL,0,350,2,-80.5,-80,-81,1
31,RL,0,350,7,-79.2857142857143,-77,-82,5
31,RL,0,350,1,-77,-77,-77,0
31,RL,0,350,6,-79.1666666666667,-77,-82,5
31,RL,0,350,2,-79.5,-77,-82,5
31,RL,0,350,1,-77,-77,-77,0
31,RL,0,350,5,-80.6,-78,-86,8
31,RL,0,350,6,-83.1666666666667,-79,-86,7
31,RL,1,350,10,-83.2,-80,-86,6
31,RL,0,350,1,-86,-86,-86,0
31,RL,0,350,7,-82.2857142857143,-80,-86,6
31,RL,0,350,8,-82.375,-80,-85,5
31,RL,1,350,10,-83,-80,-85,5
31,RL,0,350,1,-82,-82,-82,0
31,RL,0,350,3,-82,-80,-84,4
31,RL,1,350,9,-84,-82,-85,3
31,RL,1,350,10,-84.3,-83,-86,3
31,RL,0,350,8,-84.5,-83,-86,3
31,RL,0,350,6,-84.3333333333333,-83,-85,2
31,RL,0,350,1,-85,-85,-85,0
31,RL,1,350,9,-83.5555555555556,-80,-86,6
31,RL,1,350,10,-83.6,-80,-86,6
31,RL,1,350,10,-83.4,-80,-86,6
31,RL,1,350,9,-83,-80,-86,6
31,RL,0,350,5,-84.4,-83,-86,3
31,RL,0,350,1,-84,-84,-84,0
31,RL,0,350,3,-84,-83,-85,2
31,RL,1,350,10,-84.5,-82,-89,7
31,RL,0,350,3,-82.6666666666667,-82,-84,2
31,RL,0,350,7,-85.1428571428571,-82,-89,7
31,RL,1,350,9,-84.6666666666667,-82,-89,7
31,RL,0,350,3,-87,-86,-89,3
31,RL,0,350,1,-86,-86,-86,0
31,RL,0,350,6,-84.6666666666667,-82,-89,7
31,RL,0,350,8,-82.25,-78,-89,11
31,RL,0,350,8,-82.375,-78,-90,12
31,RL,0,350,4,-82.75,-82,-84,2
31,RL,0,350,7,-81.1428571428571,-78,-90,12
31,RL,0,350,3,-79.6666666666667,-78,-83,5
31,RL,1,350,9,-81.5555555555556,-78,-94,16
31,RL,0,350,6,-81.3333333333333,-78,-94,16
31,RL,0,350,5,-82,-78,-94,16
31,RL,0,350,1,-94,-94,-94,0
31,RL,0,350,5,-81.8,-77,-89,12
31,RL,0,350,7,-78.5714285714286,-76,-87,11
31,RL,0,350,3,-77.3333333333333,-77,-78,1
31,RL,0,350,7,-79.8571428571429,-76,-87,11
31,RL,1,350,9,-79.2222222222222,-76,-87,11
31,RL,1,350,9,-79.2222222222222,-76,-87,11
31,RL,0,350,7,-78.4285714285714,-76,-85,9
31,RL,0,350,5,-79,-76,-85,9
31,RL,1,350,9,-79.4444444444444,-76,-90,14
31,RL,0,350,3,-77,-76,-78,2
31,RL,0,350,4,-78.25,-77,-79,2
31,RL,0,350,2,-78,-77,-79,2
31,RL,0,350,1,-79,-79,-79,0
31,RL,0,350,2,-84.5,-79,-90,11
31,RL,0,350,3,-82.6666666666667,-79,-90,11
31,RL,1,350,9,-83.3333333333333,-78,-97,19
31,RL,0,350,6,-82.6666666666667,-78,-97,19
31,RL,0,350,2,-80.5,-80,-81,1
31,RL,0,350,3,-85.3333333333333,-78,-97,19
31,RL,0,350,7,-84.2857142857143,-78,-100,22
31,RL,0,350,1,-80,-80,-80,0
31,RL,0,350,5,-86.4,-78,-100,22
31,RL,1,350,9,-82.7777777777778,-77,-100,23
31,RL,0,350,5,-82.2,-78,-94,16
31,RL,0,350,3,-79.6666666666667,-78,-81,3
31,RL,0,350,7,-83.5714285714286,-77,-96,19
31,RL,0,350,1,-80,-80,-80,0
31,RL,0,350,2,-85.5,-77,-94,17
31,RL,0,350,1,-77,-77,-77,0
31,RL,1,350,9,-82.7777777777778,-77,-98,21
31,RL,0,350,6,-84.6666666666667,-78,-98,20
31,RL,0,350,7,-82,-78,-98,20
31,RL,1,350,9,-83.5555555555556,-78,-98,20
31,RL,0,350,1,-98,-98,-98,0
31,RL,0,350,3,-79.3333333333333,-78,-80,2
31,RL,0,350,5,-83.2,-79,-97,18
31,RL,0,350,7,-81.7142857142857,-78,-97,19
31,RL,0,350,4,-83.5,-78,-97,19
31,RL,0,350,6,-79.1666666666667,-78,-80,2
31,RL,0,350,6,-79.3333333333333,-78,-80,2
31,RL,0,350,7,-80,-78,-82,4
31,RL,0,350,2,-79,-78,-80,2
31,RL,0,350,4,-80.5,-80,-82,2
31,RL,0,350,1,-80,-80,-80,0
31,RL,0,350,7,-84.1428571428571,-80,-91,11
31,RL,0,350,4,-86.25,-82,-91,9
31,RL,0,350,3,-87.6666666666667,-82,-91,9
31,RL,0,350,1,-90,-90,-90,0
31,RL,0,350,8,-82.375,-80,-91,11
31,RL,0,350,6,-81.3333333333333,-80,-86,6
31,RL,0,350,5,-81.2,-80,-86,6
31,RL,0,350,5,-80.8,-78,-86,8
31,RL,1,350,10,-82.2,-78,-87,9
31,RL,0,350,3,-81.3333333333333,-78,-86,8
31,RL,0,350,4,-79.5,-78,-80,2
31,RL,0,350,7,-82.2857142857143,-78,-87,9
31,RL,0,350,8,-84.25,-80,-92,12
31,RL,1,350,9,-85.2222222222222,-80,-92,12
31,RL,0,350,1,-87,-87,-87,0
31,RL,0,350,8,-84.625,-77,-92,15
31,RL,0,350,8,-83.375,-77,-92,15
31,RL,0,350,2,-87,-82,-92,10
31,RL,0,350,3,-89,-84,-92,8
31,RL,0,350,6,-81.1666666666667,-76,-91,15
31,RL,0,350,4,-81.75,-77,-91,14
31,RL,0,350,6,-78.3333333333333,-74,-84,10
31,RL,0,350,2,-77,-77,-77,0
31,RL,0,350,7,-77.4285714285714,-74,-84,10
31,RL,0,350,7,-77.4285714285714,-74,-84,10
31,RL,0,350,5,-76.4,-74,-82,8
31,RL,0,350,6,-76.3333333333333,-74,-82,8
31,RL,0,350,5,-75.2,-74,-76,2
31,RL,0,350,3,-74.6666666666667,-74,-76,2
31,RL,0,350,4,-76.25,-74,-81,7
31,RL,1,350,10,-77.4,-74,-81,7
31,RL,0,350,3,-78.3333333333333,-74,-81,7
31,RL,0,350,8,-77.375,-74,-80,6
31,RL,0,350,7,-77.8571428571429,-76,-80,4
31,RL,0,350,5,-77.4,-76,-80,4
31,RL,0,350,4,-77.75,-76,-80,4
31,RL,0,350,1,-76,-76,-76,0
31,RL,1,350,9,-77.5555555555556,-76,-81,5
31,RL,0,350,2,-76.5,-76,-77,1
31,RL,0,350,7,-77.5714285714286,-76,-81,5
31,RL,0,350,6,-77.8333333333333,-76,-81,5
31,RL,1,350,9,-78.2222222222222,-76,-81,5
31,RL,1,350,10,-77.9,-76,-81,5
31,RL,0,350,1,-81,-81,-81,0
31,RL,0,350,5,-77.4,-76,-79,3
31,RL,0,350,4,-77.5,-76,-79,3
31,RL,0,350,4,-78.25,-76,-79,3
31,RL,0,350,6,-78.1666666666667,-76,-79,3
31,RL,0,350,6,-78.8333333333333,-77,-80,3
31,RL,1,350,10,-78.9,-77,-80,3
31,RL,0,350,8,-78.75,-77,-80,3
31,RL,0,350,3,-79,-78,-80,2
31,RL,1,350,10,-78.9,-78,-80,2
31,RL,0,350,1,-78,-78,-78,0
31,RL,0,350,5,-78.8,-78,-80,2
31,RL,0,350,7,-79.5714285714286,-78,-82,4
31,RL,0,350,2,-78.5,-78,-79,1
31,RL,0,350,2,-78.5,-78,-79,1
31,RL,0,350,7,-79.7142857142857,-77,-84,7
31,RL,1,350,9,-79.3333333333333,-77,-84,7
31,RL,0,350,6,-79.3333333333333,-77,-84,7
31,RL,1,350,9,-78.3333333333333,-77,-84,7
31,RL,0,350,4,-79.25,-77,-84,7
31,RL,0,350,6,-78.6666666666667,-77,-84,7
31,RL,1,350,10,-77.7,-76,-80,4
31,RL,0,350,1,-78,-78,-78,0
31,RL,0,350,8,-77.625,-76,-80,4
31,RL,1,350,10,-77.5,-75,-80,5
31,RL,0,350,7,-78,-76,-80,4
31,RL,0,350,5,-78.2,-76,-80,4
31,RL,0,350,4,-78.5,-76,-80,4
31,RL,0,350,5,-77.6,-75,-80,5
31,RL,0,350,8,-77.125,-75,-79,4
31,RL,1,350,9,-77.4444444444444,-75,-80,5
31,RL,0,350,7,-77.1428571428571,-75,-80,5
31,RL,0,350,7,-77.2857142857143,-76,-80,4
31,RL,1,350,9,-77.7777777777778,-76,-80,4
31,RL,0,350,8,-77.625,-76,-80,4
31,RL,0,350,1,-77,-77,-77,0
31,RL,1,350,9,-78,-76,-82,6
31,RL,1,350,10,-79,-76,-82,6
31,RL,0,350,1,-80,-80,-80,0
31,RL,0,350,3,-77.3333333333333,-76,-80,4
31,RL,0,350,6,-78.8333333333333,-76,-82,6
31,RL,0,350,7,-79.2857142857143,-76,-82,6
31,RL,0,350,7,-79.4285714285714,-76,-82,6
31,RL,0,350,6,-79,-76,-82,6
31,RL,1,350,10,-78.6,-76,-81,5
31,RL,0,350,3,-78.3333333333333,-77,-81,4
31,RL,0,350,4,-77,-76,-78,2
31,RL,0,350,4,-77.75,-76,-80,4
31,RL,0,350,2,-77,-76,-78,2
31,RL,0,350,5,-78.8,-76,-80,4
31,RL,0,350,5,-78.2,-75,-80,5
31,RL,0,350,6,-79.3333333333333,-75,-83,8
31,RL,0,350,6,-79.6666666666667,-75,-83,8
31,RL,0,350,4,-80,-75,-83,8
31,RL,0,350,4,-79.5,-75,-83,8
31,RL,1,350,10,-80.9,-78,-87,9
31,RL,0,350,5,-81.8,-78,-87,9
31,RL,1,350,9,-80.6666666666667,-78,-87,9
31,RL,0,350,3,-81.3333333333333,-79,-83,4
31,RL,1,350,10,-79.5,-77,-83,6
31,RL,0,350,3,-78.3333333333333,-78,-79,1
31,RL,0,350,2,-78,-78,-78,0
31,RL,0,350,2,-78,-78,-78,0
31,RL,0,350,1,-77,-77,-77,0
31,RL,1,350,9,-81,-77,-85,8
31,RL,0,350,2,-79.5,-78,-81,3
31,RL,0,350,1,-85,-85,-85,0
31,RL,1,350,10,-81.7,-79,-85,6
31,RL,0,350,6,-81,-79,-83,4
31,RL,0,350,3,-81.6666666666667,-81,-83,2
31,RL,0,350,5,-82.6,-79,-87,8
31,RL,0,350,2,-80,-79,-81,2
31,RL,0,350,3,-84,-82,-87,5
31,RL,0,350,7,-82,-81,-83,2
31,RL,0,350,6,-81.8333333333333,-81,-82,1
31,RL,1,350,9,-82.1111111111111,-81,-84,3
31,RL,0,350,4,-81.75,-81,-82,1
31,RL,0,350,1,-82,-82,-82,0
31,RL,0,350,8,-82.5,-81,-84,3
31,RL,0,350,1,-82,-82,-82,0
31,RL,0,350,4,-82.5,-81,-84,3
31,RL,0,350,5,-82.8,-81,-84,3
31,RL,0,350,2,-82.5,-81,-84,3
31,RL,0,350,5,-83.2,-82,-84,2
31,RL,0,350,8,-82.875,-81,-85,4
31,RL,0,350,1,-84,-84,-84,0
31,RL,0,350,5,-82.6,-81,-85,4
31,RL,0,350,6,-82.1666666666667,-80,-85,5
31,RL,1,350,10,-84.2,-78,-91,13
31,RL,0,350,1,-81,-81,-81,0
31,RL,0,350,8,-85,-78,-91,13
31,RL,0,350,7,-85,-78,-91,13
31,RL,0,350,8,-84.75,-78,-91,13
31,RL,0,350,8,-85.625,-78,-91,13
31,RL,0,350,7,-85.4285714285714,-78,-91,13
31,RL,0,350,8,-85.375,-79,-92,13
31,RL,0,350,8,-84.25,-78,-92,14
31,RL,0,350,3,-84.6666666666667,-80,-87,7
31,RL,0,350,7,-83.2857142857143,-78,-92,14
31,RL,0,350,8,-83.125,-78,-92,14
31,RL,0,350,5,-83.2,-78,-92,14
31,RL,1,350,10,-82.8,-78,-92,14
31,RL,0,350,6,-83.3333333333333,-78,-92,14
31,RL,0,350,8,-82.625,-80,-87,7
31,RL,0,350,7,-82,-80,-85,5
31,RL,1,350,10,-82.2,-79,-85,6
31,RL,0,350,1,-85,-85,-85,0
31,RL,0,350,1,-80,-80,-80,0
31,RL,0,350,5,-81.8,-79,-84,5
31,RL,0,350,7,-82,-79,-84,5
31,RL,0,350,1,-79,-79,-79,0
31,RL,0,350,2,-82,-80,-84,4
31,RL,1,350,9,-82.1111111111111,-80,-85,5
31,RL,0,350,3,-83,-82,-84,2
31,RL,0,350,5,-83,-81,-85,4
31,RL,0,350,8,-82.375,-80,-85,5
31,RL,0,350,4,-82.5,-80,-85,5
31,RL,0,350,6,-82.1666666666667,-80,-85,5
31,RL,0,350,2,-82.5,-80,-85,5
31,RL,1,350,10,-82.3,-79,-85,6
31,RL,0,350,8,-82.25,-79,-85,6
31,RL,0,350,1,-83,-83,-83,0
31,RL,1,350,10,-83.8,-79,-88,9
31,RL,0,350,5,-82.2,-79,-85,6
31,RL,0,350,1,-81,-81,-81,0
31,RL,0,350,1,-83,-83,-83,0
31,RL,0,350,4,-84.5,-83,-85,2
31,RL,1,350,9,-85.1111111111111,-83,-88,5
31,RL,1,350,9,-84.6666666666667,-81,-88,7
31,RL,1,350,9,-84.3333333333333,-81,-88,7
31,RL,0,350,7,-84.5714285714286,-81,-88,7
31,RL,0,350,5,-84.6,-83,-86,3
31,RL,0,350,1,-84,-84,-84,0
31,RL,0,350,2,-84.5,-83,-86,3
31,RL,1,350,9,-85.7777777777778,-81,-91,10
31,RL,0,350,1,-86,-86,-86,0
31,RL,0,350,3,-84.3333333333333,-81,-90,9
31,RL,0,350,7,-85.8571428571429,-82,-91,9
31,RL,0,350,2,-86.5,-83,-90,7
31,RL,1,350,9,-83.7777777777778,-78,-91,13
31,RL,0,350,8,-83.875,-78,-91,13
31,RL,0,350,1,-82,-82,-82,0
31,RL,0,350,8,-81.125,-78,-86,8
31,RL,1,350,10,-80.2,-77,-86,9
31,RL,0,350,7,-79.2857142857143,-77,-84,7
31,RL,0,350,2,-82,-80,-84,4
31,RL,0,350,7,-78.4285714285714,-77,-80,3
31,RL,0,350,1,-78,-78,-78,0
31,RL,0,350,1,-78,-78,-78,0
31,RL,0,350,7,-78.7142857142857,-78,-81,3
31,RL,0,350,4,-78.75,-78,-81,3
31,RL,0,350,2,-78,-78,-78,0
31,RL,0,350,3,-78.3333333333333,-78,-79,1
31,RL,1,350,10,-79.8,-77,-83,6
31,RL,0,350,7,-80,-79,-81,2
31,RL,0,350,3,-81,-81,-81,0
31,RL,0,350,8,-79.875,-77,-83,6
31,RL,0,350,3,-80,-77,-83,6
31,RL,0,350,2,-79,-77,-81,4
31,RL,0,350,7,-80,-79,-81,2
31,RL,0,350,8,-80,-78,-83,5
31,RL,0,350,2,-80,-80,-80,0
31,RL,1,350,10,-80.2,-76,-85,9
31,RL,0,350,3,-80,-80,-80,0
31,RL,0,350,6,-79,-76,-83,7
31,RL,0,350,1,-80,-80,-80,0
31,RL,0,350,2,-80.5,-78,-83,5
31,RL,1,350,10,-80.1,-76,-85,9
31,RL,0,350,8,-81,-77,-85,8
31,RL,0,350,5,-81.8,-77,-85,8
31,RL,0,350,4,-79.25,-77,-85,8
31,RL,0,350,3,-80.3333333333333,-78,-85,7
31,RL,0,350,5,-79.2,-78,-84,6
31,RL,0,350,6,-79.1666666666667,-78,-81,3
31,RL,1,350,10,-79.2,-78,-81,3
31,RL,0,350,6,-79.6666666666667,-78,-81,3
31,RL,0,350,4,-79.75,-78,-81,3
31,RL,0,350,7,-79.5714285714286,-78,-81,3
31,RL,1,350,10,-79.3,-78,-81,3
31,RL,0,350,2,-79.5,-78,-81,3
31,RL,0,350,6,-79.1666666666667,-78,-81,3
31,RL,0,350,3,-79.3333333333333,-78,-81,3
31,RL,0,350,5,-79.2,-78,-81,3
31,RL,0,350,1,-81,-81,-81,0
31,RL,0,350,1,-78,-78,-78,0
31,RL,0,350,8,-78.5,-77,-80,3
31,RL,0,350,7,-78.2857142857143,-77,-79,2
31,RL,0,350,7,-78.2857142857143,-77,-79,2
31,RL,0,350,7,-78.2857142857143,-77,-79,2
31,RL,0,350,5,-78,-77,-79,2
31,RL,1,350,9,-79.2222222222222,-78,-82,4
31,RL,1,350,9,-79.3333333333333,-78,-82,4
31,RL,0,350,8,-79.5,-78,-82,4
31,RL,1,350,9,-79.5555555555556,-78,-82,4
31,RL,0,350,5,-79.8,-78,-82,4
31,RL,0,350,4,-80.25,-78,-82,4
31,RL,0,350,2,-82,-82,-82,0
31,RL,0,350,1,-79,-79,-79,0
31,RL,0,350,8,-78.625,-77,-80,3
31,RL,0,350,3,-78.3333333333333,-77,-79,2
31,RL,0,350,7,-78.5714285714286,-77,-80,3
31,RL,0,350,5,-78.4,-77,-80,3
31,RL,0,350,6,-79.8333333333333,-78,-84,6
31,RL,0,350,8,-79.5,-76,-84,8
31,RL,0,350,5,-79.4,-76,-84,8
31,RL,0,350,7,-80.2857142857143,-76,-84,8
31,RL,0,350,5,-79.8,-76,-84,8
31,RL,0,350,6,-80.1666666666667,-76,-84,8
31,RL,0,350,3,-78.6666666666667,-76,-83,7
31,RL,1,350,9,-79,-76,-84,8
31,RL,1,350,9,-79.3333333333333,-76,-84,8
31,RL,0,350,7,-80.2857142857143,-76,-84,8
31,RL,0,350,4,-82,-76,-92,16
31,RL,0,350,2,-77,-76,-78,2
31,RL,0,350,3,-89.3333333333333,-86,-92,6
31,LR,0,350,5,-85.8,-78,-92,14
31,LR,0,350,8,-81.375,-77,-90,13
31,LR,0,350,5,-78.8,-77,-82,5
31,LR,1,350,9,-80.3333333333333,-78,-90,12
31,LR,0,350,4,-82,-78,-90,12
31,LR,0,350,6,-79.3333333333333,-78,-82,4
31,LR,0,350,4,-78.5,-78,-79,1
31,LR,1,350,10,-80,-78,-85,7
31,LR,1,350,9,-80.1111111111111,-78,-85,7
31,LR,0,350,2,-80,-80,-80,0
31,LR,0,350,8,-80.625,-78,-85,7
31,LR,1,350,9,-80.5555555555556,-76,-85,9
31,LR,0,350,8,-80,-76,-84,8
31,LR,0,350,7,-79,-76,-84,8
31,LR,0,350,2,-80.5,-78,-83,5
31,LR,0,350,7,-78.8571428571429,-75,-87,12
31,LR,0,350,5,-77.8,-75,-84,9
31,LR,0,350,6,-79.5,-75,-87,12
31,LR,0,350,4,-80.75,-75,-87,12
31,LR,0,350,8,-80.875,-75,-87,12
31,LR,0,350,5,-80.6,-77,-86,9
31,LR,0,350,4,-79.5,-77,-86,9
31,LR,1,350,10,-78.2,-74,-86,12
31,LR,1,350,9,-77,-74,-82,8
31,LR,0,350,8,-77,-74,-82,8
31,LR,0,350,7,-77.2857142857143,-74,-82,8
31,LR,0,350,1,-77,-77,-77,0
31,LR,1,350,10,-76.5,-74,-81,7
31,LR,0,350,1,-77,-77,-77,0
31,LR,0,350,8,-76.625,-74,-81,7
31,LR,0,350,1,-75,-75,-75,0
31,LR,0,350,3,-76.6666666666667,-74,-80,6
31,LR,0,350,6,-77.6666666666667,-76,-81,5
31,LR,0,350,2,-76.5,-76,-77,1
31,LR,0,350,8,-79.375,-75,-87,12
31,LR,1,350,9,-80,-75,-87,12
31,LR,0,350,6,-79.5,-75,-87,12
31,LR,0,350,1,-77,-77,-77,0
31,LR,0,350,1,-87,-87,-87,0
31,LR,0,350,8,-81.75,-76,-87,11
31,LR,1,350,9,-81.7777777777778,-77,-87,10
31,LR,1,350,9,-81,-77,-87,10
31,LR,0,350,6,-80.5,-77,-86,9
31,LR,0,350,3,-80.6666666666667,-78,-84,6
31,LR,0,350,8,-79.375,-76,-84,8
31,LR,0,350,3,-79.6666666666667,-79,-80,1
31,LR,1,350,10,-79,-76,-85,9
31,LR,1,350,10,-79.2,-76,-85,9
31,LR,0,350,8,-78.875,-76,-85,9
31,LR,0,350,3,-76.6666666666667,-76,-77,1
31,LR,0,350,6,-79,-77,-85,8
31,LR,0,350,7,-79.4285714285714,-77,-85,8
31,LR,0,350,4,-80,-77,-85,8
31,LR,1,350,10,-79.4,-77,-82,5
31,LR,0,350,4,-79.25,-77,-81,4
31,LR,1,350,10,-79.8,-77,-82,5
31,LR,0,350,3,-79.6666666666667,-78,-81,3
31,LR,0,350,3,-80.3333333333333,-80,-81,1
31,LR,0,350,3,-79.3333333333333,-78,-80,2
31,LR,0,350,2,-79,-78,-80,2
31,LR,0,350,1,-78,-78,-78,0
31,LR,1,350,9,-80.3333333333333,-77,-83,6
31,LR,0,350,4,-79.5,-77,-81,4
31,LR,0,350,2,-80.5,-80,-81,1
31,LR,0,350,1,-81,-81,-81,0
31,LR,1,350,10,-82.7,-78,-96,18
31,LR,0,350,1,-81,-81,-81,0
31,LR,1,350,10,-82.5,-78,-96,18
31,LR,0,350,2,-81,-79,-83,4
31,LR,0,350,3,-82.3333333333333,-78,-90,12
31,LR,0,350,7,-83.2857142857143,-78,-96,18
31,LR,0,350,3,-89.3333333333333,-82,-96,14
31,LR,0,350,3,-85.3333333333333,-78,-96,18
31,LR,1,350,9,-79.8888888888889,-78,-83,5
31,LR,0,350,7,-79.7142857142857,-78,-83,5
31,LR,0,350,8,-79.5,-78,-83,5
31,LR,0,350,7,-79.4285714285714,-78,-83,5
31,LR,0,350,5,-78.6,-78,-80,2
31,LR,0,350,5,-78.8,-78,-80,2
31,LR,0,350,6,-81.3333333333333,-78,-86,8
31,LR,0,350,2,-82.5,-80,-85,5
31,LR,0,350,1,-85,-85,-85,0
31,LR,0,350,5,-81.6,-79,-86,7
31,LR,1,350,9,-80.6666666666667,-79,-87,8
31,LR,1,350,9,-80.5555555555556,-78,-87,9
31,LR,0,350,1,-82,-82,-82,0
31,LR,0,350,8,-80.25,-78,-87,9
31,LR,0,350,8,-80.25,-78,-87,9
31,LR,0,350,5,-80.4,-78,-87,9
31,LR,0,350,4,-79.25,-78,-81,3
31,LR,0,350,4,-79.5,-78,-81,3
31,LR,1,350,9,-80.2222222222222,-78,-88,10
31,LR,0,350,5,-81.4,-79,-88,9
31,LR,0,350,2,-80.5,-80,-81,1
31,LR,0,350,8,-80.125,-78,-88,10
31,LR,1,350,10,-82.4,-78,-92,14
31,LR,0,350,1,-78,-78,-78,0
31,LR,0,350,8,-82.625,-78,-92,14
31,LR,0,350,2,-79,-78,-80,2
31,LR,0,350,4,-85.75,-79,-92,13
31,LR,0,350,6,-84.1666666666667,-79,-92,13
31,LR,0,350,3,-83.6666666666667,-79,-92,13
31,LR,0,350,5,-83.4,-80,-92,12
31,LR,0,350,3,-80.6666666666667,-80,-81,1
31,LR,0,350,8,-81,-77,-83,6
31,LR,0,350,3,-81.3333333333333,-80,-83,3
31,LR,0,350,5,-80,-77,-83,6
31,LR,0,350,1,-83,-83,-83,0
31,LR,1,350,9,-80.3333333333333,-77,-86,9
31,LR,0,350,4,-77.5,-77,-78,1
31,LR,0,350,6,-81.1666666666667,-78,-86,8
31,LR,0,350,8,-82.25,-78,-90,12
31,LR,0,350,8,-82.875,-78,-91,13
31,LR,0,350,6,-82.8333333333333,-78,-91,13
31,LR,1,350,10,-82.8,-78,-91,13
31,LR,1,350,9,-82.1111111111111,-78,-91,13
31,LR,0,350,4,-81.5,-78,-90,12
31,LR,0,350,3,-82.6666666666667,-79,-90,11
31,LR,1,350,10,-81.8,-77,-90,13
31,LR,1,350,9,-82.1111111111111,-77,-90,13
31,LR,0,350,5,-81.4,-77,-87,10
31,LR,0,350,2,-81.5,-81,-82,1
31,LR,0,350,6,-81.1666666666667,-77,-87,10
31,LR,0,350,4,-82.25,-77,-87,10
31,LR,0,350,6,-80.6666666666667,-77,-84,7
31,LR,0,350,7,-81.1428571428571,-77,-87,10
31,LR,0,350,7,-80.4285714285714,-77,-87,10
31,LR,0,350,5,-81.2,-78,-87,9
31,LR,1,350,10,-80.7,-78,-87,9
31,LR,0,350,2,-82.5,-78,-87,9
31,LR,0,350,8,-81.25,-78,-87,9
31,LR,0,350,6,-80.1666666666667,-78,-85,7
31,LR,0,350,4,-80.5,-78,-85,7
31,LR,0,350,5,-81.2,-79,-85,6
31,LR,0,350,7,-81.7142857142857,-79,-85,6
31,LR,0,350,5,-81.4,-79,-84,5
31,LR,0,350,1,-80,-80,-80,0
31,LR,0,350,6,-82.3333333333333,-80,-86,6
31,LR,1,350,9,-82.8888888888889,-79,-86,7
31,LR,0,350,6,-81.8333333333333,-79,-86,7
31,LR,0,350,8,-84,-79,-93,14
31,LR,0,350,7,-84.5714285714286,-79,-93,14
31,LR,0,350,1,-79,-79,-79,0
31,LR,0,350,2,-85.5,-85,-86,1
31,LR,0,350,6,-84.8333333333333,-78,-93,15
31,LR,1,350,9,-81.8888888888889,-76,-93,17
31,LR,0,350,1,-93,-93,-93,0
31,LR,0,350,4,-82.5,-78,-92,14
31,LR,0,350,8,-80.625,-76,-92,16
31,LR,0,350,3,-79,-78,-80,2
31,LR,0,350,6,-78.5,-76,-82,6
31,LR,1,350,9,-77.7777777777778,-75,-83,8
31,LR,0,350,2,-79,-76,-82,6
31,LR,1,350,9,-77.2222222222222,-75,-83,8
31,LR,1,350,9,-76.2222222222222,-73,-83,10
31,LR,0,350,8,-76,-73,-83,10
31,LR,0,350,8,-77.25,-73,-85,12
31,LR,0,350,7,-76.4285714285714,-73,-85,12
31,LR,0,350,2,-75,-75,-75,0
31,LR,0,350,7,-80.8571428571429,-76,-86,10
31,LR,1,350,9,-82.8888888888889,-76,-88,12
31,LR,0,350,3,-78.6666666666667,-76,-84,8
31,LR,1,350,9,-82.4444444444444,-76,-88,12
31,LR,0,350,3,-83.3333333333333,-81,-86,5
31,LR,0,350,4,-85,-81,-88,7
31,LR,1,350,9,-81.8888888888889,-78,-88,10
31,LR,0,350,8,-81.125,-78,-86,8
31,LR,0,350,2,-80.5,-79,-82,3
31,LR,0,350,8,-80.375,-77,-86,9
31,LR,0,350,7,-80.1428571428571,-77,-86,9
31,LR,0,350,8,-79.875,-77,-86,9
31,LR,0,350,7,-79,-77,-83,6
31,LR,1,350,9,-78.8888888888889,-77,-82,5
31,LR,0,350,1,-80,-80,-80,0
31,LR,1,350,9,-79.1111111111111,-77,-82,5
31,LR,0,350,4,-79,-77,-82,5
31,LR,0,350,4,-79.5,-77,-82,5
31,LR,1,350,10,-79.7,-77,-93,16
31,LR,1,350,9,-80,-77,-93,16
31,LR,0,350,2,-78,-78,-78,0
31,LR,0,350,8,-82.125,-77,-93,16
31,LR,0,350,1,-77,-77,-77,0
31,LR,1,350,9,-83.1111111111111,-77,-93,16
31,LR,1,350,9,-82.6666666666667,-77,-89,12
31,LR,0,350,1,-77,-77,-77,0
31,LR,0,350,5,-83.6,-77,-88,11
31,LR,0,350,3,-82,-77,-87,10
31,LR,0,350,5,-82.6,-78,-87,9
31,LR,0,350,5,-82.6,-78,-87,9
31,LR,0,350,5,-82,-78,-84,6
31,LR,0,350,6,-84.6666666666667,-78,-99,21
31,LR,0,350,6,-84.1666666666667,-78,-99,21
31,LR,0,350,4,-87,-82,-99,17
31,LR,0,350,5,-84.6,-78,-99,21
31,LR,1,350,10,-85.1,-78,-99,21
31,LR,0,350,8,-86,-78,-99,21
31,LR,1,350,10,-82.7,-78,-98,20
31,LR,0,350,1,-78,-78,-78,0
31,LR,0,350,1,-78,-78,-78,0
31,LR,0,350,5,-86.8,-80,-98,18
31,LR,0,350,8,-84.375,-78,-98,20
31,LR,0,350,3,-87.3333333333333,-80,-98,18
31,LR,0,350,3,-81.3333333333333,-80,-84,4
31,LR,1,350,10,-80.2,-76,-87,11
31,LR,0,350,3,-81.3333333333333,-78,-86,8
31,LR,0,350,1,-78,-78,-78,0
31,LR,0,350,4,-80.5,-76,-86,10
31,LR,0,350,4,-80.75,-76,-87,11
31,LR,0,350,6,-80.8333333333333,-76,-87,11
31,LR,0,350,2,-77.5,-76,-79,3
31,LR,0,350,7,-82.5714285714286,-76,-88,12
31,LR,0,350,5,-82.2,-76,-87,11
31,LR,0,350,7,-82.7142857142857,-76,-88,12
31,LR,0,350,7,-84,-77,-88,11
31,LR,0,350,4,-85.25,-79,-88,9
31,LR,0,350,1,-87,-87,-87,0
31,LR,0,350,3,-80,-76,-85,9
31,LR,0,350,6,-79.8333333333333,-75,-87,12
31,LR,0,350,7,-80.7142857142857,-75,-87,12
31,LR,0,350,4,-81.5,-75,-87,12
31,LR,0,350,2,-82,-78,-86,8
31,LR,0,350,7,-85.4285714285714,-79,-99,20
31,LR,0,350,5,-82.6,-79,-87,8
31,LR,0,350,8,-84.625,-78,-99,21
31,LR,0,350,1,-83,-83,-83,0
31,LR,1,350,10,-84.3,-77,-99,22
31,LR,0,350,3,-87.3333333333333,-80,-99,19
31,LR,0,350,2,-91,-83,-99,16
31,LR,1,350,10,-83.3,-77,-91,14
31,LR,0,350,6,-82.8333333333333,-77,-91,14
31,LR,1,350,10,-82.6,-75,-91,16
31,LR,1,350,9,-81.6666666666667,-75,-90,15
31,LR,0,350,5,-84.4,-79,-90,11
31,LR,0,350,3,-84.3333333333333,-79,-90,11
31,LR,0,350,3,-82.6666666666667,-79,-90,11
31,LR,1,350,10,-81.1,-75,-90,15
31,LR,0,350,6,-80,-75,-88,13
31,LR,0,350,7,-79.4285714285714,-74,-88,14
31,LR,0,350,3,-80,-75,-87,12
31,LR,0,350,1,-75,-75,-75,0
31,LR,0,350,7,-79.1428571428571,-74,-87,13
31,LR,0,350,2,-78,-75,-81,6
31,LR,1,350,10,-77.9,-74,-83,9
31,LR,0,350,1,-78,-78,-78,0
31,LR,0,350,5,-77,-74,-80,6
31,LR,0,350,4,-78.25,-74,-83,9
31,LR,1,350,9,-78.8888888888889,-74,-87,13
31,LR,0,350,3,-78.3333333333333,-74,-83,9
31,LR,0,350,5,-79.8,-74,-87,13
31,LR,1,350,9,-79.4444444444444,-75,-87,12
31,LR,0,350,8,-80.75,-77,-87,10
31,LR,1,350,10,-81.3,-77,-93,16
31,LR,0,350,1,-77,-77,-77,0
31,LR,0,350,5,-80.4,-77,-86,9
31,LR,0,350,3,-79.6666666666667,-77,-83,6
31,LR,0,350,3,-82,-77,-86,9
31,LR,1,350,9,-83.3333333333333,-78,-93,15
31,LR,0,350,1,-86,-86,-86,0
31,LR,0,350,1,-82,-82,-82,0
31,LR,0,350,2,-86,-79,-93,14
31,LR,0,350,7,-79.8571428571429,-75,-88,13
31,LR,0,350,6,-77.8333333333333,-75,-82,7
31,LR,0,350,8,-78,-74,-82,8
31,LR,0,350,7,-77.8571428571429,-74,-82,8
31,LR,0,350,8,-78.625,-74,-83,9
31,LR,0,350,8,-79,-74,-83,9
31,LR,0,350,1,-75,-75,-75,0
31,LR,1,350,10,-79.6,-74,-83,9
31,LR,0,350,3,-78.6666666666667,-74,-83,9
31,LR,0,350,8,-79.375,-74,-83,9
31,LR,0,350,3,-78.3333333333333,-74,-83,9
31,LR,0,350,4,-79.5,-74,-83,9
31,LR,0,350,3,-80,-74,-83,9
31,LR,0,350,1,-83,-83,-83,0
31,LR,1,350,9,-79.8888888888889,-74,-86,12
31,LR,0,350,1,-77,-77,-77,0
31,LR,0,350,3,-77.3333333333333,-74,-81,7
31,LR,0,350,1,-81,-81,-81,0
31,LR,0,350,2,-86,-86,-86,0
31,LR,1,350,10,-78.3,-74,-86,12
31,LR,1,350,10,-77.6,-74,-83,9
31,LR,0,350,8,-76.75,-74,-79,5
31,LR,0,350,5,-76.6,-74,-79,5
31,LR,0,350,1,-76,-76,-76,0
31,LR,0,350,6,-76.8333333333333,-74,-79,5
31,LR,1,350,9,-77.1111111111111,-74,-81,7
31,LR,0,350,1,-76,-76,-76,0
31,LR,0,350,1,-79,-79,-79,0
31,LR,0,350,7,-77.5714285714286,-74,-81,7
31,LR,0,350,1,-81,-81,-81,0
31,LR,0,350,1,-77,-77,-77,0
31,LR,0,350,2,-75,-74,-76,2
31,LR,0,350,1,-76,-76,-76,0
31,LR,1,350,9,-77.4444444444444,-76,-80,4
31,LR,1,350,10,-77.3,-74,-80,6
31,LR,0,350,4,-78.25,-77,-80,3
31,LR,0,350,8,-77,-74,-80,6
31,LR,1,350,10,-77.2,-74,-80,6
31,LR,0,350,4,-77.5,-76,-80,4
31,LR,0,350,4,-77,-74,-80,6
31,LR,1,350,9,-79.7777777777778,-76,-90,14
31,LR,0,350,4,-80.5,-76,-90,14
31,LR,1,350,10,-79.5,-74,-90,16
31,LR,0,350,4,-80.25,-76,-90,14
31,LR,0,350,1,-90,-90,-90,0
31,LR,0,350,6,-78.3333333333333,-74,-87,13
31,LR,1,350,9,-78.6666666666667,-76,-90,14
31,LR,0,350,8,-78.875,-76,-90,14
31,LR,0,350,3,-80,-74,-87,13
31,LR,1,350,10,-79.7,-76,-90,14
31,LR,0,350,3,-80,-76,-83,7
31,LR,0,350,6,-79,-74,-87,13
31,LR,0,350,3,-81.3333333333333,-76,-85,9
31,LR,0,350,7,-82,-74,-96,22
26,RL,0,350,8,-81,-71,-87,16
26,RL,1,350,9,-81.6666666666667,-77,-87,10
26,RL,0,350,1,-81,-81,-81,0
26,RL,0,350,6,-83,-79,-87,8
26,RL,0,350,1,-83,-83,-83,0
26,RL,0,350,2,-83,-79,-87,8
26,RL,0,350,1,-79,-79,-79,0
26,RL,0,350,8,-82.5,-79,-92,13
26,RL,0,350,4,-80.5,-80,-81,1
26,RL,0,350,8,-83.25,-80,-92,12
26,RL,0,350,2,-80.5,-80,-81,1
26,RL,1,350,10,-84.4,-79,-92,13
26,RL,0,350,4,-84.25,-82,-86,4
26,RL,0,350,8,-82.75,-79,-92,13
26,RL,0,350,3,-86,-81,-92,11
26,RL,0,350,8,-80.875,-76,-92,16
26,RL,0,350,2,-85.5,-79,-92,13
26,RL,1,350,10,-78.6,-76,-82,6
26,RL,0,350,5,-79,-76,-82,6
26,RL,0,350,1,-77,-77,-77,0
26,RL,0,350,1,-82,-82,-82,0
26,RL,0,350,6,-77.5,-76,-79,3
26,RL,0,350,5,-77.8,-77,-79,2
26,RL,1,350,10,-77,-75,-79,4
26,RL,0,350,1,-79,-79,-79,0
26,RL,0,350,1,-77,-77,-77,0
26,RL,0,350,3,-77,-75,-79,4
26,RL,0,350,6,-76.6666666666667,-75,-79,4
26,RL,0,350,2,-75.5,-75,-76,1
26,RL,0,350,2,-76,-76,-76,0
26,RL,0,350,1,-76,-76,-76,0
26,RL,0,350,4,-80.25,-79,-81,2
26,RL,0,350,7,-78.5714285714286,-76,-81,5
26,RL,1,350,10,-78.2,-76,-81,5
26,RL,0,350,4,-77.75,-76,-79,3
26,RL,1,350,10,-78,-76,-80,4
26,RL,1,350,10,-78.4,-77,-80,3
26,RL,0,350,6,-78.3333333333333,-77,-80,3
26,RL,1,350,9,-79.2222222222222,-77,-82,5
26,RL,0,350,5,-79,-78,-80,2
26,RL,1,350,10,-79.1,-76,-82,6
26,RL,0,350,3,-79.3333333333333,-78,-80,2
26,RL,0,350,5,-80.2,-79,-82,3
26,RL,0,350,8,-78.75,-76,-82,6
26,RL,0,350,8,-78,-76,-80,4
26,RL,0,350,4,-77.5,-76,-79,3
26,RL,0,350,4,-78,-76,-80,4
26,RL,1,350,9,-78.2222222222222,-77,-80,3
26,RL,0,350,2,-78.5,-77,-80,3
26,RL,1,350,10,-78.5,-77,-80,3
26,RL,1,350,10,-78.7,-77,-82,5
26,RL,0,350,2,-77.5,-77,-78,1
26,RL,0,350,3,-78.3333333333333,-78,-79,1
26,RL,1,350,10,-79.4,-78,-82,4
26,RL,0,350,2,-78,-78,-78,0
26,RL,0,350,4,-79.75,-78,-82,4
26,RL,1,350,9,-79.5555555555556,-77,-82,5
26,RL,0,350,4,-80.5,-79,-82,3
26,RL,0,350,4,-80.5,-79,-82,3
26,RL,0,350,5,-79.6,-79,-81,2
26,RL,0,350,7,-77.8571428571429,-77,-79,2
26,RL,0,350,5,-77.4,-77,-79,2
26,RL,0,350,5,-77,-77,-77,0
26,RL,0,350,2,-77,-77,-77,0
26,RL,0,350,7,-77.8571428571429,-76,-80,4
26,RL,1,350,10,-78.5,-76,-81,5
26,RL,1,350,10,-79.5,-76,-82,6
26,RL,0,350,6,-79,-77,-80,3
26,RL,0,350,3,-80,-80,-80,0
26,RL,0,350,8,-80.5,-77,-83,6
26,RL,1,350,10,-82.1,-77,-88,11
26,RL,0,350,6,-80.6666666666667,-77,-83,6
26,RL,0,350,7,-82.2857142857143,-79,-87,8
26,RL,0,350,6,-82.8333333333333,-81,-87,6
26,RL,0,350,8,-83.75,-80,-88,8
26,RL,0,350,2,-85,-83,-87,4
26,RL,0,350,7,-84.1428571428571,-80,-88,8
26,RL,0,350,7,-85,-80,-88,8
26,RL,0,350,6,-84.5,-80,-88,8
26,RL,0,350,1,-86,-86,-86,0
26,RL,1,350,9,-83.1111111111111,-80,-88,8
26,RL,0,350,3,-85.6666666666667,-84,-88,4
26,RL,0,350,1,-88,-88,-88,0
26,RL,0,350,2,-82,-80,-84,4
26,RL,0,350,1,-80,-80,-80,0
26,RL,0,350,7,-81.7142857142857,-80,-86,6
26,RL,0,350,6,-82,-80,-86,6
26,RL,0,350,6,-82.1666666666667,-80,-86,6
26,RL,0,350,3,-82,-80,-86,6
26,RL,0,350,6,-83.8333333333333,-80,-94,14
26,RL,1,350,10,-82.8,-78,-94,16
26,RL,0,350,3,-87,-83,-94,11
26,RL,1,350,9,-84,-78,-94,16
26,RL,0,350,7,-83.2857142857143,-78,-91,13
26,RL,0,350,1,-80,-80,-80,0
26,RL,1,350,9,-82.4444444444444,-75,-91,16
26,RL,1,350,9,-81,-75,-91,16
26,RL,1,350,9,-80.6666666666667,-75,-91,16
26,RL,1,350,9,-78.8888888888889,-75,-87,12
26,RL,0,350,7,-78.2857142857143,-75,-85,10
26,RL,0,350,5,-76.6,-75,-80,5
26,RL,0,350,6,-76.3333333333333,-75,-80,5
26,RL,0,350,4,-76.5,-75,-80,5
26,RL,1,350,9,-78.8888888888889,-75,-86,11
26,RL,0,350,1,-80,-80,-80,0
26,RL,0,350,3,-77.3333333333333,-75,-82,7
26,RL,0,350,7,-81.2857142857143,-75,-90,15
26,RL,0,350,4,-80,-75,-86,11
26,RL,0,350,8,-81.375,-75,-90,15
26,RL,1,350,9,-81.3333333333333,-76,-90,14
26,RL,0,350,4,-84.25,-77,-90,13
26,RL,1,350,10,-80.9,-75,-90,15
26,RL,0,350,6,-80.1666666666667,-76,-90,14
26,RL,0,350,6,-79.3333333333333,-75,-90,15
26,RL,0,350,3,-77,-76,-79,3
26,RL,0,350,6,-80.3333333333333,-75,-88,13
26,RL,0,350,5,-81.2,-75,-88,13
26,RL,0,350,1,-75,-75,-75,0
26,RL,0,350,7,-80.7142857142857,-76,-90,14
26,RL,0,350,3,-85.3333333333333,-78,-90,12
26,RL,0,350,3,-82,-78,-90,12
26,RL,1,350,9,-78,-75,-86,11
26,RL,0,350,2,-77.5,-77,-78,1
26,RL,0,350,1,-77,-77,-77,0
26,RL,0,350,3,-76,-75,-77,2
26,RL,0,350,4,-78.75,-75,-86,11
26,RL,1,350,10,-78.8,-75,-86,11
26,RL,0,350,1,-86,-86,-86,0
26,RL,1,350,10,-78.1,-75,-82,7
26,RL,0,350,8,-78.25,-75,-82,7
26,RL,0,350,5,-78.2,-75,-82,7
26,RL,1,350,9,-78,-75,-82,7
26,RL,0,350,8,-77.5,-75,-82,7
26,RL,0,350,3,-77.3333333333333,-75,-82,7
26,RL,1,350,10,-76.7,-75,-80,5
26,RL,0,350,8,-76.75,-75,-80,5
26,RL,1,350,9,-78.3333333333333,-76,-88,12
26,RL,0,350,4,-77,-76,-80,4
26,RL,0,350,1,-80,-80,-80,0
26,RL,0,350,4,-76,-76,-76,0
26,RL,0,350,1,-76,-76,-76,0
26,RL,1,350,9,-81,-76,-88,12
26,RL,0,350,4,-82.5,-76,-88,12
26,RL,0,350,2,-83,-78,-88,10
26,RL,0,350,4,-84.5,-79,-88,9
26,RL,0,350,1,-79,-79,-79,0
26,RL,0,350,1,-83,-83,-83,0
26,RL,0,350,6,-79,-77,-81,4
26,RL,0,350,2,-79.5,-78,-81,3
26,RL,0,350,1,-78,-78,-78,0
26,RL,0,350,6,-79.1666666666667,-77,-81,4
26,RL,0,350,5,-79.4,-77,-81,4
26,RL,1,350,10,-81.2,-77,-86,9
26,RL,0,350,1,-81,-81,-81,0
26,RL,0,350,4,-82.25,-80,-84,4
26,RL,0,350,8,-82.375,-76,-88,12
26,RL,0,350,2,-82.5,-81,-84,3
26,RL,0,350,2,-83,-80,-86,6
26,RL,1,350,9,-80.1111111111111,-76,-88,12
26,RL,1,350,9,-80.1111111111111,-76,-88,12
26,RL,1,350,10,-79.3,-76,-84,8
26,RL,0,350,8,-78.5,-76,-81,5
26,RL,0,350,6,-78.8333333333333,-77,-81,4
26,RL,0,350,4,-79,-77,-81,4
26,RL,0,350,6,-79.8333333333333,-79,-81,2
26,RL,0,350,5,-80.4,-79,-83,4
26,RL,0,350,4,-80.75,-79,-83,4
26,RL,1,350,10,-80.9,-77,-86,9
26,RL,0,350,4,-81.25,-78,-83,5
26,RL,0,350,3,-80.6666666666667,-78,-82,4
26,RL,1,350,9,-80.8888888888889,-77,-86,9
26,RL,0,350,1,-84,-84,-84,0
26,RL,0,350,3,-81,-77,-86,9
26,RL,0,350,1,-86,-86,-86,0
26,RL,0,350,5,-80.8,-79,-84,5
26,RL,0,350,1,-84,-84,-84,0
26,RL,0,350,5,-82.4,-79,-88,9
26,RL,0,350,5,-83,-80,-88,8
26,RL,1,350,10,-83.2,-81,-88,7
26,RL,1,350,10,-84.1,-81,-90,9
26,RL,0,350,3,-84.6666666666667,-82,-88,6
26,RL,0,350,7,-82.7142857142857,-81,-84,3
26,RL,1,350,9,-83,-78,-90,12
26,RL,0,350,3,-82.6666666666667,-81,-84,3
26,RL,0,350,5,-84.4,-81,-90,9
26,RL,0,350,4,-84.75,-81,-90,9
26,RL,1,350,9,-81.8888888888889,-77,-90,13
26,RL,1,350,9,-81.5555555555556,-77,-90,13
26,RL,0,350,7,-81.7142857142857,-77,-90,13
26,RL,1,350,9,-80.5555555555556,-77,-90,13
26,RL,0,350,6,-81.1666666666667,-77,-90,13
26,RL,0,350,1,-90,-90,-90,0
26,RL,1,350,9,-79.3333333333333,-76,-87,11
26,RL,0,350,8,-79.625,-76,-87,11
26,RL,1,350,9,-80.8888888888889,-76,-87,11
26,RL,0,350,8,-79.875,-76,-87,11
26,RL,0,350,4,-79.25,-76,-87,11
26,RL,0,350,3,-80.3333333333333,-76,-87,11
26,RL,0,350,3,-80.3333333333333,-76,-87,11
26,RL,0,350,2,-81.5,-76,-87,11
26,RL,0,350,5,-79.8,-76,-87,11
26,RL,1,350,10,-79.4,-76,-89,13
26,RL,0,350,4,-77.5,-76,-79,3
26,RL,1,350,9,-79.4444444444444,-76,-89,13
26,RL,1,350,9,-79.4444444444444,-76,-89,13
26,RL,0,350,6,-80.3333333333333,-77,-89,12
26,RL,0,350,6,-80.1666666666667,-77,-89,12
26,RL,0,350,4,-81,-77,-89,12
26,RL,1,350,9,-83.5555555555556,-78,-96,18
26,RL,0,350,4,-81.25,-78,-89,11
26,RL,0,350,4,-81.5,-78,-89,11
26,RL,0,350,7,-83.4285714285714,-78,-96,18
26,RL,0,350,8,-84.5,-78,-96,18
26,RL,0,350,4,-87,-79,-96,17
26,RL,0,350,2,-87.5,-79,-96,17
26,RL,1,350,10,-81.9,-78,-93,15
26,RL,0,350,6,-81.3333333333333,-78,-92,14
26,RL,0,350,6,-79.3333333333333,-78,-80,2
26,RL,0,350,2,-79.5,-79,-80,1
26,RL,0,350,8,-81.5,-79,-90,11
26,RL,0,350,4,-82.25,-79,-90,11
26,RL,0,350,5,-82.8,-79,-90,11
26,RL,0,350,7,-82.2857142857143,-79,-90,11
26,RL,0,350,2,-82.5,-81,-84,3
26,RL,0,350,8,-80.75,-77,-85,8
26,RL,0,350,3,-80.6666666666667,-79,-82,3
26,RL,1,350,10,-81.9,-77,-88,11
26,RL,0,350,3,-82.3333333333333,-80,-85,5
26,RL,0,350,6,-80.6666666666667,-77,-88,11
26,RL,1,350,9,-80,-75,-88,13
26,RL,0,350,2,-84,-80,-88,8
26,RL,0,350,2,-82.5,-78,-87,9
26,RL,1,350,9,-77.6666666666667,-75,-87,12
26,RL,1,350,9,-76.8888888888889,-75,-80,5
26,RL,0,350,6,-77,-75,-79,4
26,RL,0,350,5,-76.6,-75,-79,4
26,RL,0,350,1,-79,-79,-79,0
26,RL,0,350,5,-76.4,-74,-80,6
26,RL,0,350,7,-76.2857142857143,-74,-80,6
26,RL,0,350,1,-80,-80,-80,0
26,RL,0,350,4,-75.25,-74,-76,2
26,RL,0,350,2,-75,-74,-76,2
26,RL,0,350,4,-76.25,-75,-78,3
26,RL,0,350,6,-77,-75,-78,3
26,RL,1,350,10,-77.9,-76,-80,4
26,RL,0,350,3,-77.3333333333333,-76,-78,2
26,RL,0,350,2,-78,-78,-78,0
26,RL,0,350,7,-78.1428571428571,-76,-80,4
26,RL,0,350,4,-78.25,-77,-80,3
26,RL,0,350,7,-78.4285714285714,-76,-81,5
26,RL,0,350,1,-80,-80,-80,0
26,RL,1,350,9,-78,-76,-81,5
26,RL,0,350,5,-79,-77,-81,4
26,RL,0,350,2,-79,-77,-81,4
26,RL,0,350,7,-78.1428571428571,-76,-81,5
26,RL,1,350,9,-77.5555555555556,-75,-80,5
26,RL,1,350,10,-76.9,-75,-79,4
26,RL,0,350,2,-77,-76,-78,2
26,RL,0,350,4,-77.5,-75,-79,4
26,RL,0,350,1,-78,-78,-78,0
26,RL,0,350,5,-77,-75,-79,4
26,RL,0,350,1,-79,-79,-79,0
26,RL,0,350,8,-76.25,-75,-78,3
26,RL,0,350,1,-77,-77,-77,0
26,RL,0,350,3,-75.3333333333333,-75,-76,1
26,RL,0,350,5,-75.8,-75,-77,2
26,RL,0,350,2,-76,-75,-77,2
26,RL,0,350,3,-76.3333333333333,-75,-77,2
26,RL,0,350,5,-78.6,-75,-82,7
26,RL,0,350,8,-79.5,-76,-82,6
26,RL,0,350,2,-81,-80,-82,2
26,RL,1,350,9,-80.6666666666667,-76,-87,11
26,RL,0,350,1,-76,-76,-76,0
26,RL,0,350,1,-79,-79,-79,0
26,RL,0,350,2,-79.5,-77,-82,5
26,RL,0,350,8,-81.625,-79,-87,8
26,RL,0,350,8,-81.625,-79,-87,8
26,RL,0,350,8,-81.125,-79,-87,8
26,RL,0,350,1,-79,-79,-79,0
26,RL,0,350,8,-80.875,-79,-84,5
26,RL,0,350,8,-81.625,-80,-84,4
26,RL,0,350,5,-81.6,-80,-84,4
26,RL,0,350,2,-81,-80,-82,2
26,RL,1,350,10,-83.7,-77,-92,15
26,RL,0,350,6,-81.8333333333333,-77,-85,8
26,RL,0,350,1,-84,-84,-84,0
26,RL,1,350,9,-84.1111111111111,-77,-92,15
26,RL,0,350,8,-84.5,-77,-92,15
26,RL,0,350,8,-83.625,-77,-92,15
26,RL,0,350,8,-84.375,-78,-92,14
26,RL,0,350,1,-85,-85,-85,0
26,RL,0,350,7,-82.8571428571429,-78,-86,8
26,RL,0,350,4,-83.5,-78,-86,8
26,RL,0,350,5,-81.8,-78,-86,8
26,RL,0,350,1,-84,-84,-84,0
26,RL,1,350,10,-81.9,-79,-87,8
26,RL,0,350,5,-81.4,-79,-84,5
26,RL,0,350,7,-82.2857142857143,-79,-87,8
26,RL,0,350,6,-82.1666666666667,-80,-87,7
26,RL,0,350,6,-82.3333333333333,-80,-87,7
26,RL,0,350,6,-82.5,-81,-87,6
26,RL,0,350,2,-84.5,-82,-87,5
26,RL,0,350,8,-81.25,-79,-83,4
26,RL,0,350,8,-81.875,-79,-86,7
26,RL,0,350,7,-81.7142857142857,-79,-86,7
26,RL,0,350,2,-83,-83,-83,0
26,RL,1,350,9,-79.7777777777778,-77,-86,9
26,RL,0,350,7,-79.5714285714286,-77,-86,9
26,RL,0,350,8,-79.5,-77,-86,9
26,RL,1,350,10,-77.9,-77,-81,4
26,RL,0,350,5,-78.2,-77,-81,4
26,RL,0,350,4,-78.5,-77,-81,4
26,RL,0,350,3,-79,-78,-81,3
26,RL,0,350,2,-79.5,-78,-81,3
26,RL,0,350,8,-77.875,-77,-79,2
26,RL,1,350,9,-78.3333333333333,-77,-80,3
26,RL,0,350,4,-78.25,-78,-79,1
26,RL,0,350,1,-79,-79,-79,0
26,RL,0,350,1,-78,-78,-78,0
26,RL,0,350,1,-78,-78,-78,0
26,RL,0,350,1,-80,-80,-80,0
26,RL,0,350,3,-78.3333333333333,-78,-79,1
26,RL,0,350,6,-78.5,-77,-82,5
26,RL,1,350,9,-78.3333333333333,-77,-82,5
26,RL,0,350,5,-78.4,-77,-82,5
26,RL,0,350,6,-77.8333333333333,-77,-79,2
26,RL,1,350,10,-78.3,-77,-80,3
26,RL,1,350,9,-78.8888888888889,-77,-81,4
26,RL,0,350,8,-78.75,-77,-81,4
26,RL,0,350,3,-77.6666666666667,-77,-78,1
26,RL,0,350,6,-78.6666666666667,-77,-81,4
26,RL,1,350,10,-78.7,-77,-81,4
26,RL,0,350,6,-80.3333333333333,-78,-83,5
26,RL,0,350,8,-78.75,-77,-81,4
26,RL,0,350,7,-79.1428571428571,-78,-81,3
26,RL,0,350,2,-83,-83,-83,0
26,RL,0,350,4,-80.75,-78,-83,5
26,RL,0,350,6,-82.5,-78,-92,14
26,RL,0,350,7,-82.2857142857143,-78,-92,14
26,LR,0,350,3,-87.6666666666667,-80,-94,14
26,LR,1,350,10,-87.5,-81,-95,14
26,LR,1,350,9,-85.6666666666667,-78,-95,17
26,LR,0,350,7,-85.4285714285714,-78,-95,17
26,LR,0,350,7,-84.7142857142857,-78,-95,17
26,LR,0,350,1,-95,-95,-95,0
26,LR,0,350,7,-80.5714285714286,-78,-83,5
26,LR,0,350,2,-82,-81,-83,2
26,LR,1,350,10,-79.1,-76,-84,8
26,LR,1,350,9,-78.6666666666667,-76,-84,8
26,LR,0,350,8,-80,-76,-92,16
26,LR,0,350,1,-79,-79,-79,0
26,LR,1,350,9,-81.3333333333333,-76,-92,16
26,LR,0,350,1,-77,-77,-77,0
26,LR,0,350,2,-91,-90,-92,2
26,LR,0,350,5,-81,-77,-90,13
26,LR,0,350,8,-78.125,-77,-82,5
26,LR,1,350,9,-78.3333333333333,-77,-84,7
26,LR,0,350,5,-77.8,-77,-78,1
26,LR,0,350,3,-77.6666666666667,-77,-78,1
26,LR,0,350,2,-77.5,-77,-78,1
26,LR,0,350,2,-77.5,-77,-78,1
26,LR,0,350,7,-77.1428571428571,-74,-84,10
26,LR,0,350,4,-78,-75,-84,9
26,LR,0,350,7,-78.2857142857143,-74,-87,13
26,LR,0,350,6,-80.1666666666667,-74,-87,13
26,LR,1,350,9,-79.6666666666667,-74,-87,13
26,LR,0,350,5,-81.2,-74,-87,13
26,LR,0,350,1,-86,-86,-86,0
26,LR,0,350,5,-79.4,-74,-86,12
26,LR,0,350,1,-86,-86,-86,0
26,LR,0,350,5,-77.8,-74,-86,12
26,LR,1,350,10,-77.8,-73,-86,13
26,LR,0,350,1,-75,-75,-75,0
26,LR,0,350,7,-77.5714285714286,-73,-82,9
26,LR,0,350,5,-78.6,-76,-82,6
26,LR,0,350,8,-77.875,-73,-82,9
26,LR,0,350,4,-77,-73,-82,9
26,LR,0,350,8,-76.75,-73,-82,9
26,LR,0,350,6,-75.8333333333333,-73,-81,8
26,LR,0,350,7,-76.1428571428571,-73,-81,8
26,LR,1,350,9,-75.7777777777778,-73,-81,8
26,LR,0,350,6,-75.5,-73,-77,4
26,LR,0,350,6,-75.1666666666667,-73,-77,4
26,LR,1,350,10,-75.9,-73,-80,7
26,LR,0,350,2,-74,-73,-75,2
26,LR,0,350,3,-75,-75,-75,0
26,LR,1,350,10,-77.4,-73,-85,12
26,LR,0,350,5,-77,-75,-80,5
26,LR,0,350,5,-76.6,-73,-80,7
26,LR,0,350,1,-75,-75,-75,0
26,LR,1,350,9,-80.2222222222222,-73,-88,15
26,LR,0,350,3,-78.6666666666667,-73,-85,12
26,LR,0,350,5,-83.2,-78,-88,10
26,LR,0,350,7,-79.1428571428571,-74,-88,14
26,LR,0,350,2,-82,-77,-87,10
26,LR,0,350,5,-75.8,-74,-78,4
26,LR,0,350,4,-75.5,-74,-78,4
26,LR,1,350,10,-79.3,-75,-84,9
26,LR,0,350,6,-78.5,-75,-84,9
26,LR,0,350,6,-80.5,-78,-84,6
26,LR,0,350,4,-79.75,-78,-82,4
26,LR,1,350,9,-79.4444444444444,-78,-82,4
26,LR,0,350,8,-79.625,-78,-82,4
26,LR,0,350,4,-80,-79,-82,3
26,LR,0,350,3,-80,-79,-82,3
26,LR,1,350,10,-78.2,-76,-84,8
26,LR,0,350,5,-77.6,-76,-79,3
26,LR,0,350,7,-78,-76,-84,8
26,LR,1,350,9,-78.3333333333333,-76,-84,8
26,LR,0,350,4,-78.75,-76,-84,8
26,LR,1,350,10,-78.8,-77,-84,7
26,LR,0,350,4,-78.5,-77,-80,3
26,LR,0,350,1,-79,-79,-79,0
26,LR,0,350,8,-78.625,-77,-80,3
26,LR,1,350,10,-78.8,-76,-81,5
26,LR,0,350,6,-78.6666666666667,-77,-80,3
26,LR,1,350,10,-79,-76,-83,7
26,LR,0,350,7,-78.7142857142857,-76,-81,5
26,LR,0,350,6,-79,-76,-81,5
26,LR,0,350,6,-78.6666666666667,-76,-81,5
26,LR,0,350,5,-79.2,-76,-83,7
26,LR,0,350,7,-79.4285714285714,-76,-83,7
26,LR,0,350,2,-79,-77,-81,4
26,LR,0,350,5,-79.8,-77,-83,6
26,LR,1,350,9,-80.3333333333333,-77,-83,6
26,LR,0,350,7,-80,-77,-83,6
26,LR,1,350,9,-79.8888888888889,-77,-83,6
26,LR,0,350,3,-81.3333333333333,-79,-83,4
26,LR,0,350,5,-79.2,-77,-83,6
26,LR,0,350,6,-79.5,-77,-83,6
26,LR,1,350,9,-77.8888888888889,-76,-82,6
26,LR,1,350,9,-78.3333333333333,-76,-82,6
26,LR,0,350,1,-77,-77,-77,0
26,LR,0,350,8,-78.25,-76,-82,6
26,LR,1,350,9,-77.8888888888889,-76,-81,5
26,LR,1,350,9,-78.4444444444444,-77,-81,4
26,LR,1,350,10,-78.3,-76,-80,4
26,LR,0,350,3,-78.3333333333333,-78,-79,1
26,LR,0,350,3,-78.3333333333333,-78,-79,1
26,LR,0,350,6,-78.3333333333333,-76,-80,4
26,LR,0,350,6,-78.3333333333333,-76,-80,4
26,LR,0,350,6,-78.3333333333333,-76,-80,4
26,LR,0,350,4,-78,-76,-80,4
26,LR,0,350,7,-79.2857142857143,-76,-89,13
26,LR,0,350,2,-79,-78,-80,2
26,LR,0,350,1,-77,-77,-77,0
26,LR,1,350,10,-80,-76,-85,9
26,LR,0,350,5,-80,-76,-85,9
26,LR,0,350,8,-79.125,-76,-82,6
26,LR,0,350,6,-79,-76,-82,6
26,LR,0,350,2,-80,-78,-82,4
26,LR,0,350,4,-79.5,-78,-81,3
26,LR,0,350,1,-81,-81,-81,0
26,LR,1,350,9,-81.5555555555556,-77,-93,16
26,LR,1,350,9,-81.3333333333333,-77,-93,16
26,LR,0,350,3,-83,-80,-87,7
26,LR,1,350,9,-81.2222222222222,-77,-93,16
26,LR,0,350,6,-82,-77,-93,16
26,LR,1,350,9,-81.5555555555556,-77,-93,16
26,LR,0,350,4,-81.75,-77,-93,16
26,LR,0,350,8,-82.75,-78,-93,15
26,LR,0,350,8,-81.375,-79,-90,11
26,LR,0,350,1,-79,-79,-79,0
26,LR,0,350,1,-80,-80,-80,0
26,LR,0,350,5,-81.2,-80,-83,3
26,LR,0,350,1,-83,-83,-83,0
26,LR,0,350,2,-80,-80,-80,0
26,LR,0,350,7,-80.2857142857143,-75,-87,12
26,LR,0,350,6,-79.8333333333333,-75,-87,12
26,LR,0,350,2,-78,-78,-78,0
26,LR,0,350,6,-80.5,-77,-87,10
26,LR,0,350,1,-87,-87,-87,0
26,LR,0,350,3,-79.6666666666667,-77,-84,7
26,LR,0,350,3,-80.3333333333333,-78,-84,6
26,LR,0,350,2,-82.5,-79,-86,7
26,LR,0,350,4,-80.5,-78,-86,8
26,LR,0,350,4,-79,-78,-80,2
26,LR,0,350,4,-82.5,-78,-93,15
26,LR,0,350,8,-81.625,-78,-93,15
26,LR,0,350,6,-82.1666666666667,-78,-93,15
26,LR,0,350,5,-80,-78,-86,8
26,LR,0,350,7,-78.2857142857143,-77,-80,3
26,LR,0,350,3,-79.3333333333333,-79,-80,1
26,LR,0,350,4,-78.25,-77,-80,3
26,LR,1,350,9,-79.5555555555556,-76,-88,12
26,LR,0,350,3,-80,-77,-84,7
26,LR,0,350,8,-80,-76,-88,12
26,LR,1,350,10,-79.7,-76,-88,12
26,LR,0,350,4,-77.75,-76,-79,3
26,LR,0,350,4,-81,-78,-88,10
26,LR,0,350,3,-81.6666666666667,-78,-88,10
26,LR,0,350,7,-79.8571428571429,-77,-88,11
26,LR,0,350,2,-78.5,-78,-79,1
26,LR,0,350,2,-78,-77,-79,2
26,LR,1,350,9,-79.4444444444444,-77,-82,5
26,LR,1,350,10,-79.6,-78,-82,4
26,LR,1,350,9,-79.5555555555556,-78,-82,4
26,LR,0,350,6,-80,-79,-82,3
26,LR,0,350,6,-80,-79,-82,3
26,LR,0,350,1,-79,-79,-79,0
26,LR,0,350,3,-78.3333333333333,-77,-79,2
26,LR,1,350,10,-80,-75,-93,18
26,LR,0,350,6,-80.6666666666667,-75,-93,18
26,LR,0,350,3,-84,-78,-93,15
26,LR,0,350,6,-77.1666666666667,-75,-81,6
26,LR,0,350,4,-77.5,-75,-81,6
26,LR,0,350,1,-79,-79,-79,0
26,LR,0,350,1,-75,-75,-75,0
26,LR,0,350,1,-75,-75,-75,0
26,LR,0,350,8,-77,-74,-86,12
26,LR,0,350,1,-79,-79,-79,0
26,LR,0,350,3,-76,-75,-77,2
26,LR,0,350,2,-76,-75,-77,2
26,LR,0,350,4,-77.25,-74,-86,12
26,LR,1,350,10,-77.8,-74,-86,12
26,LR,0,350,5,-78.8,-75,-86,11
26,LR,0,350,1,-81,-81,-81,0
26,LR,0,350,8,-77.125,-75,-83,8
26,LR,0,350,2,-75,-75,-75,0
26,LR,0,350,7,-77.2857142857143,-75,-83,8
26,LR,0,350,8,-78.625,-76,-86,10
26,LR,0,350,5,-78.6,-76,-86,10
26,LR,0,350,2,-76.5,-76,-77,1
26,LR,0,350,7,-79.5714285714286,-76,-86,10
26,LR,0,350,3,-82,-76,-86,10
26,LR,1,350,10,-78.6,-76,-84,8
26,LR,0,350,7,-78.8571428571429,-76,-84,8
26,LR,0,350,5,-78.2,-76,-81,5
26,LR,0,350,4,-78.75,-77,-81,4
26,LR,0,350,3,-78,-77,-79,2
26,LR,0,350,6,-77.5,-76,-80,4
26,LR,0,350,7,-78,-76,-81,5
26,LR,0,350,1,-80,-80,-80,0
26,LR,0,350,3,-77,-76,-78,2
26,LR,1,350,9,-78.5555555555556,-76,-85,9
26,LR,1,350,10,-78.5,-76,-85,9
26,LR,0,350,2,-79,-77,-81,4
26,LR,0,350,7,-79.2857142857143,-77,-85,8
26,LR,0,350,3,-77.6666666666667,-77,-78,1
26,LR,0,350,7,-80.1428571428571,-77,-87,10
26,LR,0,350,4,-79.5,-77,-85,8
26,LR,0,350,7,-81.5714285714286,-77,-89,12
26,LR,0,350,4,-84.75,-77,-89,12
26,LR,1,350,10,-81.3,-75,-89,14
26,LR,0,350,4,-81.25,-77,-86,9
26,LR,0,350,1,-86,-86,-86,0
26,LR,0,350,3,-79.3333333333333,-76,-84,8
26,LR,0,350,5,-79.8,-75,-86,11
26,LR,0,350,2,-76.5,-75,-78,3
26,LR,0,350,6,-81.3333333333333,-77,-86,9
26,LR,0,350,1,-84,-84,-84,0
26,LR,0,350,3,-82.3333333333333,-77,-86,9
26,LR,0,350,8,-81.375,-75,-86,11
26,LR,0,350,6,-82.8333333333333,-80,-86,6
26,LR,0,350,4,-83.25,-81,-86,5
26,LR,0,350,2,-85.5,-85,-86,1
26,LR,0,350,5,-80.8,-75,-87,12
26,LR,0,350,8,-79.75,-74,-87,13
26,LR,1,350,9,-79.8888888888889,-74,-87,13
26,LR,0,350,5,-80.4,-74,-87,13
26,LR,0,350,1,-87,-87,-87,0
26,LR,0,350,3,-80,-74,-86,12
26,LR,1,350,10,-80.3,-74,-86,12
26,LR,0,350,3,-80.6666666666667,-80,-82,2
26,LR,0,350,8,-79.625,-74,-86,12
26,LR,0,350,5,-79.4,-74,-82,8
26,LR,0,350,3,-78.3333333333333,-74,-81,7
26,LR,1,350,10,-79,-74,-90,16
26,LR,0,350,4,-82.75,-74,-90,16
26,LR,0,350,2,-82,-74,-90,16
26,LR,0,350,4,-80.75,-74,-90,16
26,LR,0,350,6,-75.1666666666667,-74,-78,4
26,LR,0,350,5,-75.2,-74,-78,4
26,LR,1,350,9,-78.3333333333333,-74,-85,11
26,LR,1,350,10,-79.8,-74,-88,14
26,LR,0,350,3,-74.6666666666667,-74,-76,2
26,LR,0,350,8,-81.25,-74,-88,14
26,LR,0,350,3,-81,-74,-85,11
26,LR,0,350,6,-83.3333333333333,-76,-88,12
26,LR,0,350,5,-83,-76,-88,12
26,LR,0,350,6,-84.8333333333333,-76,-96,20
26,LR,0,350,2,-86,-84,-88,4
26,LR,1,350,10,-85.1,-76,-96,20
26,LR,0,350,3,-87,-82,-96,14
26,LR,1,350,10,-84.6,-76,-96,20
26,LR,0,350,1,-90,-90,-90,0
26,LR,0,350,2,-87.5,-84,-91,7
26,LR,0,350,2,-80.5,-78,-83,5
26,LR,0,350,4,-80,-76,-83,7
26,LR,0,350,6,-79.6666666666667,-74,-84,10
26,LR,0,350,2,-83,-83,-83,0
26,LR,1,350,10,-78.3,-73,-84,11
26,LR,0,350,6,-78.6666666666667,-74,-84,10
26,LR,0,350,2,-78.5,-74,-83,9
26,LR,0,350,1,-83,-83,-83,0
26,LR,1,350,10,-76.9,-73,-86,13
26,LR,0,350,1,-77,-77,-77,0
26,LR,0,350,7,-77.8571428571429,-74,-86,12
26,LR,1,350,9,-78.3333333333333,-74,-86,12
26,LR,0,350,5,-76.4,-74,-80,6
26,LR,1,350,9,-76.8888888888889,-74,-81,7
26,LR,0,350,4,-76.25,-74,-80,6
26,LR,0,350,6,-78.1666666666667,-75,-81,6
26,LR,0,350,7,-78.1428571428571,-75,-81,6
26,LR,0,350,8,-77.5,-75,-81,6
26,LR,0,350,6,-78,-75,-81,6
26,LR,1,350,9,-76.7777777777778,-73,-81,8
26,LR,1,350,9,-76.3333333333333,-73,-79,6
26,LR,1,350,9,-76.8888888888889,-73,-81,8
26,LR,0,350,2,-77.5,-76,-79,3
26,LR,0,350,1,-76,-76,-76,0
26,LR,0,350,6,-77,-73,-81,8
26,LR,0,350,5,-76.8,-73,-81,8
26,LR,0,350,3,-79,-77,-81,4
26,LR,1,350,9,-79.7777777777778,-73,-87,14
26,LR,0,350,4,-79.25,-74,-85,11
26,LR,0,350,1,-85,-85,-85,0
26,LR,0,350,2,-83,-79,-87,8
26,LR,0,350,5,-79.2,-73,-84,11
26,LR,1,350,9,-78.5555555555556,-73,-84,11
26,LR,0,350,3,-76.6666666666667,-74,-79,5
26,LR,0,350,2,-75.5,-74,-77,3
26,LR,0,350,4,-76.75,-73,-83,10
26,LR,0,350,7,-78.1428571428571,-73,-83,10
26,LR,1,350,10,-79.2,-72,-88,16
26,LR,0,350,8,-79.875,-73,-88,15
26,LR,1,350,10,-78.9,-72,-88,16
26,LR,0,350,6,-80.8333333333333,-73,-88,15
26,LR,0,350,1,-76,-76,-76,0
26,LR,0,350,7,-76.2857142857143,-72,-83,11
26,LR,1,350,10,-75.8,-72,-79,7
26,LR,0,350,2,-77,-77,-77,0
26,LR,0,350,4,-75.5,-73,-77,4
26,LR,0,350,1,-75,-75,-75,0
26,LR,1,350,9,-76.1111111111111,-72,-79,7
26,LR,0,350,4,-76.5,-72,-79,7
26,LR,0,350,6,-76.1666666666667,-72,-79,7
26,LR,0,350,5,-75.6,-72,-78,6
26,LR,0,350,8,-76.5,-73,-79,6
26,LR,0,350,5,-76.4,-75,-78,3
26,LR,0,350,7,-75.5714285714286,-73,-79,6
26,LR,1,350,9,-75.7777777777778,-73,-79,6
26,LR,0,350,5,-75.8,-73,-79,6
26,LR,0,350,8,-75.875,-73,-79,6
26,LR,0,350,6,-75.5,-73,-79,6
26,LR,0,350,7,-75.8571428571429,-73,-79,6
26,LR,0,350,5,-75.8,-73,-78,5
26,LR,1,350,10,-78,-73,-86,13
26,LR,0,350,3,-75.3333333333333,-73,-78,5
26,LR,0,350,2,-75.5,-73,-78,5
26,LR,0,350,5,-80.2,-74,-86,12
26,LR,0,350,1,-74,-74,-74,0
26,LR,0,350,6,-79.5,-76,-86,10
26,LR,0,350,2,-82,-78,-86,8
26,LR,0,350,7,-76.8571428571429,-75,-80,5
26,LR,0,350,8,-76,-73,-80,7
26,LR,0,350,6,-76.3333333333333,-74,-80,6
26,LR,0,350,1,-80,-80,-80,0
26,LR,0,350,4,-75.75,-73,-79,6
26,LR,0,350,5,-76,-73,-79,6
26,LR,1,350,10,-77.7,-73,-88,15
26,LR,0,350,8,-76.25,-73,-79,6
26,LR,0,350,7,-76.2857142857143,-73,-79,6
26,LR,0,350,8,-79.75,-75,-88,13
26,LR,0,350,4,-80,-75,-88,13
26,LR,1,350,9,-79.1111111111111,-75,-88,13
26,LR,0,350,8,-79.625,-75,-88,13
26,LR,0,350,4,-82,-76,-88,12
26,LR,0,350,7,-77.7142857142857,-74,-86,12
26,LR,1,350,9,-76.4444444444444,-74,-80,6
26,LR,0,350,8,-76.5,-74,-80,6
26,LR,0,350,5,-75.8,-74,-77,3
26,LR,0,350,3,-75,-74,-77,3
26,LR,1,350,10,-78.5,-74,-88,14
26,LR,0,350,8,-76.5,-74,-80,6
26,LR,0,350,7,-77.5714285714286,-74,-81,7
31,RL,0,400,4,-78.25,-71,-82,11
31,RL,0,400,3,-78,-71,-82,11
31,RL,0,400,4,-77.5,-71,-81,10
31,RL,0,400,6,-76.3333333333333,-71,-80,9
31,RL,1,400,9,-80.1111111111111,-76,-88,12
31,RL,0,400,5,-79.4,-76,-87,11
31,RL,0,400,4,-80.25,-77,-87,10
31,RL,0,400,6,-82,-78,-88,10
31,RL,1,400,9,-82.3333333333333,-78,-88,10
31,RL,0,400,4,-83,-78,-88,10
31,RL,0,400,4,-80.5,-78,-86,8
31,RL,0,400,8,-82.875,-78,-85,7
31,RL,0,400,4,-84,-81,-85,4
31,RL,0,400,6,-83.3333333333333,-81,-85,4
31,RL,0,400,6,-83.5,-82,-85,3
31,RL,0,400,3,-83,-82,-84,2
31,RL,0,400,4,-83.25,-82,-85,3
31,RL,1,400,10,-83.1,-81,-85,4
31,RL,1,400,10,-83.5,-81,-86,5
31,RL,0,400,3,-83,-82,-84,2
31,RL,0,400,2,-83.5,-83,-84,1
31,RL,0,400,2,-83,-82,-84,2
31,RL,0,400,1,-82,-82,-82,0
31,RL,0,400,6,-86.5,-84,-92,8
31,RL,0,400,5,-87,-85,-92,7
31,RL,0,400,8,-86.25,-83,-92,9
31,RL,0,400,7,-86.2857142857143,-83,-92,9
31,RL,0,400,3,-88.3333333333333,-86,-92,6
31,RL,1,400,9,-86,-83,-90,7
31,RL,1,400,10,-85.6,-82,-90,8
31,RL,0,400,7,-85.8571428571429,-83,-90,7
31,RL,0,400,5,-86.6,-83,-90,7
31,RL,0,400,7,-86.4285714285714,-82,-90,8
31,RL,1,400,9,-85.6666666666667,-82,-87,5
31,RL,0,400,6,-85.6666666666667,-82,-87,5
31,RL,0,400,1,-87,-87,-87,0
31,RL,0,400,1,-87,-87,-87,0
31,RL,1,400,9,-85,-82,-88,6
31,RL,0,400,7,-85.2857142857143,-83,-88,5
31,RL,0,400,3,-84.3333333333333,-83,-87,4
31,RL,0,400,1,-87,-87,-87,0
31,RL,0,400,2,-84,-83,-85,2
31,RL,0,400,2,-86.5,-85,-88,3
31,RL,0,400,7,-85.2857142857143,-82,-88,6
31,RL,0,400,2,-83.5,-82,-85,3
31,RL,0,400,6,-84.1666666666667,-81,-87,6
31,RL,0,400,6,-84.6666666666667,-81,-87,6
31,RL,0,400,3,-85,-82,-87,5
31,RL,0,400,3,-83.3333333333333,-81,-87,6
31,RL,0,400,2,-81.5,-81,-82,1
31,RL,0,400,3,-83.3333333333333,-81,-85,4
31,RL,0,400,6,-84.6666666666667,-83,-87,4
31,RL,0,400,5,-84.6,-83,-87,4
31,RL,0,400,7,-83.7142857142857,-82,-87,5
31,RL,0,400,2,-84,-83,-85,2
31,RL,0,400,1,-83,-83,-83,0
31,RL,0,400,1,-82,-82,-82,0
31,RL,0,400,3,-83.3333333333333,-82,-84,2
31,RL,0,400,8,-84.625,-83,-87,4
31,RL,0,400,1,-86,-86,-86,0
31,RL,0,400,5,-84.2,-83,-87,4
31,RL,0,400,8,-84.125,-82,-87,5
31,RL,0,400,8,-83.75,-81,-87,6
31,RL,0,400,5,-83.6,-82,-86,4
31,RL,1,400,9,-82.6666666666667,-79,-86,7
31,RL,1,400,9,-82.2222222222222,-79,-85,6
31,RL,0,400,7,-82.2857142857143,-79,-85,6
31,RL,0,400,7,-82.2857142857143,-79,-85,6
31,RL,0,400,5,-81.8,-79,-84,5
31,RL,0,400,4,-82,-79,-84,5
31,RL,0,400,5,-81.8,-79,-84,5
31,RL,0,400,1,-81,-81,-81,0
31,RL,0,400,2,-82.5,-82,-83,1
31,RL,0,400,8,-83,-80,-86,6
31,RL,1,400,9,-82.7777777777778,-80,-86,6
31,RL,0,400,8,-82.25,-81,-83,2
31,RL,0,400,1,-83,-83,-83,0
31,RL,1,400,9,-81.6666666666667,-79,-83,4
31,RL,1,400,10,-82.2,-79,-86,7
31,RL,0,400,3,-82.6666666666667,-82,-83,1
31,RL,0,400,7,-81.7142857142857,-79,-83,4
31,RL,0,400,4,-81.25,-79,-83,4
31,RL,0,400,6,-82.1666666666667,-79,-86,7
31,RL,0,400,7,-82.8571428571429,-81,-86,5
31,RL,0,400,4,-82.75,-81,-86,5
31,RL,0,400,5,-83.2,-81,-86,5
31,RL,0,400,7,-83.8571428571429,-81,-86,5
31,RL,0,400,6,-84.1666666666667,-81,-86,5
31,RL,0,400,8,-82.625,-79,-86,7
31,RL,0,400,5,-83.6,-82,-86,4
31,RL,1,400,10,-82.3,-79,-85,6
31,RL,1,400,10,-82.2,-79,-85,6
31,RL,0,400,3,-81.6666666666667,-79,-83,4
31,RL,0,400,3,-82,-79,-84,5
31,RL,0,400,3,-83.6666666666667,-82,-85,3
31,RL,1,400,9,-82.2222222222222,-79,-85,6
31,RL,0,400,8,-82.25,-79,-85,6
31,RL,1,400,10,-82.1,-79,-85,6
31,RL,0,400,6,-82,-79,-84,5
31,RL,1,400,10,-82.3,-79,-85,6
31,RL,0,400,5,-82.8,-79,-85,6
31,RL,0,400,1,-82,-82,-82,0
31,RL,0,400,2,-81.5,-79,-84,5
31,RL,0,400,5,-81.4,-79,-85,6
31,RL,0,400,2,-84,-83,-85,2
31,RL,0,400,4,-82.25,-81,-84,3
31,RL,0,400,4,-81.75,-81,-82,1
31,RL,0,400,3,-82,-82,-82,0
31,RL,0,400,3,-83,-82,-85,3
31,RL,0,400,6,-83.3333333333333,-81,-87,6
31,RL,0,400,4,-83.75,-81,-87,6
31,RL,1,400,9,-83.8888888888889,-81,-87,6
31,RL,1,400,10,-84.1,-82,-87,5
31,RL,0,400,4,-84.25,-82,-86,4
31,RL,0,400,7,-84.1428571428571,-82,-86,4
31,RL,0,400,1,-86,-86,-86,0
31,RL,0,400,8,-83.5,-82,-85,3
31,RL,0,400,1,-85,-85,-85,0
31,RL,0,400,6,-83.5,-83,-84,1
31,RL,0,400,8,-82.75,-79,-84,5
31,RL,1,400,9,-82.7777777777778,-79,-84,5
31,RL,0,400,1,-84,-84,-84,0
31,RL,1,400,10,-82.9,-79,-85,6
31,RL,0,400,1,-81,-81,-81,0
31,RL,0,400,6,-82.8333333333333,-79,-85,6
31,RL,0,400,3,-83,-83,-83,0
31,RL,0,400,1,-83,-83,-83,0
31,RL,0,400,8,-83.625,-81,-86,5
31,RL,0,400,4,-84,-82,-85,3
31,RL,0,400,1,-84,-84,-84,0
31,RL,0,400,2,-83.5,-82,-85,3
31,RL,0,400,1,-85,-85,-85,0
31,RL,1,400,9,-82.8888888888889,-81,-86,5
31,RL,0,400,4,-84.25,-82,-86,4
31,RL,0,400,8,-83.125,-81,-86,5
31,RL,0,400,2,-81.5,-81,-82,1
31,RL,0,400,2,-81.5,-81,-82,1
31,RL,1,400,9,-83.4444444444444,-81,-86,5
31,RL,1,400,9,-83.2222222222222,-81,-86,5
31,RL,1,400,9,-83.5555555555556,-81,-86,5
31,RL,0,400,2,-85,-84,-86,2
31,RL,0,400,7,-83.4285714285714,-81,-85,4
31,RL,0,400,6,-83.3333333333333,-81,-85,4
31,RL,0,400,1,-85,-85,-85,0
31,RL,0,400,5,-83,-82,-84,2
31,RL,0,400,6,-82.3333333333333,-81,-83,2
31,RL,0,400,6,-81.5,-78,-83,5
31,RL,0,400,1,-82,-82,-82,0
31,RL,0,400,6,-80.5,-78,-83,5
31,RL,0,400,1,-81,-81,-81,0
31,RL,0,400,4,-79.75,-78,-82,4
31,RL,0,400,2,-78,-78,-78,0
31,RL,1,400,10,-80.1,-78,-83,5
31,RL,1,400,9,-80.2222222222222,-78,-83,5
31,RL,0,400,7,-80.8571428571429,-80,-83,3
31,RL,0,400,5,-81,-80,-83,3
31,RL,1,400,9,-80.4444444444444,-78,-83,5
31,RL,0,400,7,-80.5714285714286,-78,-83,5
31,RL,0,400,6,-80.1666666666667,-78,-82,4
31,RL,0,400,3,-79.6666666666667,-78,-81,3
31,RL,1,400,9,-80.5555555555556,-78,-83,5
31,RL,0,400,4,-80,-78,-82,4
31,RL,0,400,4,-80.5,-80,-82,2
31,RL,0,400,3,-80,-80,-80,0
31,RL,0,400,4,-81.25,-80,-83,3
31,RL,0,400,8,-80.5,-79,-83,4
31,RL,0,400,1,-83,-83,-83,0
31,RL,1,400,9,-80.7777777777778,-79,-83,4
31,RL,1,400,9,-81.3333333333333,-79,-84,5
31,RL,0,400,5,-80.4,-79,-83,4
31,RL,0,400,7,-82.2857142857143,-80,-84,4
31,RL,0,400,8,-82.375,-80,-84,4
31,RL,1,400,10,-82.9,-80,-85,5
31,RL,1,400,9,-82.8888888888889,-80,-85,5
31,RL,0,400,5,-82.4,-80,-84,4
31,RL,0,400,2,-82,-80,-84,4
31,RL,0,400,5,-82.6,-80,-85,5
31,RL,0,400,4,-83.25,-80,-85,5
31,RL,0,400,6,-83.8333333333333,-82,-85,3
31,RL,0,400,8,-84,-82,-86,4
31,RL,1,400,10,-83.4,-81,-86,5
31,RL,0,400,3,-83.3333333333333,-82,-84,2
31,RL,0,400,6,-83.6666666666667,-82,-86,4
31,RL,0,400,5,-83.6,-82,-86,4
31,RL,1,400,10,-82.6,-81,-86,5
31,RL,1,400,9,-81.7777777777778,-81,-83,2
31,RL,0,400,5,-81.6,-81,-83,2
31,RL,1,400,10,-81.8,-81,-84,3
31,RL,0,400,4,-82,-81,-83,2
31,RL,0,400,7,-81.8571428571429,-81,-84,3
31,RL,0,400,2,-82,-82,-82,0
31,RL,0,400,6,-82.3333333333333,-81,-84,3
31,RL,0,400,2,-81,-81,-81,0
31,RL,0,400,6,-83,-81,-85,4
31,RL,0,400,2,-83,-82,-84,2
31,RL,0,400,3,-84.3333333333333,-84,-85,1
31,RL,0,400,8,-82.625,-81,-85,4
31,RL,0,400,2,-83,-82,-84,2
31,RL,1,400,10,-82.5,-80,-86,6
31,RL,0,400,1,-81,-81,-81,0
31,RL,1,400,10,-82.8,-80,-86,6
31,RL,1,400,9,-83,-80,-86,6
31,RL,0,400,3,-83.6666666666667,-80,-86,6
31,RL,1,400,10,-83.2,-82,-86,4
31,RL,0,400,5,-82.4,-82,-84,2
31,RL,0,400,2,-82,-82,-82,0
31,RL,0,400,8,-82.625,-80,-84,4
31,RL,0,400,1,-84,-84,-84,0
31,RL,0,400,1,-82,-82,-82,0
31,RL,1,400,10,-82.9,-80,-85,5
31,RL,0,400,6,-82.8333333333333,-80,-84,4
31,RL,1,400,10,-83.3,-80,-86,6
31,RL,0,400,2,-82,-80,-84,4
31,RL,0,400,2,-84,-84,-84,0
31,RL,0,400,2,-83.5,-83,-84,1
31,RL,0,400,4,-83,-82,-85,3
31,RL,1,400,10,-83.8,-82,-89,7
31,RL,0,400,6,-84.1666666666667,-82,-89,7
31,RL,0,400,6,-84.5,-82,-89,7
31,RL,0,400,6,-84.1666666666667,-82,-89,7
31,RL,0,400,5,-84.6,-83,-89,6
31,RL,0,400,1,-89,-89,-89,0
31,RL,0,400,4,-84.75,-83,-88,5
31,RL,0,400,4,-84.75,-83,-88,5
31,RL,0,400,5,-85.8,-83,-88,5
31,RL,0,400,6,-86,-84,-88,4
31,RL,1,400,9,-85.5555555555556,-84,-88,4
31,RL,0,400,4,-86,-85,-88,3
31,RL,0,400,7,-85.7142857142857,-84,-88,4
31,RL,0,400,8,-85.125,-84,-88,4
31,RL,1,400,9,-85.1111111111111,-84,-88,4
31,RL,0,400,4,-85.5,-84,-88,4
31,RL,0,400,1,-84,-84,-84,0
31,RL,0,400,2,-84,-84,-84,0
31,RL,0,400,7,-86.2857142857143,-85,-90,5
31,RL,0,400,6,-86,-83,-90,7
31,RL,0,400,3,-86.6666666666667,-85,-90,5
31,RL,1,400,9,-85.1111111111111,-83,-90,7
31,RL,0,400,3,-83.6666666666667,-83,-84,1
31,RL,1,400,10,-85.3,-83,-88,5
31,RL,0,400,5,-84.4,-83,-86,3
31,RL,0,400,2,-83.5,-83,-84,1
31,RL,0,400,5,-84.8,-83,-87,4
31,RL,0,400,7,-86.2857142857143,-84,-88,4
31,RL,0,400,1,-87,-87,-87,0
31,RL,0,400,8,-87.5,-85,-92,7
31,RL,0,400,8,-87.875,-85,-92,7
31,RL,0,400,6,-87.8333333333333,-85,-92,7
31,RL,0,400,1,-87,-87,-87,0
31,RL,0,400,6,-89.6666666666667,-85,-96,11
31,RL,0,400,1,-92,-92,-92,0
31,RL,0,400,7,-89.8571428571429,-87,-96,9
31,RL,0,400,1,-88,-88,-88,0
31,RL,0,400,7,-89.4285714285714,-86,-96,10
31,RL,0,400,1,-87,-87,-87,0
31,RL,0,400,6,-88.5,-86,-90,4
31,RL,0,400,6,-88.1666666666667,-86,-90,4
31,RL,0,400,1,-90,-90,-90,0
31,RL,0,400,6,-87.6666666666667,-86,-89,3
31,RL,0,400,2,-87,-86,-88,2
31,RL,0,400,8,-87.5,-85,-90,5
31,RL,0,400,3,-87.6666666666667,-86,-89,3
31,RL,0,400,8,-88.125,-85,-92,7
31,RL,0,400,5,-88,-85,-90,5
31,RL,0,400,7,-88,-85,-92,7
31,RL,0,400,4,-89.5,-86,-92,6
31,RL,0,400,7,-88.5714285714286,-86,-93,7
31,RL,0,400,7,-88.8571428571429,-86,-93,7
31,RL,1,400,9,-88.6666666666667,-85,-93,8
31,RL,0,400,8,-88.875,-85,-93,8
31,RL,0,400,8,-88.875,-85,-93,8
31,RL,0,400,7,-89.2857142857143,-85,-93,8
31,RL,1,400,9,-87.4444444444444,-85,-92,7
31,RL,0,400,6,-87.6666666666667,-85,-92,7
31,RL,0,400,2,-85.5,-85,-86,1
31,RL,0,400,2,-86,-86,-86,0
31,RL,0,400,1,-86,-86,-86,0
31,RL,0,400,5,-89.4,-86,-93,7
31,RL,0,400,2,-89,-88,-90,2
31,RL,0,400,3,-89,-86,-93,7
31,RL,0,400,7,-85.8571428571429,-85,-87,2
31,RL,0,400,8,-86.25,-85,-89,4
31,RL,0,400,6,-85.6666666666667,-85,-86,1
31,RL,0,400,6,-86.3333333333333,-85,-89,4
31,RL,0,400,7,-87,-85,-89,4
31,RL,0,400,3,-85.6666666666667,-85,-86,1
31,RL,0,400,7,-87.7142857142857,-86,-90,4
31,RL,1,400,9,-87,-85,-90,5
31,RL,0,400,1,-88,-88,-88,0
31,RL,0,400,7,-86.5714285714286,-85,-90,5
31,RL,1,400,10,-86.1,-85,-90,5
31,RL,0,400,5,-85.4,-85,-86,1
31,RL,0,400,3,-85.3333333333333,-85,-86,1
31,RL,0,400,2,-85,-85,-85,0
31,RL,0,400,6,-85.6666666666667,-85,-88,3
31,RL,0,400,4,-85.75,-85,-88,3
31,RL,1,400,9,-85.5555555555556,-84,-88,4
31,RL,0,400,8,-85.625,-84,-88,4
31,RL,0,400,1,-85,-85,-85,0
31,RL,0,400,7,-85.1428571428571,-84,-86,2
31,RL,0,400,3,-84.6666666666667,-84,-85,1
31,RL,0,400,3,-85,-84,-86,2
31,RL,0,400,4,-86.25,-84,-90,6
31,RL,0,400,3,-86.3333333333333,-84,-90,6
31,RL,0,400,5,-87.4,-85,-90,5
31,RL,1,400,10,-86.8,-85,-90,5
31,RL,0,400,2,-88,-86,-90,4
31,RL,0,400,2,-86,-86,-86,0
31,RL,0,400,3,-87.3333333333333,-86,-90,4
31,RL,0,400,6,-86,-85,-90,5
31,RL,0,400,1,-85,-85,-85,0
31,RL,0,400,3,-85,-85,-85,0
31,RL,0,400,8,-85.75,-85,-87,2
31,RL,0,400,6,-85.8333333333333,-85,-87,2
31,RL,0,400,1,-87,-87,-87,0
31,RL,0,400,5,-85.4,-84,-87,3
31,RL,0,400,8,-86.125,-84,-88,4
31,RL,0,400,5,-86.6,-85,-88,3
31,RL,0,400,3,-86.3333333333333,-85,-88,3
31,RL,0,400,8,-86.875,-85,-90,5
31,RL,0,400,3,-85.6666666666667,-85,-86,1
31,RL,0,400,7,-87,-85,-90,5
31,RL,0,400,5,-87.2,-86,-90,4
31,RL,0,400,2,-87,-86,-88,2
31,RL,0,400,7,-87.5714285714286,-86,-90,4
31,RL,0,400,4,-87.25,-86,-89,3
31,RL,0,400,8,-87.125,-86,-90,4
31,RL,0,400,2,-86,-86,-86,0
31,RL,1,400,9,-85.6666666666667,-83,-90,7
31,RL,0,400,2,-88,-86,-90,4
31,RL,0,400,6,-84.8333333333333,-83,-86,3
31,RL,1,400,9,-83.8888888888889,-82,-86,4
31,RL,0,400,6,-84.1666666666667,-82,-86,4
31,RL,0,400,3,-84,-83,-86,3
31,RL,0,400,1,-83,-83,-83,0
31,RL,0,400,6,-84.1666666666667,-82,-87,5
31,RL,0,400,7,-83.2857142857143,-81,-87,6
31,RL,0,400,7,-83.8571428571429,-81,-90,9
31,RL,0,400,6,-84,-81,-90,9
31,RL,0,400,7,-84.1428571428571,-81,-90,9
31,RL,0,400,6,-85.3333333333333,-82,-90,8
31,RL,0,400,7,-85.4285714285714,-82,-90,8
31,RL,0,400,8,-85.75,-84,-90,6
31,RL,0,400,1,-86,-86,-86,0
31,RL,0,400,1,-84,-84,-84,0
31,RL,0,400,6,-86.1666666666667,-84,-90,6
31,RL,0,400,5,-85.8,-84,-87,3
31,RL,0,400,5,-85.8,-84,-87,3
31,RL,0,400,5,-86,-85,-87,2
31,RL,1,400,9,-87.1111111111111,-85,-93,8
31,RL,0,400,8,-87.125,-85,-93,8
31,RL,1,400,9,-86.8888888888889,-84,-93,9
31,RL,0,400,6,-87.3333333333333,-84,-93,9
31,RL,0,400,4,-87.5,-85,-93,8
31,RL,1,400,9,-87.8888888888889,-84,-93,9
31,RL,0,400,8,-88.125,-84,-93,9
31,RL,0,400,2,-84.5,-84,-85,1
31,RL,0,400,2,-85.5,-84,-87,3
31,RL,0,400,7,-89,-84,-96,12
31,RL,0,400,8,-89.75,-84,-97,13
31,RL,0,400,6,-91.1666666666667,-84,-97,13
31,RL,0,400,5,-91,-84,-97,13
31,RL,0,400,7,-89.8571428571429,-84,-97,13
31,RL,0,400,7,-88.7142857142857,-84,-97,13
31,RL,0,400,5,-88.2,-84,-97,13
31,RL,1,400,10,-88.9,-84,-100,16
31,RL,0,400,7,-89.8571428571429,-84,-100,16
31,RL,0,400,7,-89.5714285714286,-84,-100,16
31,RL,0,400,5,-91,-84,-100,16
31,RL,0,400,5,-91.4,-84,-100,16
31,RL,0,400,7,-90.1428571428571,-84,-98,14
31,RL,1,400,9,-87.5555555555556,-84,-95,11
31,RL,1,400,9,-88.4444444444444,-84,-95,11
31,RL,0,400,4,-87.5,-84,-95,11
31,RL,0,400,5,-84.6,-84,-87,3
31,RL,0,400,2,-85.5,-84,-87,3
31,RL,0,400,7,-86.7142857142857,-83,-93,10
31,RL,0,400,3,-87,-84,-93,9
31,RL,0,400,3,-89,-84,-93,9
31,RL,0,400,5,-86.8,-82,-93,11
31,RL,0,400,4,-85.25,-82,-90,8
31,RL,0,400,3,-83.6666666666667,-82,-86,4
31,RL,1,400,10,-84.7,-81,-89,8
31,RL,1,400,9,-84.8888888888889,-81,-89,8
31,RL,0,400,5,-84.8,-81,-89,8
31,RL,0,400,1,-89,-89,-89,0
31,RL,1,400,9,-85.2222222222222,-81,-92,11
31,RL,0,400,4,-85,-81,-87,6
31,RL,0,400,6,-85.5,-81,-92,11
31,RL,1,400,10,-87,-82,-92,10
31,RL,0,400,5,-86.4,-82,-92,10
31,RL,0,400,3,-88,-86,-92,6
31,RL,0,400,2,-86,-86,-86,0
31,RL,0,400,6,-87.6666666666667,-86,-89,3
31,RL,0,400,4,-87.75,-87,-89,2
31,RL,0,400,6,-85,-82,-89,7
31,RL,1,400,10,-86.1,-82,-92,10
31,RL,0,400,7,-85.4285714285714,-82,-92,10
31,RL,0,400,4,-84.5,-82,-88,6
31,RL,0,400,5,-86.8,-82,-92,10
31,RL,0,400,5,-87.6,-86,-92,6
31,RL,0,400,7,-87.2857142857143,-83,-92,9
31,RL,0,400,4,-86.75,-83,-92,9
31,RL,0,400,4,-86.75,-83,-92,9
31,RL,0,400,5,-85.8,-82,-92,10
31,RL,0,400,5,-87,-82,-92,10
31,RL,1,400,10,-87.7,-82,-92,10
31,RL,0,400,2,-87,-82,-92,10
31,RL,0,400,2,-88.5,-86,-91,5
31,RL,0,400,6,-86.6666666666667,-81,-92,11
31,RL,0,400,6,-85.8333333333333,-81,-92,11
31,RL,0,400,1,-92,-92,-92,0
31,RL,0,400,8,-85,-81,-90,9
31,RL,0,400,3,-84.3333333333333,-81,-86,5
31,RL,0,400,3,-84.3333333333333,-81,-86,5
31,RL,0,400,2,-85.5,-81,-90,9
31,RL,0,400,1,-90,-90,-90,0
31,RL,0,400,8,-85.125,-80,-92,12
31,RL,1,400,10,-85.2,-80,-92,12
31,RL,0,400,6,-85.1666666666667,-80,-92,12
31,RL,0,400,1,-81,-81,-81,0
31,RL,0,400,4,-89,-86,-92,6
31,RL,0,400,6,-86.1666666666667,-84,-89,5
31,RL,0,400,3,-86,-86,-86,0
31,RL,0,400,5,-85.8,-85,-86,1
31,RL,0,400,3,-85.6666666666667,-85,-86,1
31,RL,0,400,2,-85.5,-85,-86,1
31,RL,0,400,2,-85,-85,-85,0
31,RL,0,400,5,-85.8,-84,-87,3
31,RL,0,400,2,-87,-87,-87,0
31,RL,0,400,8,-89.125,-84,-98,14
31,RL,0,400,2,-84,-84,-84,0
31,RL,0,400,2,-89.5,-84,-95,11
31,RL,0,400,8,-89.875,-83,-98,15
31,RL,0,400,8,-88.625,-83,-98,15
31,RL,0,400,2,-85.5,-84,-87,3
31,RL,1,400,9,-86.3333333333333,-83,-90,7
31,RL,1,400,9,-86.5555555555556,-83,-90,7
31,RL,0,400,3,-85.3333333333333,-83,-88,5
31,RL,1,400,9,-85.7777777777778,-83,-90,7
31,RL,0,400,3,-84.6666666666667,-84,-85,1
31,RL,0,400,5,-86.6,-84,-90,6
31,RL,0,400,6,-86.5,-84,-90,6
31,RL,0,400,8,-86.625,-84,-90,6
31,RL,0,400,2,-86.5,-86,-87,1
31,RL,1,400,10,-85.5,-82,-88,6
31,RL,0,400,6,-86,-84,-88,4
31,RL,0,400,8,-85.5,-82,-88,6
31,RL,0,400,3,-87.3333333333333,-86,-88,2
31,RL,0,400,2,-87,-86,-88,2
31,RL,0,400,8,-85.875,-82,-89,7
31,RL,1,400,10,-85.9,-82,-89,7
31,RL,0,400,1,-86,-86,-86,0
31,RL,0,400,8,-85.875,-82,-89,7
31,RL,1,400,9,-87.1111111111111,-82,-96,14
31,RL,0,400,3,-87.6666666666667,-85,-89,4
31,RL,0,400,7,-88.1428571428571,-85,-96,11
31,RL,0,400,3,-86,-86,-86,0
31,RL,0,400,2,-86,-86,-86,0
31,RL,0,400,8,-87.75,-85,-96,11
31,RL,0,400,1,-85,-85,-85,0
31,RL,0,400,7,-88.1428571428571,-86,-96,10
31,RL,0,400,4,-87,-86,-89,3
31,RL,0,400,8,-86.625,-86,-89,3
31,RL,1,400,10,-86.8,-86,-90,4
31,RL,1,400,10,-86.6,-86,-90,4
31,RL,0,400,6,-86,-86,-86,0
31,RL,1,400,10,-86.5,-86,-90,4
31,RL,0,400,5,-86.8,-86,-90,4
31,RL,0,400,2,-86,-86,-86,0
31,RL,0,400,1,-86,-86,-86,0
31,RL,0,400,4,-87.25,-86,-90,4
31,RL,0,400,5,-87,-86,-90,4
31,RL,0,400,3,-86.3333333333333,-86,-87,1
31,RL,0,400,6,-86.8333333333333,-86,-88,2
31,RL,0,400,5,-86.8,-86,-88,2
31,RL,0,400,8,-89.625,-86,-95,9
31,RL,0,400,8,-90.625,-86,-95,9
31,RL,0,400,2,-88,-88,-88,0
31,RL,0,400,7,-90.8571428571429,-85,-95,10
31,RL,0,400,2,-90.5,-87,-94,7
31,RL,0,400,4,-91.75,-85,-95,10
31,RL,0,400,5,-90.8,-85,-95,10
31,RL,0,400,5,-88.8,-85,-94,9
31,RL,0,400,4,-87.5,-85,-90,5
31,RL,0,400,3,-88.3333333333333,-85,-90,5
31,RL,0,400,7,-86.8571428571429,-82,-90,8
31,RL,0,400,5,-85.8,-82,-90,8
31,RL,0,400,3,-86.3333333333333,-82,-90,8
31,RL,1,400,10,-84.2,-81,-89,8
31,RL,1,400,9,-83.6666666666667,-81,-89,8
31,RL,0,400,5,-85,-82,-89,7
31,RL,0,400,2,-84.5,-84,-85,1
31,RL,0,400,4,-83.25,-81,-85,4
31,RL,0,400,6,-82.6666666666667,-81,-84,3
31,RL,0,400,3,-82.6666666666667,-82,-84,2
31,RL,0,400,8,-85.5,-82,-92,10
31,RL,1,400,10,-86.3,-83,-92,9
31,RL,0,400,4,-86.75,-83,-92,9
31,RL,0,400,7,-87.4285714285714,-84,-92,8
31,RL,0,400,4,-87.75,-85,-92,7
31,RL,0,400,1,-88,-88,-88,0
31,RL,0,400,1,-85,-85,-85,0
31,RL,1,400,9,-84.7777777777778,-81,-90,9
31,RL,0,400,7,-83.8571428571429,-81,-87,6
31,RL,1,400,9,-82.2222222222222,-80,-86,6
31,RL,0,400,3,-82,-81,-83,2
31,RL,0,400,1,-82,-82,-82,0
31,RL,0,400,7,-81.5714285714286,-80,-84,4
31,RL,0,400,5,-81,-80,-82,2
31,RL,1,400,9,-81.5555555555556,-80,-83,3
31,RL,0,400,4,-81.5,-81,-82,1
31,RL,0,400,7,-81.7142857142857,-81,-83,2
31,RL,1,400,10,-81.6,-80,-83,3
31,RL,1,400,9,-81.6666666666667,-80,-83,3
31,RL,0,400,3,-81.6666666666667,-81,-83,2
31,RL,0,400,8,-81.125,-80,-83,3
31,RL,0,400,2,-80.5,-80,-81,1
31,RL,0,400,4,-81.25,-80,-83,3
31,RL,0,400,8,-81.625,-81,-83,2
31,RL,1,400,10,-81.4,-80,-83,3
31,RL,0,400,3,-81.6666666666667,-81,-83,2
31,RL,0,400,3,-81.3333333333333,-81,-82,1
31,RL,0,400,8,-81.125,-80,-83,3
31,RL,0,400,1,-81,-81,-81,0
31,RL,0,400,6,-80.8333333333333,-80,-83,3
31,RL,0,400,4,-80.5,-80,-81,1
31,RL,0,400,8,-81.125,-80,-84,4
31,RL,1,400,9,-81.4444444444444,-80,-84,4
31,RL,0,400,8,-82,-80,-84,4
31,RL,0,400,4,-82,-80,-84,4
31,RL,0,400,6,-82.6666666666667,-81,-84,3
31,RL,1,400,9,-81.7777777777778,-80,-84,4
31,RL,0,400,2,-82.5,-81,-84,3
31,RL,1,400,9,-81.6666666666667,-80,-84,4
31,RL,0,400,6,-81.6666666666667,-80,-83,3
31,RL,0,400,5,-80.8,-80,-82,2
31,RL,1,400,10,-81.8,-80,-87,7
31,RL,0,400,1,-82,-82,-82,0
31,RL,1,400,9,-82.5555555555556,-80,-87,7
31,RL,0,400,4,-82.5,-81,-87,6
31,RL,0,400,8,-83.25,-80,-87,7
31,RL,1,400,9,-82.7777777777778,-79,-87,8
31,RL,0,400,6,-84,-80,-87,7
31,RL,0,400,7,-82.4285714285714,-79,-87,8
31,RL,0,400,2,-84.5,-82,-87,5
31,RL,0,400,6,-82,-79,-87,8
31,RL,1,400,9,-79.8888888888889,-79,-82,3
31,RL,0,400,3,-79.6666666666667,-79,-81,2
31,RL,0,400,2,-79,-79,-79,0
31,RL,0,400,5,-79.8,-79,-82,3
31,RL,0,400,6,-79.8333333333333,-79,-82,3
31,RL,1,400,9,-81.4444444444444,-79,-85,6
31,RL,0,400,5,-80.2,-79,-82,3
31,RL,0,400,2,-81,-80,-82,2
31,RL,0,400,8,-82.25,-79,-85,6
31,RL,1,400,10,-83.9,-82,-86,4
31,RL,0,400,4,-83,-82,-84,2
31,RL,0,400,1,-84,-84,-84,0
31,RL,0,400,7,-83.7142857142857,-82,-86,4
31,RL,0,400,7,-84.1428571428571,-82,-86,4
31,RL,1,400,10,-83.7,-79,-86,7
31,RL,0,400,1,-83,-83,-83,0
31,RL,0,400,5,-85.4,-85,-86,1
31,RL,1,400,9,-82.8888888888889,-79,-86,7
31,RL,0,400,2,-85.5,-85,-86,1
31,RL,0,400,5,-83,-79,-85,6
31,RL,0,400,3,-83.6666666666667,-82,-85,3
31,RL,0,400,8,-82.625,-79,-87,8
31,RL,1,400,9,-83.5555555555556,-79,-88,9
31,RL,0,400,1,-79,-79,-79,0
31,RL,0,400,5,-83.2,-80,-87,7
31,RL,0,400,3,-83,-80,-85,5
31,RL,1,400,10,-86.5,-84,-88,4
31,RL,1,400,9,-86.7777777777778,-85,-88,3
31,RL,1,400,10,-87.4,-86,-91,5
31,RL,0,400,1,-88,-88,-88,0
31,RL,0,400,7,-87.5714285714286,-86,-91,5
31,RL,0,400,6,-87.6666666666667,-86,-91,5
31,RL,0,400,2,-87,-86,-88,2
31,RL,0,400,5,-87,-84,-91,7
31,RL,0,400,3,-88.3333333333333,-86,-91,5
31,RL,1,400,9,-89.2222222222222,-84,-94,10
31,RL,0,400,7,-89.1428571428571,-84,-94,10
31,RL,0,400,2,-85,-84,-86,2
31,RL,0,400,6,-90.8333333333333,-86,-94,8
31,RL,1,400,10,-85.2,-80,-91,11
31,RL,0,400,5,-87,-84,-89,5
31,RL,0,400,1,-84,-84,-84,0
31,RL,1,400,10,-83.6,-80,-89,9
31,RL,1,400,9,-83,-80,-89,9
31,RL,1,400,10,-83.3,-80,-89,9
31,RL,0,400,6,-81.6666666666667,-80,-83,3
31,RL,1,400,9,-83.7777777777778,-81,-88,7
31,RL,0,400,4,-82,-81,-83,2
31,RL,0,400,2,-81.5,-81,-82,1
31,RL,0,400,5,-84.6,-82,-88,6
31,RL,0,400,3,-85,-83,-88,5
31,RL,1,400,10,-85.2,-82,-88,6
31,RL,0,400,4,-86.5,-86,-88,2
31,RL,0,400,7,-84.8571428571429,-82,-87,5
31,RL,1,400,10,-84.7,-82,-89,7
31,RL,0,400,4,-84.25,-82,-87,5
31,RL,1,400,9,-83.7777777777778,-81,-89,8
31,RL,0,400,7,-84.4285714285714,-81,-89,8
31,RL,0,400,2,-87,-85,-89,4
31,RL,0,400,4,-84,-82,-86,4
31,RL,1,400,9,-84.6666666666667,-81,-92,11
31,RL,1,400,9,-85.6666666666667,-81,-92,11
31,RL,0,400,1,-81,-81,-81,0
31,RL,0,400,7,-88.5714285714286,-81,-92,11
31,RL,0,400,6,-89.8333333333333,-88,-92,4
31,RL,0,400,2,-90,-88,-92,4
31,RL,1,400,10,-89.2,-86,-92,6
31,RL,0,400,8,-88.75,-86,-92,6
31,RL,0,400,4,-88,-86,-92,6
31,RL,0,400,2,-87,-86,-88,2
31,RL,0,400,4,-87.25,-86,-89,3
31,RL,0,400,3,-87.6666666666667,-86,-89,3
31,RL,0,400,5,-87.8,-82,-90,8
31,RL,0,400,2,-89,-88,-90,2
31,RL,0,400,3,-87.3333333333333,-82,-90,8
31,RL,0,400,5,-85.2,-82,-90,8
31,RL,1,400,10,-86.5,-79,-100,21
31,RL,1,400,9,-87,-79,-100,21
31,RL,0,400,8,-86.625,-79,-100,21
31,RL,0,400,2,-90.5,-82,-99,17
31,RL,0,400,7,-88,-79,-100,21
31,RL,0,400,2,-89.5,-79,-100,21
31,RL,0,400,2,-82,-80,-84,4
31,RL,0,400,6,-85.5,-80,-88,8
31,RL,0,400,7,-84.2857142857143,-77,-88,11
31,RL,0,400,8,-83.375,-77,-88,11
31,RL,0,400,8,-82.375,-77,-88,11
31,RL,0,400,1,-80,-80,-80,0
31,RL,0,400,1,-84,-84,-84,0
31,RL,1,400,10,-80.7,-76,-87,11
31,RL,0,400,2,-82,-82,-82,0
31,RL,0,400,1,-82,-82,-82,0
31,RL,1,400,9,-81.5555555555556,-76,-87,11
31,RL,0,400,2,-76,-76,-76,0
31,RL,0,400,3,-82.6666666666667,-76,-87,11
31,RL,0,400,7,-82.5714285714286,-80,-87,7
31,RL,0,400,6,-81,-80,-86,6
31,RL,0,400,7,-78.8571428571429,-77,-80,3
31,RL,0,400,3,-79.3333333333333,-78,-80,2
31,RL,0,400,8,-77.875,-75,-80,5
31,RL,0,400,4,-78,-77,-80,3
31,RL,0,400,4,-77.25,-75,-80,5
31,RL,0,400,4,-77,-75,-78,3
31,RL,0,400,5,-77.8,-75,-80,5
31,RL,0,400,1,-78,-78,-78,0
31,RL,1,400,9,-81.4444444444444,-77,-92,15
31,RL,0,400,8,-81.875,-77,-92,15
31,RL,0,400,2,-77.5,-77,-78,1
31,RL,1,400,10,-82.6,-78,-92,14
31,RL,0,400,1,-81,-81,-81,0
31,RL,0,400,7,-81.5714285714286,-78,-84,6
31,RL,0,400,5,-81,-78,-83,5
31,RL,0,400,5,-81.4,-78,-83,5
31,RL,1,400,10,-82.3,-78,-86,8
31,RL,0,400,2,-82.5,-82,-83,1
31,RL,0,400,6,-81.8333333333333,-78,-86,8
31,RL,0,400,4,-80.5,-78,-86,8
31,RL,0,400,1,-79,-79,-79,0
31,RL,1,400,9,-80.4444444444444,-73,-86,13
31,RL,0,400,8,-79.75,-73,-86,13
31,RL,1,400,9,-81.8888888888889,-78,-86,8
31,RL,0,400,3,-77,-76,-78,2
31,RL,0,400,1,-76,-76,-76,0
31,RL,0,400,7,-80,-73,-86,13
31,RL,0,400,6,-80.3333333333333,-73,-85,12
31,LR,0,400,5,-88.6,-82,-95,13
31,LR,1,400,10,-82.9,-72,-95,23
31,LR,0,400,2,-86.5,-85,-88,3
31,LR,1,400,10,-79.1,-72,-89,17
31,LR,0,400,6,-81.5,-74,-89,15
31,LR,0,400,1,-74,-74,-74,0
31,LR,0,400,8,-74.75,-72,-81,9
31,LR,0,400,7,-74.5714285714286,-72,-80,8
31,LR,0,400,1,-73,-73,-73,0
31,LR,0,400,7,-77.5714285714286,-72,-83,11
31,LR,0,400,5,-77.6,-72,-83,11
31,LR,0,400,8,-78,-73,-83,10
31,LR,0,400,8,-77.875,-73,-83,10
31,LR,0,400,2,-78.5,-74,-83,9
31,LR,0,400,5,-78.2,-73,-83,10
31,LR,0,400,1,-81,-81,-81,0
31,LR,0,400,3,-75.6666666666667,-73,-81,8
31,LR,1,400,10,-77.5,-73,-81,8
31,LR,1,400,10,-77.4,-72,-81,9
31,LR,0,400,1,-79,-79,-79,0
31,LR,0,400,6,-77.3333333333333,-74,-80,6
31,LR,1,400,10,-76.3,-72,-80,8
31,LR,0,400,7,-76,-72,-80,8
31,LR,0,400,8,-76.125,-72,-80,8
31,LR,0,400,1,-77,-77,-77,0
31,LR,0,400,4,-74.75,-72,-78,6
31,LR,0,400,1,-72,-72,-72,0
31,LR,0,400,8,-75.375,-72,-79,7
31,LR,0,400,2,-77.5,-76,-79,3
31,LR,0,400,8,-75.75,-72,-79,7
31,LR,0,400,6,-75.8333333333333,-72,-80,8
31,LR,1,400,9,-76.1111111111111,-72,-80,8
31,LR,1,400,9,-76.5555555555556,-72,-80,8
31,LR,0,400,4,-76.5,-74,-80,6
31,LR,0,400,1,-80,-80,-80,0
31,LR,0,400,1,-78,-78,-78,0
31,LR,0,400,5,-75.6,-73,-78,5
31,LR,0,400,5,-75.2,-73,-78,5
31,LR,0,400,8,-76.125,-73,-79,6
31,LR,0,400,6,-76.8333333333333,-73,-79,6
31,LR,1,400,9,-75.5555555555556,-72,-79,7
31,LR,0,400,1,-74,-74,-74,0
31,LR,1,400,9,-76.1111111111111,-72,-79,7
31,LR,0,400,1,-79,-79,-79,0
31,LR,0,400,3,-75.6666666666667,-74,-79,5
31,LR,0,400,1,-74,-74,-74,0
31,LR,0,400,3,-74,-72,-76,4
31,LR,1,400,9,-75.7777777777778,-72,-79,7
31,LR,0,400,8,-76.25,-73,-79,6
31,LR,0,400,5,-76.6,-73,-79,6
31,LR,0,400,4,-77.5,-75,-79,4
31,LR,0,400,3,-77,-75,-79,4
31,LR,0,400,2,-77,-75,-79,4
31,LR,0,400,6,-76.8333333333333,-74,-79,5
31,LR,0,400,2,-75.5,-74,-77,3
31,LR,0,400,2,-76.5,-74,-79,5
31,LR,0,400,3,-78,-77,-79,2
31,LR,0,400,6,-76.8333333333333,-72,-79,7
31,LR,0,400,1,-78,-78,-78,0
31,LR,0,400,3,-75,-72,-77,5
31,LR,0,400,1,-77,-77,-77,0
31,LR,0,400,7,-76.8571428571429,-73,-80,7
31,LR,0,400,1,-79,-79,-79,0
31,LR,0,400,2,-73.5,-73,-74,1
31,LR,0,400,2,-76,-74,-78,4
31,LR,0,400,5,-79,-78,-81,3
31,LR,0,400,6,-78.1666666666667,-74,-81,7
31,LR,0,400,8,-78,-74,-81,7
31,LR,0,400,1,-81,-81,-81,0
31,LR,0,400,3,-76.6666666666667,-74,-78,4
31,LR,0,400,6,-78.1666666666667,-75,-81,6
31,LR,0,400,2,-78.5,-78,-79,1
31,LR,1,400,10,-76.9,-73,-86,13
31,LR,0,400,2,-74.5,-74,-75,1
31,LR,0,400,5,-75.2,-73,-78,5
31,LR,0,400,3,-76,-73,-78,5
31,LR,0,400,7,-78.1428571428571,-73,-86,13
31,LR,0,400,8,-78,-73,-86,13
31,LR,1,400,10,-78.1,-73,-86,13
31,LR,0,400,3,-78.6666666666667,-74,-82,8
31,LR,0,400,3,-78,-74,-82,8
31,LR,0,400,5,-75,-73,-78,5
31,LR,0,400,1,-78,-78,-78,0
31,LR,0,400,2,-74,-73,-75,2
31,LR,0,400,1,-75,-75,-75,0
31,LR,0,400,2,-80,-80,-80,0
31,LR,0,400,4,-78.25,-74,-81,7
31,LR,1,400,9,-77.3333333333333,-73,-86,13
31,LR,0,400,7,-77.2857142857143,-73,-86,13
31,LR,0,400,7,-77.2857142857143,-73,-86,13
31,LR,1,400,10,-78,-73,-86,13
31,LR,0,400,3,-74.3333333333333,-74,-75,1
31,LR,0,400,2,-74,-74,-74,0
31,LR,0,400,7,-78.5714285714286,-74,-85,11
31,LR,0,400,6,-78.1666666666667,-74,-85,11
31,LR,0,400,6,-77.3333333333333,-74,-80,6
31,LR,1,400,10,-75.8,-73,-80,7
31,LR,0,400,2,-76,-75,-77,2
31,LR,0,400,4,-75.5,-73,-80,7
31,LR,0,400,5,-75.8,-73,-80,7
31,LR,1,400,9,-76.1111111111111,-73,-86,13
31,LR,0,400,1,-74,-74,-74,0
31,LR,1,400,10,-78,-73,-88,15
31,LR,0,400,5,-77.2,-73,-86,13
31,LR,1,400,9,-78.5555555555556,-73,-88,15
31,LR,1,400,10,-79,-73,-88,15
31,LR,0,400,2,-76,-73,-79,6
31,LR,0,400,8,-79,-75,-88,13
31,LR,0,400,1,-75,-75,-75,0
31,LR,0,400,7,-80.2857142857143,-75,-88,13
31,LR,0,400,5,-78,-75,-79,4
31,LR,1,400,9,-79.4444444444444,-74,-91,17
31,LR,0,400,5,-78,-74,-84,10
31,LR,0,400,6,-78.3333333333333,-74,-84,10
31,LR,0,400,4,-77.5,-74,-83,9
31,LR,0,400,4,-75.75,-74,-79,5
31,LR,0,400,3,-76.3333333333333,-74,-79,5
31,LR,0,400,6,-81.3333333333333,-76,-91,15
31,LR,0,400,7,-79.5714285714286,-74,-91,17
31,LR,0,400,8,-78.375,-73,-91,18
31,LR,0,400,4,-79,-74,-83,9
31,LR,0,400,8,-76,-73,-82,9
31,LR,0,400,1,-77,-77,-77,0
31,LR,0,400,1,-74,-74,-74,0
31,LR,0,400,2,-73,-73,-73,0
31,LR,0,400,7,-74.7142857142857,-71,-82,11
31,LR,1,400,9,-75.2222222222222,-71,-82,11
31,LR,0,400,8,-75.5,-71,-82,11
31,LR,0,400,1,-72,-72,-72,0
31,LR,0,400,5,-74.2,-71,-82,11
31,LR,1,400,10,-75.4,-72,-82,10
31,LR,0,400,4,-75,-72,-82,10
31,LR,0,400,8,-74.875,-72,-81,9
31,LR,1,400,9,-75.6666666666667,-72,-83,11
31,LR,1,400,9,-75.7777777777778,-72,-83,11
31,LR,0,400,3,-75.6666666666667,-73,-81,8
31,LR,0,400,7,-76.5714285714286,-72,-83,11
31,LR,0,400,8,-77.375,-72,-83,11
31,LR,0,400,8,-76.375,-72,-83,11
31,LR,0,400,6,-77.5,-72,-83,11
31,LR,1,400,10,-77.2,-73,-84,11
31,LR,0,400,3,-76.3333333333333,-73,-83,10
31,LR,1,400,9,-76.5555555555556,-73,-84,11
31,LR,0,400,6,-76.6666666666667,-73,-84,11
31,LR,0,400,8,-76.625,-73,-84,11
31,LR,0,400,7,-75.5714285714286,-73,-84,11
31,LR,0,400,8,-74.125,-73,-80,7
31,LR,0,400,1,-73,-73,-73,0
31,LR,0,400,7,-74.5714285714286,-73,-80,7
31,LR,1,400,9,-76.1111111111111,-73,-86,13
31,LR,1,400,9,-76.3333333333333,-73,-86,13
31,LR,0,400,1,-73,-73,-73,0
31,LR,0,400,4,-77.75,-75,-86,11
31,LR,0,400,3,-75,-75,-75,0
31,LR,1,400,10,-75.1,-73,-78,5
31,LR,0,400,3,-75.3333333333333,-73,-77,4
31,LR,0,400,8,-74.375,-73,-76,3
31,LR,0,400,6,-74.5,-73,-76,3
31,LR,0,400,1,-73,-73,-73,0
31,LR,0,400,5,-75,-73,-76,3
31,LR,0,400,8,-74.125,-72,-77,5
31,LR,0,400,5,-74.8,-73,-77,4
31,LR,0,400,8,-73.875,-72,-77,5
31,LR,1,400,10,-73.7,-72,-77,5
31,LR,0,400,7,-73.2857142857143,-72,-77,5
31,LR,0,400,1,-73,-73,-73,0
31,LR,0,400,5,-73.4,-72,-76,4
31,LR,0,400,6,-74.1666666666667,-72,-77,5
31,LR,0,400,8,-74.25,-72,-77,5
31,LR,0,400,6,-74.5,-73,-77,4
31,LR,0,400,6,-74.8333333333333,-73,-77,4
31,LR,1,400,9,-74.6666666666667,-73,-77,4
31,LR,0,400,3,-75,-73,-77,4
31,LR,1,400,9,-74.7777777777778,-73,-76,3
31,LR,0,400,6,-74.5,-73,-76,3
31,LR,0,400,6,-74.8333333333333,-73,-76,3
31,LR,0,400,6,-75,-73,-76,3
31,LR,1,400,9,-74.6666666666667,-73,-76,3
31,LR,0,400,1,-75,-75,-75,0
31,LR,0,400,3,-75,-74,-76,2
31,LR,0,400,4,-74.75,-73,-76,3
31,LR,1,400,10,-74.3,-73,-78,5
31,LR,0,400,8,-74.5,-73,-78,5
31,LR,1,400,10,-74.2,-73,-78,5
31,LR,0,400,7,-74.2857142857143,-73,-78,5
31,LR,0,400,3,-75.3333333333333,-73,-78,5
31,LR,0,400,5,-74.8,-73,-78,5
31,LR,0,400,7,-74.8571428571429,-73,-80,7
31,LR,0,400,8,-75.75,-74,-80,6
31,LR,1,400,10,-76.4,-73,-85,12
31,LR,0,400,8,-77,-73,-85,12
31,LR,0,400,8,-77.875,-73,-85,12
31,LR,0,400,8,-76.875,-72,-85,13
31,LR,0,400,2,-77.5,-75,-80,5
31,LR,0,400,2,-74,-73,-75,2
31,LR,0,400,4,-78.25,-73,-85,12
31,LR,0,400,6,-76.6666666666667,-72,-85,13
31,LR,0,400,7,-77.2857142857143,-72,-85,13
31,LR,0,400,2,-76.5,-72,-81,9
31,LR,0,400,5,-75,-72,-78,6
31,LR,0,400,4,-75.75,-72,-78,6
31,LR,1,400,10,-75.9,-71,-81,10
31,LR,0,400,6,-76,-71,-81,10
31,LR,0,400,2,-77.5,-75,-80,5
31,LR,0,400,5,-76.4,-71,-81,10
31,LR,1,400,10,-76.1,-71,-84,13
31,LR,0,400,7,-76.7142857142857,-73,-84,11
31,LR,0,400,3,-74,-73,-75,2
31,LR,0,400,3,-75.6666666666667,-74,-79,5
31,LR,0,400,7,-77.8571428571429,-72,-90,18
31,LR,0,400,8,-76.75,-72,-90,18
31,LR,1,400,9,-76.4444444444444,-72,-90,18
31,LR,0,400,1,-72,-72,-72,0
31,LR,0,400,2,-73,-72,-74,2
31,LR,0,400,1,-74,-74,-74,0
31,LR,0,400,2,-82,-74,-90,16
31,LR,1,400,9,-75.5555555555556,-72,-86,14
31,LR,0,400,7,-76,-72,-86,14
31,LR,0,400,2,-80.5,-75,-86,11
31,LR,1,400,9,-75.4444444444444,-72,-80,8
31,LR,0,400,7,-75.8571428571429,-72,-80,8
31,LR,0,400,3,-74.3333333333333,-74,-75,1
31,LR,1,400,10,-76.4,-73,-82,9
31,LR,0,400,3,-77.3333333333333,-74,-80,6
31,LR,0,400,5,-77.4,-73,-80,7
31,LR,1,400,10,-76.1,-73,-82,9
31,LR,0,400,6,-76.3333333333333,-73,-82,9
31,LR,0,400,7,-75.7142857142857,-73,-82,9
31,LR,0,400,6,-75.3333333333333,-73,-82,9
31,LR,0,400,7,-75,-73,-82,9
31,LR,0,400,1,-74,-74,-74,0
31,LR,0,400,2,-75,-73,-77,4
31,LR,1,400,9,-75.4444444444444,-73,-82,9
31,LR,0,400,7,-76.1428571428571,-73,-82,9
31,LR,0,400,6,-76.6666666666667,-73,-82,9
31,LR,0,400,1,-75,-75,-75,0
31,LR,0,400,5,-77,-73,-82,9
31,LR,0,400,7,-76.2857142857143,-73,-82,9
31,LR,1,400,10,-76.4,-73,-83,10
31,LR,0,400,4,-76,-73,-82,9
31,LR,0,400,5,-76,-73,-83,10
31,LR,0,400,8,-76.25,-73,-83,10
31,LR,0,400,7,-76.2857142857143,-73,-83,10
31,LR,1,400,10,-77.3,-73,-88,15
31,LR,0,400,1,-80,-80,-80,0
31,LR,0,400,6,-76.1666666666667,-73,-84,11
31,LR,0,400,2,-75,-73,-77,4
31,LR,0,400,1,-77,-77,-77,0
31,LR,0,400,6,-80,-73,-88,15
31,LR,0,400,6,-79,-73,-88,15
31,LR,0,400,1,-87,-87,-87,0
31,LR,0,400,8,-76.25,-73,-85,12
31,LR,0,400,6,-77.1666666666667,-74,-85,11
31,LR,0,400,3,-75.3333333333333,-74,-78,4
31,LR,0,400,1,-74,-74,-74,0
31,LR,1,400,10,-78.8,-72,-87,15
31,LR,0,400,8,-79.25,-73,-87,14
31,LR,0,400,3,-76.6666666666667,-74,-80,6
31,LR,0,400,8,-77,-73,-81,8
31,LR,0,400,7,-76.5714285714286,-73,-81,8
31,LR,0,400,6,-76.6666666666667,-73,-81,8
31,LR,0,400,5,-77.4,-73,-81,8
31,LR,0,400,8,-78.875,-73,-92,19
31,LR,0,400,2,-74,-73,-75,2
31,LR,0,400,1,-75,-75,-75,0
31,LR,0,400,2,-76.5,-74,-79,5
31,LR,0,400,8,-81,-75,-92,17
31,LR,0,400,6,-81.8333333333333,-75,-92,17
31,LR,0,400,3,-79.3333333333333,-75,-86,11
31,LR,0,400,8,-79.125,-75,-92,17
31,LR,0,400,6,-79.1666666666667,-75,-92,17
31,LR,0,400,6,-80.8333333333333,-75,-92,17
31,LR,0,400,4,-80,-75,-92,17
31,LR,0,400,8,-80.625,-74,-92,18
31,LR,0,400,3,-85,-75,-92,17
31,LR,1,400,9,-81.8888888888889,-74,-96,22
31,LR,0,400,6,-79.6666666666667,-74,-91,17
31,LR,1,400,10,-81.2,-73,-96,23
31,LR,0,400,7,-81.8571428571429,-73,-96,23
31,LR,0,400,3,-81.6666666666667,-74,-96,22
31,LR,0,400,6,-77.1666666666667,-73,-90,17
31,LR,0,400,8,-77.625,-73,-90,17
31,LR,1,400,9,-78.4444444444444,-73,-90,17
31,LR,0,400,6,-78.3333333333333,-73,-87,14
31,LR,1,400,10,-77.4,-73,-87,14
31,LR,1,400,10,-77.3,-73,-87,14
31,LR,0,400,8,-77.375,-73,-87,14
31,LR,0,400,6,-76.1666666666667,-73,-87,14
31,LR,0,400,8,-79,-73,-91,18
31,LR,0,400,1,-73,-73,-73,0
31,LR,0,400,7,-80.7142857142857,-74,-92,18
31,LR,1,400,9,-79,-73,-92,19
31,LR,0,400,7,-80.1428571428571,-73,-92,19
31,LR,0,400,6,-79.8333333333333,-73,-92,19
31,LR,0,400,8,-78.25,-73,-92,19
31,LR,1,400,9,-80.4444444444444,-73,-95,22
31,LR,0,400,2,-83,-74,-92,18
31,LR,0,400,1,-74,-74,-74,0
31,LR,0,400,8,-79.125,-73,-95,22
31,LR,0,400,1,-74,-74,-74,0
31,LR,0,400,8,-79.875,-74,-95,21
31,LR,0,400,2,-74.5,-74,-75,1
31,LR,0,400,2,-74.5,-74,-75,1
31,LR,0,400,3,-78.3333333333333,-74,-86,12
31,LR,0,400,8,-79.375,-73,-91,18
31,LR,0,400,2,-80,-76,-84,8
31,LR,0,400,6,-79.1666666666667,-73,-91,18
31,LR,1,400,9,-79.3333333333333,-73,-91,18
31,LR,0,400,6,-77.6666666666667,-73,-85,12
31,LR,0,400,6,-78.8333333333333,-73,-85,12
31,LR,0,400,6,-79,-74,-85,11
31,LR,0,400,3,-77.3333333333333,-74,-84,10
31,LR,0,400,8,-79.875,-74,-94,20
31,LR,0,400,5,-79.8,-74,-94,20
31,LR,0,400,5,-75.8,-74,-81,7
31,LR,1,400,10,-76.8,-74,-81,7
31,LR,0,400,8,-75.875,-74,-80,6
31,LR,0,400,3,-75.6666666666667,-74,-78,4
31,LR,0,400,2,-76,-74,-78,4
31,LR,0,400,2,-79,-78,-80,2
31,LR,0,400,6,-76.8333333333333,-74,-80,6
31,LR,0,400,8,-77,-74,-82,8
31,LR,1,400,9,-77.5555555555556,-74,-82,8
31,LR,1,400,9,-77.7777777777778,-74,-82,8
31,LR,1,400,9,-77.8888888888889,-74,-82,8
31,LR,0,400,7,-77.8571428571429,-74,-82,8
31,LR,0,400,7,-77.7142857142857,-74,-81,7
31,LR,1,400,10,-78,-74,-81,7
31,LR,0,400,1,-75,-75,-75,0
31,LR,0,400,2,-79,-77,-81,4
31,LR,0,400,6,-78.1666666666667,-74,-81,7
31,LR,0,400,3,-76.6666666666667,-74,-81,7
31,LR,0,400,7,-78,-74,-81,7
31,LR,0,400,5,-78.2,-74,-81,7
31,LR,0,400,8,-77.5,-74,-81,7
31,LR,0,400,8,-77.5,-74,-81,7
31,LR,0,400,6,-77.5,-74,-81,7
31,LR,0,400,2,-81,-81,-81,0
31,LR,0,400,1,-80,-80,-80,0
31,LR,0,400,4,-77,-75,-81,6
31,LR,0,400,3,-75.3333333333333,-74,-76,2
31,LR,0,400,1,-74,-74,-74,0
31,LR,0,400,3,-82.3333333333333,-79,-86,7
31,LR,1,400,10,-78.2,-74,-86,12
31,LR,0,400,2,-90,-82,-98,16
31,LR,0,400,5,-83.8,-74,-98,24
26,RL,0,400,8,-77.125,-68,-93,25
26,RL,1,400,10,-78.8,-68,-93,25
26,RL,1,400,9,-80,-73,-93,20
26,RL,1,400,10,-81.6,-74,-93,19
26,RL,0,400,3,-77.3333333333333,-74,-82,8
26,RL,0,400,3,-83.6666666666667,-76,-93,17
26,RL,0,400,6,-84.5,-79,-93,14
26,RL,0,400,7,-84.5714285714286,-79,-93,14
26,RL,0,400,6,-83.1666666666667,-79,-89,10
26,RL,0,400,4,-84.25,-79,-89,10
26,RL,0,400,3,-82.6666666666667,-79,-85,6
26,RL,0,400,8,-82.75,-81,-85,4
26,RL,0,400,4,-81.75,-81,-83,2
26,RL,0,400,2,-81.5,-81,-82,1
26,RL,0,400,8,-83.75,-81,-91,10
26,RL,0,400,3,-82.3333333333333,-81,-83,2
26,RL,0,400,1,-83,-83,-83,0
26,RL,0,400,8,-84.5,-82,-91,9
26,RL,1,400,9,-84.6666666666667,-82,-91,9
26,RL,0,400,3,-83,-82,-84,2
26,RL,0,400,6,-84.3333333333333,-82,-86,4
26,RL,1,400,9,-84.6666666666667,-82,-86,4
26,RL,0,400,5,-84.6,-82,-86,4
26,RL,1,400,9,-84.4444444444444,-80,-86,6
26,RL,0,400,6,-84.1666666666667,-80,-86,6
26,RL,1,400,9,-83.8888888888889,-80,-86,6
26,RL,0,400,8,-83.625,-80,-86,6
26,RL,0,400,3,-84,-80,-86,6
26,RL,0,400,7,-82.8571428571429,-80,-86,6
26,RL,0,400,7,-83.2857142857143,-81,-86,5
26,RL,0,400,1,-81,-81,-81,0
26,RL,0,400,3,-83.6666666666667,-81,-85,4
26,RL,0,400,4,-82.75,-81,-85,4
26,RL,1,400,9,-82.8888888888889,-81,-85,4
26,RL,0,400,8,-82.625,-81,-85,4
26,RL,0,400,1,-85,-85,-85,0
26,RL,0,400,2,-82.5,-82,-83,1
26,RL,0,400,6,-82.6666666666667,-81,-86,5
26,RL,0,400,6,-83,-81,-86,5
26,RL,0,400,3,-82.6666666666667,-81,-86,5
26,RL,0,400,7,-84.1428571428571,-80,-89,9
26,RL,0,400,1,-84,-84,-84,0
26,RL,0,400,7,-83,-80,-89,9
26,RL,0,400,6,-82.5,-80,-89,9
26,RL,0,400,8,-81.75,-80,-85,5
26,RL,0,400,4,-80.75,-80,-82,2
26,RL,0,400,1,-82,-82,-82,0
26,RL,1,400,9,-81.8888888888889,-78,-85,7
26,RL,1,400,10,-82.2,-78,-85,7
26,RL,0,400,5,-81.8,-78,-85,7
26,RL,1,400,9,-82.3333333333333,-78,-85,7
26,RL,0,400,5,-82.6,-78,-85,7
26,RL,0,400,1,-83,-83,-83,0
26,RL,0,400,4,-81.75,-78,-84,6
26,RL,0,400,1,-84,-84,-84,0
26,RL,0,400,7,-81.8571428571429,-79,-85,6
26,RL,0,400,1,-81,-81,-81,0
26,RL,0,400,4,-81.5,-79,-85,6
26,RL,0,400,3,-81.6666666666667,-79,-83,4
26,RL,0,400,2,-81,-79,-83,4
26,RL,0,400,5,-84.6,-83,-86,3
26,RL,0,400,1,-83,-83,-83,0
26,RL,0,400,2,-85.5,-85,-86,1
26,RL,1,400,10,-82.7,-79,-86,7
26,RL,1,400,10,-82.3,-79,-85,6
26,RL,0,400,7,-82,-79,-85,6
26,RL,0,400,7,-82.2857142857143,-79,-85,6
26,RL,0,400,8,-82.125,-79,-85,6
26,RL,0,400,7,-82,-79,-85,6
26,RL,0,400,5,-82.6,-80,-85,5
26,RL,0,400,7,-82.7142857142857,-81,-85,4
26,RL,0,400,1,-84,-84,-84,0
26,RL,0,400,6,-81.1666666666667,-78,-84,6
26,RL,0,400,6,-80.6666666666667,-78,-84,6
26,RL,0,400,4,-80.5,-78,-82,4
26,RL,0,400,7,-79.8571428571429,-78,-82,4
26,RL,0,400,6,-79.6666666666667,-78,-82,4
26,RL,0,400,7,-79.7142857142857,-78,-82,4
26,RL,0,400,3,-79.6666666666667,-78,-82,4
26,RL,1,400,10,-81,-79,-84,5
26,RL,0,400,2,-80.5,-79,-82,3
26,RL,0,400,2,-79.5,-79,-80,1
26,RL,1,400,10,-81.5,-80,-84,4
26,RL,0,400,1,-83,-83,-83,0
26,RL,1,400,10,-82.1,-80,-84,4
26,RL,0,400,2,-81,-81,-81,0
26,RL,0,400,1,-81,-81,-81,0
26,RL,0,400,2,-81,-80,-82,2
26,RL,0,400,5,-82.2,-80,-84,4
26,RL,1,400,10,-81.6,-80,-84,4
26,RL,0,400,6,-81.8333333333333,-80,-84,4
26,RL,0,400,5,-81.4,-80,-84,4
26,RL,1,400,9,-81.5555555555556,-80,-84,4
26,RL,0,400,8,-81.5,-80,-84,4
26,RL,0,400,3,-81.6666666666667,-80,-84,4
26,RL,1,400,10,-82,-80,-84,4
26,RL,1,400,9,-82.5555555555556,-80,-88,8
26,RL,1,400,9,-83.4444444444444,-80,-88,8
26,RL,0,400,2,-82.5,-82,-83,1
26,RL,1,400,9,-84.4444444444444,-80,-88,8
26,RL,0,400,7,-85,-80,-88,8
26,RL,0,400,2,-82.5,-82,-83,1
26,RL,1,400,10,-85.6,-82,-89,7
26,RL,0,400,3,-86,-84,-88,4
26,RL,1,400,9,-84.2222222222222,-82,-89,7
26,RL,1,400,10,-84.2,-82,-89,7
26,RL,0,400,2,-86.5,-84,-89,5
26,RL,1,400,10,-84.2,-82,-88,6
26,RL,0,400,7,-84.2857142857143,-82,-88,6
26,RL,0,400,5,-84,-82,-85,3
26,RL,0,400,4,-84.5,-84,-85,1
26,RL,0,400,3,-84.3333333333333,-84,-85,1
26,RL,0,400,1,-84,-84,-84,0
26,RL,0,400,6,-85.5,-84,-88,4
26,RL,1,400,10,-85.5,-84,-88,4
26,RL,0,400,8,-85.875,-84,-88,4
26,RL,0,400,7,-86,-84,-88,4
26,RL,0,400,2,-85,-84,-86,2
26,RL,0,400,3,-86.3333333333333,-85,-88,3
26,RL,0,400,7,-86.8571428571429,-84,-92,8
26,RL,1,400,10,-86.8,-84,-92,8
26,RL,0,400,5,-87,-84,-92,8
26,RL,0,400,5,-87,-84,-92,8
26,RL,1,400,9,-87.1111111111111,-84,-92,8
26,RL,0,400,2,-89,-86,-92,6
26,RL,0,400,4,-87,-84,-91,7
26,RL,0,400,6,-86.8333333333333,-84,-91,7
26,RL,0,400,6,-87.3333333333333,-84,-92,8
26,RL,0,400,3,-89.6666666666667,-87,-92,5
26,RL,0,400,7,-85.5714285714286,-84,-90,6
26,RL,0,400,2,-84,-84,-84,0
26,RL,0,400,7,-86.5714285714286,-84,-90,6
26,RL,1,400,10,-86.7,-83,-90,7
26,RL,0,400,4,-88,-84,-90,6
26,RL,0,400,1,-84,-84,-84,0
26,RL,0,400,6,-87.6666666666667,-86,-89,3
26,RL,0,400,2,-87.5,-86,-89,3
26,RL,0,400,6,-85.6666666666667,-83,-88,5
26,RL,0,400,1,-88,-88,-88,0
26,RL,1,400,9,-84.5555555555556,-83,-88,5
26,RL,1,400,10,-84.4,-83,-87,4
26,RL,0,400,4,-83.75,-83,-85,2
26,RL,0,400,6,-84,-83,-85,2
26,RL,0,400,6,-84.6666666666667,-84,-87,3
26,RL,0,400,3,-84,-84,-84,0
26,RL,1,400,10,-84.9,-84,-87,3
26,RL,0,400,3,-85,-84,-87,3
26,RL,0,400,4,-85,-84,-87,3
26,RL,0,400,8,-84.75,-81,-87,6
26,RL,1,400,9,-84.6666666666667,-81,-92,11
26,RL,0,400,1,-84,-84,-84,0
26,RL,0,400,5,-83.4,-81,-87,6
26,RL,0,400,4,-82.5,-81,-86,5
26,RL,0,400,4,-83.5,-79,-92,13
26,RL,0,400,8,-83.5,-79,-92,13
26,RL,0,400,1,-92,-92,-92,0
26,RL,0,400,1,-79,-79,-79,0
26,RL,0,400,2,-82.5,-82,-83,1
26,RL,1,400,10,-84.8,-81,-90,9
26,RL,0,400,5,-83.8,-81,-86,5
26,RL,0,400,7,-84.8571428571429,-83,-87,4
26,RL,0,400,6,-84.8333333333333,-83,-87,4
26,RL,0,400,3,-85.3333333333333,-83,-87,4
26,RL,0,400,2,-86.5,-86,-87,1
26,RL,0,400,8,-86.25,-84,-90,6
26,RL,0,400,8,-86.25,-84,-90,6
26,RL,0,400,2,-87,-84,-90,6
26,RL,0,400,3,-86.3333333333333,-84,-90,6
26,RL,0,400,1,-88,-88,-88,0
26,RL,0,400,7,-90.7142857142857,-86,-98,12
26,RL,0,400,5,-91.2,-86,-98,12
26,RL,1,400,9,-88.6666666666667,-83,-96,13
26,RL,0,400,2,-89,-86,-92,6
26,RL,0,400,7,-87.7142857142857,-83,-92,9
26,RL,1,400,10,-85.3,-80,-91,11
26,RL,1,400,9,-84.6666666666667,-80,-90,10
26,RL,1,400,9,-85.5555555555556,-80,-91,11
26,RL,0,400,5,-85.4,-80,-89,9
26,RL,0,400,4,-85.5,-80,-89,9
26,RL,0,400,6,-83.8333333333333,-80,-91,11
26,RL,1,400,10,-84.9,-81,-91,10
26,RL,0,400,4,-83.5,-81,-91,10
26,RL,0,400,4,-83.75,-81,-91,10
26,RL,0,400,8,-85.125,-81,-89,8
26,RL,0,400,3,-86,-82,-89,7
26,RL,1,400,9,-85.8888888888889,-81,-91,10
26,RL,0,400,7,-86.2857142857143,-81,-91,10
26,RL,0,400,5,-86.4,-84,-87,3
26,RL,0,400,3,-87,-87,-87,0
26,RL,0,400,2,-87,-87,-87,0
26,RL,0,400,2,-85.5,-84,-87,3
26,RL,0,400,1,-91,-91,-91,0
26,RL,0,400,5,-84,-82,-88,6
26,RL,0,400,2,-85,-82,-88,6
26,RL,0,400,6,-86,-84,-90,6
26,RL,0,400,4,-85.5,-84,-90,6
26,RL,0,400,1,-84,-84,-84,0
26,RL,0,400,6,-84.5,-83,-86,3
26,RL,0,400,6,-85.8333333333333,-83,-92,9
26,RL,0,400,8,-85.875,-83,-92,9
26,RL,1,400,9,-86,-83,-92,9
26,RL,0,400,5,-86.4,-84,-92,8
26,RL,1,400,10,-85.9,-81,-92,11
26,RL,0,400,8,-86,-81,-92,11
26,RL,0,400,7,-85.1428571428571,-81,-87,6
26,RL,1,400,9,-85.8888888888889,-81,-90,9
26,RL,0,400,4,-84.5,-81,-87,6
26,RL,0,400,5,-84.8,-81,-87,6
26,RL,0,400,6,-85.3333333333333,-81,-90,9
26,RL,0,400,2,-86.5,-86,-87,1
26,RL,1,400,9,-85.1111111111111,-81,-90,9
26,RL,0,400,2,-88,-86,-90,4
26,RL,0,400,1,-90,-90,-90,0
26,RL,0,400,6,-84,-81,-86,5
26,RL,0,400,5,-84.4,-81,-86,5
26,RL,0,400,1,-86,-86,-86,0
26,RL,1,400,9,-84.8888888888889,-81,-88,7
26,RL,0,400,2,-82.5,-81,-84,3
26,RL,0,400,5,-85.2,-84,-88,4
26,RL,0,400,2,-84.5,-84,-85,1
26,RL,0,400,7,-86,-84,-90,6
26,RL,0,400,8,-86,-84,-90,6
26,RL,0,400,7,-86.1428571428571,-84,-90,6
26,RL,0,400,5,-86,-84,-90,6
26,RL,1,400,9,-85.6666666666667,-82,-90,8
26,RL,0,400,6,-85.8333333333333,-84,-90,6
26,RL,0,400,5,-86,-84,-90,6
26,RL,0,400,4,-86.25,-84,-90,6
26,RL,0,400,8,-84.375,-80,-88,8
26,RL,1,400,9,-83.6666666666667,-80,-88,8
26,RL,0,400,1,-84,-84,-84,0
26,RL,0,400,7,-83.1428571428571,-80,-88,8
26,RL,0,400,8,-83.5,-80,-88,8
26,RL,0,400,5,-83.6,-80,-88,8
26,RL,0,400,5,-83.2,-80,-88,8
26,RL,1,400,9,-81.5555555555556,-79,-86,7
26,RL,0,400,2,-83,-80,-86,6
26,RL,1,400,10,-81.8,-79,-86,7
26,RL,0,400,6,-81,-79,-85,6
26,RL,0,400,7,-80.8571428571429,-79,-85,6
26,RL,0,400,4,-80,-79,-82,3
26,RL,0,400,5,-81,-79,-84,5
26,RL,0,400,8,-81,-78,-84,6
26,RL,0,400,3,-80.6666666666667,-78,-84,6
26,RL,0,400,4,-81.5,-78,-84,6
26,RL,0,400,3,-80.6666666666667,-78,-84,6
26,RL,1,400,9,-80.5555555555556,-78,-84,6
26,RL,0,400,1,-80,-80,-80,0
26,RL,0,400,6,-79.8333333333333,-78,-82,4
26,RL,0,400,5,-79.4,-78,-82,4
26,RL,0,400,2,-78,-78,-78,0
26,RL,0,400,5,-82.4,-80,-84,4
26,RL,0,400,1,-83,-83,-83,0
26,RL,0,400,5,-83.6,-80,-86,6
26,RL,0,400,1,-84,-84,-84,0
26,RL,0,400,1,-82,-82,-82,0
26,RL,0,400,2,-86,-86,-86,0
26,RL,0,400,4,-88.5,-86,-90,4
26,RL,0,400,3,-89.3333333333333,-88,-90,2
26,RL,1,400,9,-84.8888888888889,-79,-91,12
26,RL,1,400,10,-84.6,-79,-91,12
26,RL,0,400,7,-83.2857142857143,-79,-90,11
26,RL,0,400,8,-83.375,-79,-86,7
26,RL,0,400,8,-84,-79,-86,7
26,RL,0,400,6,-84.5,-80,-86,6
26,RL,0,400,5,-85.4,-83,-86,3
26,RL,0,400,7,-86.1428571428571,-83,-90,7
26,RL,0,400,3,-86,-86,-86,0
26,RL,1,400,9,-85.4444444444444,-80,-90,10
26,RL,0,400,2,-86,-86,-86,0
26,RL,0,400,8,-85.375,-80,-90,10
26,RL,0,400,6,-85.1666666666667,-80,-90,10
26,RL,1,400,10,-85.9,-80,-93,13
26,RL,0,400,7,-84.8571428571429,-80,-89,9
26,RL,1,400,9,-85.3333333333333,-78,-93,15
26,RL,1,400,10,-84.6,-78,-93,15
26,RL,0,400,3,-86.6666666666667,-78,-93,15
26,RL,0,400,8,-80.75,-75,-88,13
26,RL,0,400,3,-80.6666666666667,-78,-82,4
26,RL,1,400,9,-80.7777777777778,-75,-86,11
26,RL,1,400,9,-80.4444444444444,-75,-86,11
26,RL,0,400,1,-83,-83,-83,0
26,RL,0,400,2,-77.5,-75,-80,5
26,RL,0,400,4,-79,-75,-86,11
26,RL,1,400,9,-79.6666666666667,-75,-86,11
26,RL,0,400,7,-80.4285714285714,-75,-86,11
26,RL,0,400,2,-80.5,-77,-84,7
26,RL,0,400,3,-82.6666666666667,-79,-85,6
26,RL,0,400,8,-80.125,-75,-86,11
26,RL,0,400,3,-76,-75,-77,2
26,RL,1,400,10,-79.2,-75,-86,11
26,RL,0,400,4,-82.5,-77,-91,14
26,RL,0,400,7,-78.5714285714286,-75,-85,10
26,RL,1,400,10,-80.2,-75,-91,16
26,RL,0,400,5,-81.2,-76,-91,15
26,RL,0,400,1,-83,-83,-83,0
26,RL,0,400,3,-81.3333333333333,-80,-83,3
26,LR,0,400,8,-83.625,-77,-94,17
26,LR,1,400,9,-85.2222222222222,-77,-94,17
26,LR,0,400,4,-85,-80,-94,14
26,LR,0,400,5,-88.4,-82,-94,12
26,LR,0,400,6,-90.3333333333333,-87,-94,7
26,LR,0,400,3,-90,-88,-92,4
26,LR,1,400,10,-81.1,-72,-98,26
26,LR,0,400,5,-82.8,-74,-98,24
26,LR,0,400,5,-79,-73,-88,15
26,LR,0,400,6,-76.5,-72,-85,13
26,LR,0,400,1,-75,-75,-75,0
26,LR,0,400,6,-76.1666666666667,-72,-85,13
26,LR,0,400,2,-76,-72,-80,8
26,LR,0,400,8,-74.875,-72,-80,8
26,LR,1,400,9,-74.3333333333333,-72,-77,5
26,LR,0,400,2,-72.5,-72,-73,1
26,LR,0,400,6,-74.8333333333333,-73,-77,4
26,LR,0,400,2,-74.5,-73,-76,3
26,LR,1,400,10,-75.7,-73,-80,7
26,LR,1,400,9,-76,-73,-80,7
26,LR,0,400,3,-75.6666666666667,-73,-77,4
26,LR,0,400,3,-74.3333333333333,-73,-77,4
26,LR,0,400,4,-76.5,-73,-80,7
26,LR,0,400,2,-78,-76,-80,4
26,LR,0,400,8,-76.25,-73,-80,7
26,LR,0,400,1,-73,-73,-73,0
26,LR,1,400,9,-76.1111111111111,-73,-80,7
26,LR,0,400,6,-76.5,-73,-80,7
26,LR,0,400,8,-76.125,-73,-80,7
26,LR,0,400,7,-76.1428571428571,-73,-80,7
26,LR,0,400,1,-80,-80,-80,0
26,LR,0,400,4,-76,-73,-78,5
26,LR,1,400,10,-74.6,-72,-78,6
26,LR,0,400,8,-74.625,-72,-78,6
26,LR,0,400,7,-75,-72,-78,6
26,LR,1,400,10,-75.1,-72,-78,6
26,LR,0,400,4,-75.5,-73,-78,5
26,LR,1,400,9,-75.1111111111111,-72,-78,6
26,LR,0,400,3,-75,-73,-78,5
26,LR,0,400,5,-75.4,-72,-78,6
26,LR,0,400,1,-76,-76,-76,0
26,LR,0,400,4,-74.5,-72,-77,5
26,LR,0,400,2,-75,-73,-77,4
26,LR,0,400,2,-74.5,-73,-76,3
26,LR,1,400,10,-75.1,-72,-78,6
26,LR,0,400,1,-73,-73,-73,0
26,LR,1,400,10,-76.1,-72,-79,7
26,LR,0,400,6,-75.5,-72,-78,6
26,LR,1,400,10,-76,-72,-79,7
26,LR,0,400,5,-76.6,-73,-79,6
26,LR,0,400,5,-76.6,-73,-79,6
26,LR,0,400,1,-76,-76,-76,0
26,LR,0,400,1,-79,-79,-79,0
26,LR,0,400,5,-76.2,-73,-78,5
26,LR,0,400,7,-76,-72,-78,6
26,LR,0,400,2,-75,-73,-77,4
26,LR,1,400,9,-75.5555555555556,-72,-78,6
26,LR,0,400,7,-75.7142857142857,-72,-78,6
26,LR,0,400,5,-75.2,-72,-78,6
26,LR,0,400,6,-74.8333333333333,-72,-78,6
26,LR,0,400,6,-75.6666666666667,-72,-78,6
26,LR,0,400,1,-72,-72,-72,0
26,LR,1,400,10,-76,-73,-80,7
26,LR,0,400,8,-76.125,-73,-80,7
26,LR,0,400,4,-75,-73,-77,4
26,LR,0,400,5,-76.2,-74,-80,6
26,LR,1,400,10,-75.6,-72,-80,8
26,LR,0,400,6,-75.3333333333333,-72,-80,8
26,LR,0,400,7,-75.5714285714286,-72,-80,8
26,LR,0,400,4,-74.5,-72,-77,5
26,LR,0,400,7,-75.5714285714286,-72,-78,6
26,LR,0,400,2,-73.5,-72,-75,3
26,LR,0,400,3,-74.3333333333333,-72,-78,6
26,LR,0,400,2,-75.5,-73,-78,5
26,LR,0,400,4,-77,-76,-78,2
26,LR,0,400,6,-75.8333333333333,-74,-77,3
26,LR,0,400,8,-77.875,-74,-90,16
26,LR,0,400,7,-78,-74,-90,16
26,LR,1,400,10,-78,-74,-90,16
26,LR,0,400,1,-74,-74,-74,0
26,LR,0,400,5,-80,-75,-90,15
26,LR,0,400,1,-75,-75,-75,0
26,LR,0,400,3,-82.6666666666667,-78,-90,12
26,LR,0,400,7,-78.8571428571429,-74,-83,9
26,LR,0,400,1,-78,-78,-78,0
26,LR,0,400,3,-77.3333333333333,-74,-83,9
26,LR,0,400,4,-79.75,-74,-83,9
26,LR,1,400,9,-77.4444444444444,-72,-83,11
26,LR,0,400,6,-77.5,-73,-83,10
26,LR,0,400,3,-76.6666666666667,-73,-83,10
26,LR,0,400,1,-74,-74,-74,0
26,LR,0,400,1,-83,-83,-83,0
26,LR,0,400,4,-73.5,-72,-77,5
26,LR,1,400,9,-74,-72,-78,6
26,LR,0,400,6,-73,-72,-75,3
26,LR,0,400,8,-74.875,-72,-81,9
26,LR,0,400,8,-75,-73,-81,8
26,LR,1,400,10,-76,-72,-82,10
26,LR,0,400,2,-77,-73,-81,8
26,LR,0,400,3,-73.3333333333333,-73,-74,1
26,LR,0,400,3,-76.3333333333333,-73,-82,9
26,LR,0,400,2,-73.5,-72,-75,3
26,LR,0,400,8,-76,-72,-86,14
26,LR,0,400,4,-78.75,-72,-86,14
26,LR,0,400,2,-82,-78,-86,8
26,LR,0,400,6,-76,-73,-82,9
26,LR,0,400,4,-74,-73,-75,2
26,LR,0,400,8,-75.75,-72,-82,10
26,LR,0,400,7,-76.1428571428571,-72,-82,10
26,LR,1,400,9,-76.6666666666667,-72,-82,10
26,LR,0,400,4,-76.75,-72,-82,10
26,LR,1,400,9,-76.5555555555556,-72,-84,12
26,LR,0,400,8,-77.125,-72,-84,12
26,LR,0,400,6,-76.6666666666667,-72,-80,8
26,LR,0,400,5,-76,-72,-79,7
26,LR,0,400,7,-77.1428571428571,-73,-84,11
26,LR,1,400,10,-77.1,-72,-84,12
26,LR,1,400,9,-77.4444444444444,-72,-84,12
26,LR,0,400,8,-77.5,-72,-84,12
26,LR,0,400,3,-75,-73,-77,4
26,LR,0,400,8,-76.375,-72,-82,10
26,LR,0,400,4,-78.75,-76,-82,6
26,LR,0,400,1,-76,-76,-76,0
26,LR,0,400,6,-75.3333333333333,-72,-79,7
26,LR,0,400,7,-76.7142857142857,-72,-80,8
26,LR,0,400,2,-74.5,-72,-77,5
26,LR,0,400,6,-77,-73,-80,7
26,LR,1,400,10,-75.6,-72,-80,8
26,LR,0,400,2,-76.5,-73,-80,7
26,LR,0,400,4,-73.25,-72,-74,2
26,LR,0,400,7,-73.4285714285714,-71,-79,8
26,LR,1,400,10,-74.2,-71,-79,8
26,LR,0,400,3,-75.3333333333333,-73,-79,6
26,LR,0,400,6,-74.3333333333333,-71,-79,8
26,LR,0,400,5,-74.6,-71,-79,8
26,LR,0,400,5,-74.4,-71,-79,8
26,LR,0,400,2,-71.5,-71,-72,1
26,LR,0,400,3,-76.3333333333333,-72,-79,7
26,LR,0,400,5,-76.6,-72,-82,10
26,LR,0,400,5,-77.8,-72,-82,10
26,LR,0,400,8,-77.75,-72,-82,10
26,LR,0,400,5,-79.6,-73,-82,9
26,LR,0,400,6,-78,-72,-82,10
26,LR,0,400,8,-76.75,-72,-83,11
26,LR,0,400,4,-76.25,-72,-80,8
26,LR,0,400,6,-76.6666666666667,-72,-83,11
26,LR,1,400,10,-76.2,-72,-83,11
26,LR,0,400,1,-72,-72,-72,0
26,LR,0,400,6,-76,-72,-83,11
26,LR,1,400,9,-76,-72,-83,11
26,LR,0,400,6,-77.5,-72,-83,11
26,LR,0,400,5,-76.4,-72,-83,11
26,LR,1,400,10,-76.2,-72,-83,11
26,LR,0,400,8,-75.25,-72,-82,10
26,LR,0,400,3,-75.6666666666667,-72,-82,10
26,LR,0,400,7,-75,-73,-79,6
26,LR,0,400,3,-76,-74,-79,5
26,LR,0,400,5,-75.6,-73,-79,6
26,LR,0,400,1,-75,-75,-75,0
26,LR,0,400,8,-74.125,-72,-77,5
26,LR,1,400,9,-73.4444444444444,-72,-76,4
26,LR,0,400,1,-76,-76,-76,0
26,LR,0,400,8,-73,-72,-75,3
26,LR,0,400,8,-73.125,-72,-75,3
26,LR,1,400,10,-73.2,-72,-75,3
26,LR,0,400,4,-73.25,-72,-75,3
26,LR,0,400,7,-73.4285714285714,-72,-75,3
26,LR,1,400,10,-73.1,-72,-76,4
26,LR,0,400,5,-73.4,-72,-75,3
26,LR,0,400,2,-73.5,-72,-75,3
26,LR,0,400,3,-72,-72,-72,0
26,LR,0,400,3,-73.3333333333333,-72,-76,4
26,LR,0,400,1,-76,-76,-76,0
26,LR,1,400,10,-73.5,-72,-79,7
26,LR,0,400,8,-73.75,-72,-79,7
26,LR,0,400,6,-74.3333333333333,-72,-79,7
26,LR,1,400,10,-73.5,-72,-79,7
26,LR,0,400,1,-74,-74,-74,0
26,LR,0,400,8,-73.625,-72,-79,7
26,LR,0,400,3,-74.6666666666667,-72,-79,7
26,LR,0,400,2,-75.5,-72,-79,7
26,LR,1,400,9,-73.1111111111111,-72,-75,3
26,LR,1,400,10,-73.1,-72,-75,3
26,LR,0,400,1,-74,-74,-74,0
26,LR,0,400,7,-73.1428571428571,-72,-75,3
26,LR,1,400,10,-73.2,-72,-76,4
26,LR,1,400,10,-73.2,-72,-76,4
26,LR,0,400,2,-72.5,-72,-73,1
26,LR,0,400,1,-73,-73,-73,0
26,LR,0,400,1,-72,-72,-72,0
26,LR,0,400,4,-73.5,-72,-75,3
26,LR,0,400,2,-72.5,-72,-73,1
26,LR,0,400,3,-74,-72,-76,4
26,LR,1,400,10,-75.3,-72,-84,12
26,LR,0,400,2,-74.5,-73,-76,3
26,LR,0,400,7,-75.7142857142857,-72,-84,12
26,LR,0,400,4,-75.5,-72,-79,7
26,LR,1,400,9,-75.4444444444444,-72,-84,12
26,LR,0,400,3,-74,-72,-78,6
26,LR,0,400,3,-78,-72,-84,12
26,LR,0,400,6,-75,-72,-84,12
26,LR,0,400,7,-75.4285714285714,-72,-84,12
26,LR,1,400,9,-73.8888888888889,-72,-76,4
26,LR,0,400,1,-76,-76,-76,0
26,LR,1,400,10,-75,-72,-80,8
26,LR,0,400,7,-75.1428571428571,-73,-80,7
26,LR,0,400,6,-75,-73,-80,7
26,LR,0,400,5,-76,-72,-80,8
26,LR,0,400,1,-75,-75,-75,0
26,LR,1,400,9,-75,-72,-81,9
26,LR,1,400,10,-77.1,-72,-94,22
26,LR,0,400,2,-76,-72,-80,8
26,LR,0,400,2,-72.5,-72,-73,1
26,LR,1,400,10,-78.4,-72,-94,22
26,LR,1,400,10,-78.4,-72,-94,22
26,LR,0,400,3,-78.3333333333333,-72,-82,10
26,LR,0,400,2,-92,-90,-94,4
26,LR,0,400,6,-76.5,-72,-90,18
26,LR,0,400,7,-74.4285714285714,-72,-78,6
26,LR,0,400,2,-73,-72,-74,2
26,LR,0,400,1,-74,-74,-74,0
26,LR,1,400,10,-74.7,-72,-78,6
26,LR,0,400,5,-74.6,-72,-78,6
26,LR,0,400,5,-73.6,-72,-77,5
26,LR,1,400,10,-74.4,-72,-77,5
26,LR,0,400,3,-74,-72,-77,5
26,LR,0,400,2,-72.5,-72,-73,1
26,LR,0,400,4,-75,-73,-76,3
26,LR,0,400,6,-75,-72,-77,5
26,LR,1,400,9,-74.6666666666667,-72,-81,9
26,LR,0,400,2,-74.5,-74,-75,1
26,LR,0,400,4,-73.75,-72,-77,5
26,LR,0,400,2,-74.5,-72,-77,5
26,LR,1,400,10,-75.1,-72,-81,9
26,LR,1,400,10,-74.8,-72,-81,9
26,LR,0,400,4,-74.75,-72,-81,9
26,LR,0,400,8,-75,-73,-80,7
26,LR,0,400,1,-73,-73,-73,0
26,LR,0,400,2,-74,-73,-75,2
26,LR,0,400,5,-75.4,-72,-80,8
26,LR,0,400,6,-74.5,-72,-77,5
26,LR,0,400,8,-75.375,-72,-79,7
26,LR,0,400,5,-74.8,-72,-78,6
26,LR,0,400,1,-72,-72,-72,0
26,LR,0,400,3,-76,-73,-78,5
26,LR,1,400,9,-76.2222222222222,-73,-86,13
26,LR,0,400,5,-78.6,-73,-86,13
26,LR,0,400,8,-76.125,-73,-86,13
26,LR,0,400,3,-78.6666666666667,-73,-86,13
26,LR,1,400,10,-75.6,-72,-86,14
26,LR,0,400,7,-74.1428571428571,-72,-79,7
26,LR,0,400,2,-73.5,-73,-74,1
26,LR,0,400,8,-77.25,-71,-84,13
26,LR,0,400,8,-78.375,-71,-84,13
26,LR,1,400,10,-78.1,-71,-84,13
26,LR,1,400,10,-77.6,-71,-82,11
26,LR,0,400,4,-75.75,-71,-80,9
26,LR,0,400,1,-73,-73,-73,0
26,LR,1,400,9,-76.5555555555556,-71,-80,9
26,LR,0,400,7,-76.2857142857143,-71,-79,8
26,LR,0,400,6,-77.1666666666667,-75,-79,4
26,LR,0,400,3,-78.6666666666667,-78,-79,1
26,LR,0,400,7,-75.5714285714286,-74,-79,5
26,LR,0,400,6,-75,-74,-76,2
26,LR,0,400,1,-75,-75,-75,0
26,LR,0,400,3,-75,-74,-76,2
26,LR,0,400,1,-74,-74,-74,0
26,LR,0,400,3,-76,-74,-77,3
26,LR,1,400,10,-77.6,-73,-86,13
26,LR,0,400,5,-77.8,-77,-79,2
26,LR,0,400,7,-77.8571428571429,-73,-86,13
26,LR,0,400,2,-77.5,-77,-78,1
26,LR,0,400,6,-79,-73,-86,13
26,LR,0,400,1,-79,-79,-79,0
26,LR,0,400,7,-78.7142857142857,-73,-86,13
26,LR,0,400,1,-86,-86,-86,0
26,LR,1,400,10,-76.3,-72,-86,14
26,LR,0,400,2,-79.5,-74,-85,11
26,LR,0,400,8,-75.625,-72,-86,14
26,LR,1,400,9,-75.2222222222222,-72,-81,9
26,LR,0,400,2,-73,-73,-73,0
26,LR,0,400,8,-76.625,-72,-81,9
26,LR,0,400,8,-76.5,-72,-81,9
26,LR,0,400,8,-75.625,-72,-81,9
26,LR,0,400,7,-76.1428571428571,-73,-81,8
26,LR,1,400,9,-74.8888888888889,-73,-81,8
26,LR,0,400,8,-74.125,-73,-81,8
26,LR,0,400,8,-74.125,-73,-81,8
26,LR,0,400,2,-73,-73,-73,0
26,LR,0,400,5,-73,-73,-73,0
26,LR,1,400,9,-75.2222222222222,-72,-86,14
26,LR,0,400,4,-73,-73,-73,0
26,LR,0,400,4,-72.75,-72,-73,1
26,LR,0,400,2,-73,-73,-73,0
26,LR,0,400,7,-76.2857142857143,-72,-86,14
26,LR,0,400,5,-75.2,-73,-81,8
26,LR,0,400,4,-75.75,-73,-81,8
26,LR,0,400,2,-74.5,-74,-75,1
26,LR,0,400,4,-77.75,-73,-89,16
26,LR,0,400,1,-73,-73,-73,0
26,LR,0,400,4,-76.5,-73,-83,10
26,LR,1,400,9,-78.6666666666667,-73,-94,21
26,LR,0,400,7,-77.8571428571429,-73,-94,21
26,LR,0,400,4,-80.75,-73,-94,21
26,LR,0,400,8,-77,-72,-86,14
26,LR,0,400,2,-78,-74,-82,8
26,LR,0,400,1,-82,-82,-82,0
26,LR,0,400,1,-75,-75,-75,0
26,LR,0,400,1,-86,-86,-86,0
26,LR,0,400,4,-74.25,-72,-79,7
26,LR,0,400,8,-75.375,-72,-79,7
26,LR,0,400,4,-75.5,-72,-79,7
26,LR,0,400,8,-75.625,-72,-81,9
26,LR,0,400,3,-75,-73,-78,5
26,LR,0,400,6,-76.6666666666667,-74,-81,7
26,LR,0,400,6,-77,-74,-81,7
26,LR,1,400,9,-77,-74,-81,7
26,LR,1,400,9,-76.2222222222222,-74,-80,6
26,LR,0,400,6,-76.3333333333333,-74,-80,6
26,LR,1,400,9,-77.1111111111111,-74,-80,6
26,LR,1,400,9,-76.5555555555556,-74,-80,6
26,LR,0,400,6,-77.1666666666667,-74,-80,6
26,LR,0,400,7,-76.2857142857143,-74,-80,6
26,LR,0,400,5,-76.8,-74,-80,6
26,LR,1,400,10,-76.8,-74,-80,6
26,LR,0,400,4,-76.25,-74,-80,6
26,LR,1,400,10,-76.1,-73,-80,7
26,LR,0,400,6,-76.6666666666667,-74,-80,6
26,LR,0,400,4,-77.5,-75,-80,5
26,LR,0,400,3,-78.3333333333333,-75,-80,5
26,LR,0,400,4,-77,-74,-80,6
26,LR,1,400,10,-75.6,-73,-80,7
26,LR,0,400,3,-73.3333333333333,-73,-74,1
26,LR,0,400,8,-76.125,-73,-80,7
26,LR,0,400,8,-79.375,-74,-93,19
26,LR,0,400,8,-81,-74,-93,19
26,LR,0,400,6,-80.1666666666667,-74,-93,19
26,LR,1,400,9,-75.7777777777778,-73,-80,7
26,LR,0,400,2,-77,-74,-80,6
26,LR,0,400,5,-76.4,-74,-80,6
26,LR,0,400,6,-80.1666666666667,-74,-93,19
26,LR,0,400,4,-86.5,-80,-93,13
26,LR,0,400,3,-91.6666666666667,-89,-93,4
26,LR,1,400,10,-83.6,-74,-99,25
31,RL,0,450,1,-95,-95,-95,0
31,RL,0,450,3,-74.6666666666667,-72,-78,6
31,RL,0,450,6,-76.6666666666667,-74,-81,7
31,RL,0,450,2,-76,-74,-78,4
31,RL,0,450,5,-76.4,-73,-81,8
31,RL,0,450,8,-78,-72,-88,16
31,RL,0,450,8,-77.875,-72,-88,16
31,RL,1,450,9,-79.4444444444444,-72,-88,16
31,RL,0,450,3,-77.6666666666667,-72,-88,16
31,RL,0,450,3,-82.6666666666667,-73,-88,15
31,RL,0,450,5,-82.6,-79,-88,9
31,RL,0,450,3,-81.6666666666667,-79,-87,8
31,RL,0,450,3,-79.3333333333333,-79,-80,1
31,RL,0,450,3,-79.6666666666667,-79,-80,1
31,RL,0,450,1,-80,-80,-80,0
31,RL,0,450,2,-78,-76,-80,4
31,RL,1,450,10,-79.7,-74,-86,12
31,RL,0,450,2,-82.5,-79,-86,7
31,RL,0,450,5,-80.8,-75,-86,11
31,RL,1,450,10,-79.5,-74,-86,12
31,RL,0,450,4,-76.5,-74,-79,5
31,RL,0,450,3,-76,-74,-79,5
31,RL,1,450,9,-78.1111111111111,-73,-86,13
31,RL,1,450,10,-78.9,-73,-86,13
31,RL,0,450,1,-86,-86,-86,0
31,RL,0,450,2,-78,-78,-78,0
31,RL,0,450,4,-79.25,-76,-85,9
31,RL,0,450,3,-79.6666666666667,-76,-85,9
31,RL,0,450,2,-75.5,-73,-78,5
31,RL,0,450,3,-78,-73,-81,8
31,RL,0,450,7,-79.1428571428571,-74,-82,8
31,RL,0,450,7,-78.2857142857143,-74,-82,8
31,RL,0,450,2,-81.5,-81,-82,1
31,RL,0,450,8,-77.75,-74,-82,8
31,RL,0,450,6,-76.8333333333333,-74,-82,8
31,RL,0,450,1,-74,-74,-74,0
31,RL,0,450,1,-77,-77,-77,0
31,RL,1,450,10,-79.7,-74,-85,11
31,RL,0,450,4,-80,-75,-84,9
31,RL,0,450,6,-80.6666666666667,-77,-84,7
31,RL,0,450,8,-80.375,-77,-85,8
31,RL,1,450,9,-80,-77,-85,8
31,RL,0,450,3,-79.6666666666667,-77,-84,7
31,RL,0,450,2,-77,-77,-77,0
31,RL,0,450,5,-78.2,-77,-81,4
31,RL,0,450,4,-78.25,-77,-81,4
31,RL,1,450,9,-80.2222222222222,-78,-84,6
31,RL,0,450,4,-80.75,-79,-84,5
31,RL,0,450,2,-80,-80,-80,0
31,RL,0,450,5,-80.2,-79,-82,3
31,RL,0,450,4,-80,-80,-80,0
31,RL,1,450,9,-79.3333333333333,-78,-80,2
31,RL,0,450,6,-79.3333333333333,-79,-80,1
31,RL,0,450,5,-79.2,-79,-80,1
31,RL,0,450,4,-79,-79,-79,0
31,RL,0,450,4,-79.25,-79,-80,1
31,RL,1,450,9,-79.3333333333333,-77,-82,5
31,RL,0,450,1,-79,-79,-79,0
31,RL,0,450,4,-79.75,-77,-82,5
31,RL,0,450,6,-79.6666666666667,-77,-82,5
31,RL,0,450,3,-79.6666666666667,-77,-82,5
31,RL,0,450,8,-79.625,-77,-84,7
31,RL,0,450,8,-79.875,-77,-84,7
31,RL,0,450,7,-79.8571428571429,-77,-84,7
31,RL,0,450,2,-82.5,-81,-84,3
31,RL,0,450,3,-80,-78,-81,3
31,RL,0,450,4,-80,-78,-83,5
31,RL,0,450,8,-79.375,-77,-84,7
31,RL,0,450,1,-78,-78,-78,0
31,RL,0,450,5,-79,-77,-83,6
31,RL,0,450,6,-79,-77,-84,7
31,RL,0,450,6,-79.1666666666667,-77,-84,7
31,RL,0,450,3,-79.6666666666667,-77,-84,7
31,RL,0,450,5,-82.2,-78,-86,8
31,RL,1,450,9,-80.2222222222222,-78,-86,8
31,RL,0,450,5,-81.6,-78,-86,8
31,RL,0,450,8,-80.5,-78,-86,8
31,RL,0,450,4,-79.25,-78,-80,2
31,RL,1,450,10,-79.3,-78,-83,5
31,RL,0,450,8,-79.375,-78,-83,5
31,RL,0,450,5,-78.4,-78,-79,1
31,RL,1,450,9,-80.2222222222222,-78,-86,8
31,RL,0,450,1,-78,-78,-78,0
31,RL,0,450,7,-80.7142857142857,-78,-86,8
31,RL,0,450,1,-80,-80,-80,0
31,RL,0,450,7,-81.7142857142857,-78,-86,8
31,RL,0,450,4,-80.75,-78,-86,8
31,RL,0,450,4,-80.75,-78,-86,8
31,RL,0,450,5,-80.6,-78,-86,8
31,RL,0,450,6,-81.1666666666667,-78,-88,10
31,RL,0,450,7,-81.8571428571429,-78,-88,10
31,RL,0,450,3,-83,-80,-88,8
31,RL,0,450,7,-81,-78,-86,8
31,RL,0,450,5,-81.4,-78,-86,8
31,RL,0,450,7,-80.1428571428571,-78,-84,6
31,RL,0,450,3,-81,-78,-84,6
31,RL,1,450,9,-79,-76,-82,6
31,RL,0,450,6,-79.8333333333333,-76,-82,6
31,RL,0,450,2,-81,-81,-81,0
31,RL,0,450,1,-76,-76,-76,0
31,RL,0,450,6,-78.1666666666667,-74,-82,8
31,RL,0,450,8,-76.875,-74,-80,6
31,RL,0,450,1,-76,-76,-76,0
31,RL,0,450,3,-77.6666666666667,-74,-80,6
31,RL,0,450,4,-76.25,-74,-80,6
31,RL,0,450,7,-75.2857142857143,-73,-79,6
31,RL,1,450,9,-76,-73,-79,6
31,RL,1,450,10,-76.3,-73,-79,6
31,RL,1,450,10,-76.2,-73,-79,6
31,RL,0,450,5,-76.6,-73,-79,6
31,RL,0,450,7,-76.7142857142857,-74,-79,5
31,RL,0,450,7,-76.8571428571429,-74,-80,6
31,RL,0,450,4,-77,-74,-80,6
31,RL,0,450,8,-77.75,-74,-81,7
31,RL,0,450,4,-79.5,-76,-81,5
31,RL,0,450,1,-81,-81,-81,0
31,RL,0,450,7,-76.7142857142857,-75,-80,5
31,RL,1,450,10,-77.9,-75,-80,5
31,RL,0,450,8,-78.125,-75,-80,5
31,RL,0,450,6,-78.3333333333333,-75,-80,5
31,RL,0,450,8,-78.75,-75,-80,5
31,RL,1,450,10,-78.1,-75,-80,5
31,RL,0,450,3,-79.3333333333333,-78,-80,2
31,RL,0,450,2,-79,-78,-80,2
31,RL,0,450,4,-79.5,-79,-80,1
31,RL,1,450,9,-78.4444444444444,-75,-80,5
31,RL,0,450,3,-78,-75,-80,5
31,RL,0,450,6,-77.8333333333333,-75,-80,5
31,RL,0,450,2,-75,-75,-75,0
31,RL,0,450,4,-78.25,-75,-80,5
31,RL,0,450,7,-77.4285714285714,-75,-80,5
31,RL,0,450,6,-77.1666666666667,-75,-80,5
31,RL,0,450,5,-76.6,-75,-80,5
31,RL,0,450,3,-76,-75,-78,3
31,RL,0,450,6,-77.1666666666667,-75,-80,5
31,RL,0,450,1,-75,-75,-75,0
31,RL,1,450,10,-77.5,-74,-80,6
31,RL,0,450,1,-80,-80,-80,0
31,RL,0,450,8,-77.5,-74,-80,6
31,RL,1,450,10,-76.7,-74,-79,5
31,RL,0,450,8,-77.125,-74,-79,5
31,RL,0,450,4,-78,-75,-79,4
31,RL,0,450,8,-76.125,-74,-79,5
31,RL,0,450,4,-76.75,-74,-79,5
31,RL,1,450,9,-77,-74,-80,6
31,RL,0,450,8,-76.75,-74,-80,6
31,RL,0,450,5,-76.4,-75,-80,5
31,RL,0,450,1,-77,-77,-77,0
31,RL,0,450,3,-76.6666666666667,-75,-80,5
31,RL,1,450,9,-78.4444444444444,-74,-81,7
31,RL,1,450,9,-78.4444444444444,-74,-81,7
31,RL,0,450,4,-78.5,-74,-81,7
31,RL,0,450,7,-78.5714285714286,-75,-81,6
31,RL,0,450,1,-81,-81,-81,0
31,RL,0,450,5,-77.8,-75,-81,6
31,RL,1,450,9,-79.3333333333333,-75,-82,7
31,RL,0,450,1,-75,-75,-75,0
31,RL,1,450,9,-80,-77,-82,5
31,RL,1,450,9,-80.4444444444444,-77,-85,8
31,RL,0,450,6,-80.3333333333333,-77,-82,5
31,RL,0,450,1,-81,-81,-81,0
31,RL,0,450,4,-80.25,-77,-82,5
31,RL,0,450,5,-79.2,-76,-85,9
31,RL,0,450,3,-79.6666666666667,-77,-85,8
31,RL,0,450,5,-79.6,-76,-85,9
31,RL,1,450,10,-79.4,-76,-85,9
31,RL,0,450,2,-78,-78,-78,0
31,RL,0,450,2,-79,-78,-80,2
31,RL,1,450,9,-79.2222222222222,-78,-81,3
31,RL,0,450,3,-78.6666666666667,-78,-80,2
31,RL,0,450,6,-79,-78,-81,3
31,RL,0,450,8,-79,-78,-81,3
31,RL,0,450,4,-79.5,-78,-81,3
31,RL,0,450,7,-78.5714285714286,-76,-81,5
31,RL,0,450,5,-78.2,-76,-79,3
31,RL,0,450,3,-78.6666666666667,-78,-79,1
31,RL,0,450,6,-77,-73,-79,6
31,RL,1,450,10,-76.8,-73,-80,7
31,RL,0,450,3,-75,-73,-76,3
31,RL,0,450,8,-76.625,-73,-80,7
31,RL,0,450,5,-76.4,-73,-80,7
31,RL,0,450,8,-77.625,-74,-80,6
31,RL,0,450,4,-76.25,-74,-80,6
31,RL,0,450,1,-80,-80,-80,0
31,RL,0,450,3,-76.3333333333333,-74,-80,6
31,RL,1,450,9,-78.1111111111111,-74,-81,7
31,RL,1,450,10,-77.7,-74,-81,7
31,RL,0,450,1,-80,-80,-80,0
31,RL,0,450,8,-79,-74,-81,7
31,RL,0,450,2,-80.5,-80,-81,1
31,RL,0,450,5,-78.8,-74,-80,6
31,RL,0,450,3,-78,-74,-80,6
31,RL,0,450,7,-78.8571428571429,-78,-80,2
31,RL,0,450,5,-78.8,-78,-80,2
31,RL,0,450,5,-78.4,-78,-80,2
31,RL,0,450,1,-78,-78,-78,0
31,RL,1,450,9,-77.7777777777778,-76,-79,3
31,RL,0,450,4,-77,-76,-78,2
31,RL,0,450,4,-77,-76,-78,2
31,RL,1,450,10,-77.8,-76,-79,3
31,RL,0,450,4,-78.5,-78,-79,1
31,RL,0,450,5,-78,-76,-79,3
31,RL,0,450,7,-78.1428571428571,-76,-80,4
31,RL,0,450,6,-78,-76,-80,4
31,RL,0,450,6,-77.8333333333333,-76,-80,4
31,RL,0,450,8,-76.75,-74,-80,6
31,RL,0,450,8,-76.5,-74,-80,6
31,RL,0,450,6,-76,-74,-80,6
31,RL,0,450,6,-75.5,-74,-77,3
31,RL,0,450,5,-75.2,-74,-77,3
31,RL,1,450,9,-75.5555555555556,-74,-79,5
31,RL,0,450,1,-77,-77,-77,0
31,RL,1,450,10,-75.1,-74,-79,5
31,RL,1,450,9,-75.1111111111111,-74,-79,5
31,RL,0,450,5,-75.6,-74,-79,5
31,RL,0,450,6,-75.3333333333333,-74,-79,5
31,RL,1,450,9,-75.6666666666667,-74,-79,5
31,RL,0,450,6,-75.5,-74,-79,5
31,RL,0,450,5,-74.8,-74,-76,2
31,RL,0,450,3,-74.6666666666667,-74,-76,2
31,RL,0,450,3,-75.3333333333333,-74,-76,2
31,RL,0,450,6,-76.3333333333333,-76,-77,1
31,RL,0,450,4,-76.5,-76,-77,1
31,RL,0,450,1,-77,-77,-77,0
31,RL,0,450,5,-77,-76,-78,2
31,RL,0,450,4,-78,-76,-80,4
31,RL,0,450,6,-79.3333333333333,-78,-80,2
31,RL,0,450,2,-79,-78,-80,2
31,RL,0,450,2,-80,-80,-80,0
31,RL,0,450,5,-78.8,-77,-80,3
31,RL,0,450,8,-78.375,-77,-80,3
31,RL,0,450,5,-78.6,-77,-80,3
31,RL,1,450,10,-78.2,-75,-80,5
31,RL,1,450,10,-78.3,-75,-80,5
31,RL,0,450,2,-77,-77,-77,0
31,RL,0,450,1,-77,-77,-77,0
31,RL,0,450,3,-79,-79,-79,0
31,RL,0,450,8,-77.75,-75,-80,5
31,RL,1,450,10,-78,-75,-80,5
31,RL,1,450,10,-78.1,-75,-80,5
31,RL,0,450,5,-77.2,-75,-80,5
31,RL,0,450,3,-78.3333333333333,-76,-80,4
31,RL,0,450,6,-79,-76,-81,5
31,RL,0,450,5,-79.6,-77,-81,4
31,RL,0,450,4,-79.5,-77,-81,4
31,RL,0,450,2,-78.5,-77,-80,3
31,RL,0,450,5,-79.8,-78,-81,3
31,RL,1,450,9,-79.5555555555556,-78,-81,3
31,RL,0,450,7,-79.4285714285714,-78,-81,3
31,RL,0,450,7,-79.4285714285714,-78,-81,3
31,RL,0,450,8,-78.5,-75,-81,6
31,RL,0,450,6,-79.1666666666667,-78,-81,3
31,RL,0,450,5,-79.4,-78,-81,3
31,RL,0,450,6,-78,-74,-81,7
31,RL,0,450,7,-77.4285714285714,-74,-81,7
31,RL,0,450,7,-77,-74,-80,6
31,RL,0,450,8,-77.25,-74,-81,7
31,RL,0,450,1,-74,-74,-74,0
31,RL,0,450,5,-77.6,-75,-80,5
31,RL,1,450,10,-78,-75,-81,6
31,RL,0,450,5,-78,-76,-81,5
31,RL,0,450,7,-77.8571428571429,-76,-81,5
31,RL,0,450,7,-77.4285714285714,-75,-81,6
31,RL,0,450,4,-77.75,-76,-81,5
31,RL,0,450,6,-77.1666666666667,-75,-81,6
31,RL,0,450,1,-77,-77,-77,0
31,RL,0,450,4,-76.25,-75,-78,3
31,RL,0,450,8,-77.5,-75,-85,10
31,RL,1,450,9,-77.3333333333333,-75,-85,10
31,RL,0,450,3,-77.3333333333333,-75,-79,4
31,RL,0,450,1,-79,-79,-79,0
31,RL,0,450,4,-77.75,-75,-85,10
31,RL,0,450,6,-78.3333333333333,-75,-85,10
31,RL,0,450,2,-80.5,-76,-85,9
31,RL,0,450,6,-77.5,-75,-84,9
31,RL,0,450,7,-78.1428571428571,-75,-84,9
31,RL,0,450,8,-78.25,-75,-84,9
31,RL,1,450,10,-78.2,-76,-81,5
31,RL,0,450,3,-78,-76,-80,4
31,RL,0,450,1,-80,-80,-80,0
31,RL,0,450,7,-78.1428571428571,-76,-81,5
31,RL,0,450,5,-78,-77,-81,4
31,RL,0,450,1,-77,-77,-77,0
31,RL,0,450,4,-78.5,-74,-82,8
31,RL,0,450,8,-79.375,-74,-84,10
31,RL,0,450,3,-79.6666666666667,-74,-83,9
31,RL,1,450,9,-80.4444444444444,-74,-85,11
31,RL,0,450,3,-77.6666666666667,-74,-83,9
31,RL,0,450,8,-79.625,-74,-85,11
31,RL,0,450,3,-83.3333333333333,-82,-84,2
31,RL,0,450,3,-80.6666666666667,-74,-84,10
31,RL,0,450,2,-79,-74,-84,10
31,RL,0,450,8,-77.75,-74,-85,11
31,RL,0,450,6,-77.1666666666667,-74,-85,11
31,RL,1,450,10,-80.2,-74,-88,14
31,RL,1,450,9,-81.1111111111111,-74,-88,14
31,RL,0,450,7,-82.2857142857143,-75,-88,13
31,RL,0,450,3,-83,-76,-88,12
31,RL,0,450,7,-83.4285714285714,-75,-88,13
31,RL,0,450,6,-83.1666666666667,-75,-88,13
31,RL,0,450,2,-88,-88,-88,0
31,RL,0,450,6,-81,-75,-88,13
31,RL,0,450,6,-80.8333333333333,-75,-88,13
31,RL,1,450,9,-79.1111111111111,-75,-88,13
31,RL,1,450,9,-79.3333333333333,-75,-87,12
31,RL,0,450,8,-79.875,-75,-87,12
31,RL,0,450,3,-77,-75,-80,5
31,RL,1,450,10,-80.8,-76,-85,9
31,RL,0,450,8,-81,-76,-85,9
31,RL,0,450,1,-76,-76,-76,0
31,RL,0,450,6,-82.5,-76,-85,9
31,RL,1,450,9,-82.3333333333333,-76,-85,9
31,RL,0,450,7,-82.8571428571429,-77,-85,8
31,RL,1,450,10,-82.5,-77,-85,8
31,RL,0,450,4,-84.25,-83,-85,2
31,RL,0,450,3,-84,-83,-85,2
31,RL,1,450,9,-81.4444444444444,-77,-85,8
31,RL,1,450,10,-80.8,-77,-85,8
31,RL,0,450,8,-80.25,-77,-85,8
31,RL,0,450,6,-80,-77,-83,6
31,RL,0,450,8,-80.125,-77,-83,6
31,RL,0,450,3,-78.3333333333333,-77,-81,4
31,RL,0,450,6,-81.1666666666667,-80,-83,3
31,RL,1,450,9,-81.7777777777778,-79,-84,5
31,RL,0,450,4,-81.5,-80,-83,3
31,RL,0,450,4,-81.5,-80,-83,3
31,RL,0,450,5,-82,-79,-84,5
31,RL,1,450,10,-82,-77,-86,9
31,RL,0,450,3,-82,-79,-84,5
31,RL,1,450,9,-82.5555555555556,-77,-86,9
31,RL,0,450,5,-80.6,-77,-83,6
31,RL,1,450,10,-82.1,-77,-86,9
31,RL,0,450,6,-83.1666666666667,-77,-86,9
31,RL,1,450,10,-83.4,-77,-86,9
31,RL,0,450,2,-83.5,-83,-84,1
31,RL,0,450,3,-85.3333333333333,-84,-86,2
31,RL,0,450,8,-83.375,-77,-86,9
31,RL,0,450,2,-85.5,-85,-86,1
31,RL,0,450,1,-85,-85,-85,0
31,RL,1,450,10,-81.5,-77,-84,7
31,RL,0,450,1,-77,-77,-77,0
31,RL,0,450,5,-82.2,-79,-84,5
31,RL,0,450,2,-82.5,-82,-83,1
31,RL,0,450,3,-80.3333333333333,-79,-82,3
31,RL,0,450,6,-82,-80,-88,8
31,RL,0,450,4,-83,-80,-88,8
31,RL,0,450,6,-83,-80,-88,8
31,RL,0,450,1,-88,-88,-88,0
31,RL,0,450,1,-80,-80,-80,0
31,RL,0,450,1,-80,-80,-80,0
31,RL,0,450,1,-80,-80,-80,0
31,RL,0,450,3,-83.3333333333333,-83,-84,1
31,RL,0,450,8,-80.875,-78,-83,5
31,RL,1,450,10,-79.4,-76,-83,7
31,RL,1,450,9,-79,-76,-81,5
31,RL,0,450,2,-79,-78,-80,2
31,RL,0,450,4,-79.25,-78,-81,3
31,RL,0,450,1,-81,-81,-81,0
31,RL,0,450,7,-77.7142857142857,-76,-79,3
31,RL,1,450,9,-77.3333333333333,-76,-79,3
31,RL,0,450,4,-77.25,-76,-79,3
31,RL,0,450,4,-76.5,-76,-77,1
31,RL,0,450,5,-78,-77,-82,5
31,RL,0,450,2,-77,-77,-77,0
31,RL,0,450,2,-77,-77,-77,0
31,RL,0,450,6,-80.1666666666667,-76,-83,7
31,RL,1,450,10,-78.8,-76,-83,7
31,RL,0,450,8,-77.875,-76,-83,7
31,RL,0,450,3,-78.3333333333333,-76,-83,7
31,RL,0,450,6,-76.6666666666667,-76,-78,2
31,RL,0,450,4,-77,-76,-78,2
31,RL,0,450,6,-78,-76,-80,4
31,RL,0,450,2,-77.5,-76,-79,3
31,RL,1,450,10,-79.1,-78,-80,2
31,RL,0,450,7,-79.2857142857143,-78,-80,2
31,RL,0,450,1,-80,-80,-80,0
31,RL,0,450,2,-78.5,-78,-79,1
31,RL,0,450,6,-78.1666666666667,-76,-80,4
31,RL,0,450,1,-79,-79,-79,0
31,RL,0,450,6,-78.8333333333333,-76,-81,5
31,RL,0,450,4,-79.25,-76,-81,5
31,RL,0,450,8,-78.125,-74,-81,7
31,RL,0,450,8,-78,-74,-80,6
31,RL,1,450,10,-77.5,-75,-80,5
31,RL,0,450,1,-80,-80,-80,0
31,RL,0,450,6,-77.5,-75,-80,5
31,RL,0,450,4,-78.75,-75,-80,5
31,RL,1,450,10,-78.7,-75,-82,7
31,RL,0,450,3,-78.3333333333333,-75,-80,5
31,RL,0,450,8,-78.25,-74,-82,8
31,RL,0,450,5,-79.4,-75,-82,7
31,RL,1,450,10,-79.2,-74,-82,8
31,RL,0,450,3,-81,-79,-82,3
31,RL,0,450,3,-78.3333333333333,-74,-82,8
31,RL,0,450,5,-78.2,-74,-80,6
31,RL,0,450,7,-78.2857142857143,-74,-80,6
31,RL,1,450,10,-78.6,-73,-80,7
31,RL,0,450,7,-78,-73,-80,7
31,RL,1,450,9,-78.4444444444444,-73,-80,7
31,RL,0,450,6,-78,-73,-80,7
31,RL,0,450,3,-76.6666666666667,-73,-79,6
31,RL,0,450,1,-80,-80,-80,0
31,RL,0,450,3,-78.6666666666667,-78,-80,2
31,RL,1,450,10,-75.8,-73,-80,7
31,RL,1,450,10,-75.4,-73,-80,7
31,RL,0,450,2,-73.5,-73,-74,1
31,RL,0,450,1,-74,-74,-74,0
31,RL,0,450,5,-75.2,-74,-80,6
31,RL,0,450,1,-74,-74,-74,0
31,RL,0,450,7,-75,-74,-80,6
31,RL,0,450,8,-75.5,-74,-80,6
31,RL,0,450,2,-74,-74,-74,0
31,RL,0,450,2,-74.5,-74,-75,1
31,RL,0,450,8,-76.375,-74,-81,7
31,RL,0,450,1,-74,-74,-74,0
31,RL,0,450,3,-77.6666666666667,-74,-80,6
31,RL,1,450,10,-76.4,-74,-81,7
31,RL,0,450,4,-75.75,-74,-81,7
31,RL,0,450,5,-76.6,-74,-81,7
31,RL,1,450,10,-76.9,-74,-80,6
31,RL,0,450,5,-76.4,-74,-80,6
31,RL,0,450,3,-76,-74,-80,6
31,RL,0,450,3,-76,-74,-80,6
31,RL,0,450,7,-78.1428571428571,-74,-80,6
31,RL,0,450,4,-79.75,-79,-80,1
31,RL,0,450,4,-78.25,-74,-80,6
31,RL,0,450,2,-79.5,-79,-80,1
31,RL,1,450,10,-77.8,-74,-80,6
31,RL,0,450,1,-74,-74,-74,0
31,RL,0,450,3,-79.3333333333333,-79,-80,1
31,RL,1,450,10,-77.9,-74,-80,6
31,RL,0,450,7,-78,-75,-80,5
31,RL,0,450,4,-78,-75,-79,4
31,RL,0,450,2,-79,-79,-79,0
31,RL,0,450,2,-77,-75,-79,4
31,RL,0,450,8,-77.875,-74,-80,6
31,RL,0,450,8,-78.5,-74,-80,6
31,RL,1,450,10,-79.5,-74,-81,7
31,RL,0,450,5,-78.6,-74,-80,6
31,RL,1,450,10,-80.1,-79,-81,2
31,RL,0,450,7,-80.1428571428571,-79,-81,2
31,RL,0,450,7,-80.1428571428571,-79,-81,2
31,RL,0,450,2,-80.5,-80,-81,1
31,RL,1,450,9,-78.5555555555556,-75,-81,6
31,RL,1,450,10,-78.6,-75,-83,8
31,RL,0,450,3,-78.3333333333333,-75,-80,5
31,RL,0,450,7,-77.4285714285714,-75,-81,6
31,RL,1,450,10,-78.2,-75,-83,8
31,RL,0,450,8,-78.875,-75,-83,8
31,RL,0,450,4,-79.75,-76,-83,7
31,RL,0,450,1,-79,-79,-79,0
31,RL,0,450,7,-78.5714285714286,-75,-83,8
31,RL,0,450,3,-79,-75,-82,7
31,RL,1,450,9,-79.4444444444444,-75,-83,8
31,RL,0,450,7,-79,-75,-83,8
31,RL,0,450,1,-75,-75,-75,0
31,RL,0,450,5,-79.8,-76,-83,7
31,RL,0,450,4,-79,-76,-80,4
31,RL,0,450,4,-79,-76,-80,4
31,RL,0,450,1,-80,-80,-80,0
31,RL,0,450,5,-77,-75,-80,5
31,RL,0,450,3,-76.6666666666667,-75,-80,5
31,RL,0,450,7,-77.5714285714286,-75,-83,8
31,RL,0,450,5,-77.4,-75,-83,8
31,RL,1,450,10,-79.2,-75,-84,9
31,RL,0,450,4,-78,-75,-82,7
31,RL,0,450,4,-78.25,-75,-82,7
31,RL,0,450,4,-80,-76,-82,6
31,RL,0,450,2,-78,-76,-80,4
31,RL,0,450,2,-79,-76,-82,6
31,RL,0,450,1,-82,-82,-82,0
31,RL,0,450,1,-84,-84,-84,0
31,RL,1,450,10,-76.8,-74,-82,8
31,RL,0,450,3,-76,-74,-79,5
31,RL,0,450,8,-76.75,-74,-82,8
31,RL,0,450,5,-77.8,-74,-82,8
31,RL,0,450,1,-79,-79,-79,0
31,RL,0,450,5,-80.2,-75,-86,11
31,RL,1,450,10,-81,-75,-86,11
31,RL,0,450,4,-82,-80,-86,6
31,RL,0,450,2,-81,-80,-82,2
31,RL,0,450,2,-81,-79,-83,4
31,RL,0,450,6,-79.8333333333333,-79,-82,3
31,RL,0,450,2,-79,-79,-79,0
31,RL,0,450,2,-79.5,-79,-80,1
31,RL,0,450,4,-79.25,-75,-82,7
31,RL,0,450,4,-78,-75,-82,7
31,RL,1,450,10,-77.4,-75,-80,5
31,RL,1,450,9,-78.2222222222222,-75,-84,9
31,RL,0,450,1,-80,-80,-80,0
31,RL,0,450,3,-78,-75,-80,5
31,RL,0,450,7,-79,-75,-84,9
31,RL,0,450,2,-79.5,-79,-80,1
31,RL,1,450,9,-78.5555555555556,-75,-84,9
31,RL,0,450,5,-79,-75,-84,9
31,RL,0,450,8,-78.375,-75,-84,9
31,RL,0,450,7,-77.5714285714286,-75,-80,5
31,RL,0,450,3,-76.6666666666667,-75,-80,5
31,RL,0,450,4,-78.25,-75,-80,5
31,RL,0,450,8,-78.5,-75,-84,9
31,RL,0,450,2,-77,-75,-79,4
31,RL,0,450,8,-78.5,-76,-84,8
31,RL,0,450,4,-79,-76,-84,8
31,RL,0,450,4,-79,-76,-84,8
31,RL,0,450,8,-80.125,-76,-84,8
31,RL,0,450,2,-78,-76,-80,4
31,RL,1,450,10,-79.9,-76,-83,7
31,RL,1,450,9,-80.3333333333333,-77,-83,6
31,RL,0,450,8,-80.75,-79,-83,4
31,RL,0,450,5,-81,-79,-83,4
31,RL,0,450,1,-79,-79,-79,0
31,RL,0,450,3,-81,-79,-82,3
31,RL,0,450,3,-80,-79,-82,3
31,RL,0,450,7,-78.8571428571429,-75,-86,11
31,RL,0,450,8,-79.25,-75,-86,11
31,RL,0,450,5,-78.8,-75,-86,11
31,RL,0,450,3,-78.6666666666667,-75,-86,11
31,RL,0,450,4,-80.75,-76,-86,10
31,RL,1,450,9,-80.4444444444444,-76,-85,9
31,RL,0,450,7,-81.2857142857143,-76,-85,9
31,RL,0,450,8,-81,-76,-85,9
31,RL,0,450,3,-82.6666666666667,-80,-85,5
31,RL,0,450,2,-82.5,-80,-85,5
31,RL,0,450,4,-79,-76,-84,8
31,RL,0,450,3,-77.3333333333333,-76,-79,3
31,RL,1,450,10,-78.2,-76,-81,5
31,RL,0,450,5,-79,-77,-81,4
31,RL,0,450,7,-78.7142857142857,-76,-83,7
31,RL,0,450,6,-78.6666666666667,-76,-83,7
31,RL,0,450,2,-78,-76,-80,4
31,RL,1,450,10,-78.7,-75,-86,11
31,RL,0,450,4,-78.75,-76,-83,7
31,RL,1,450,10,-79.6,-75,-86,11
31,RL,0,450,8,-79,-75,-86,11
31,RL,1,450,9,-79.4444444444444,-75,-86,11
31,RL,0,450,3,-78.3333333333333,-76,-80,4
31,RL,1,450,10,-78.4,-75,-85,10
31,RL,1,450,10,-78.1,-75,-85,10
31,RL,0,450,2,-80.5,-76,-85,9
31,RL,0,450,2,-80,-75,-85,10
31,RL,0,450,8,-79,-76,-86,10
31,RL,0,450,6,-79.3333333333333,-76,-86,10
31,RL,0,450,8,-80.125,-76,-89,13
31,RL,0,450,1,-80,-80,-80,0
31,RL,0,450,1,-76,-76,-76,0
31,RL,0,450,5,-81.2,-77,-89,12
31,RL,1,450,9,-83.2222222222222,-77,-90,13
31,RL,0,450,3,-81,-77,-89,12
31,RL,0,450,7,-85,-77,-90,13
31,RL,0,450,4,-89.5,-89,-90,1
31,RL,0,450,6,-84.8333333333333,-80,-90,10
31,RL,1,450,9,-83.8888888888889,-80,-90,10
31,RL,0,450,4,-82.5,-80,-90,10
31,RL,0,450,8,-82,-80,-87,7
31,RL,1,450,10,-81.3,-76,-87,11
31,RL,0,450,4,-82,-80,-87,7
31,RL,0,450,6,-82.8333333333333,-80,-87,7
31,RL,0,450,6,-82.1666666666667,-76,-87,11
31,RL,0,450,5,-81,-76,-87,11
31,RL,0,450,6,-81.1666666666667,-76,-88,12
31,RL,0,450,7,-80.4285714285714,-76,-88,12
31,RL,0,450,4,-81.25,-76,-88,12
31,RL,0,450,5,-81.2,-76,-88,12
31,RL,0,450,6,-80.5,-76,-88,12
31,RL,0,450,6,-80.3333333333333,-76,-87,11
31,RL,0,450,3,-77.6666666666667,-76,-81,5
31,RL,1,450,9,-79.4444444444444,-75,-87,12
31,RL,1,450,9,-80.3333333333333,-75,-87,12
31,RL,0,450,2,-82,-80,-84,4
31,RL,0,450,6,-79.1666666666667,-75,-84,9
31,RL,0,450,2,-78,-76,-80,4
31,RL,1,450,10,-79,-75,-85,10
31,RL,1,450,9,-80.7777777777778,-76,-86,10
31,RL,1,450,9,-80.2222222222222,-76,-86,10
31,RL,0,450,1,-80,-80,-80,0
31,RL,0,450,5,-79,-76,-86,10
31,RL,0,450,1,-81,-81,-81,0
31,RL,1,450,10,-81.1,-75,-86,11
31,RL,0,450,7,-80.7142857142857,-75,-86,11
31,RL,0,450,5,-82.8,-76,-86,10
31,RL,0,450,2,-83,-80,-86,6
31,RL,0,450,2,-78,-76,-80,4
31,RL,0,450,6,-81.3333333333333,-75,-86,11
31,RL,1,450,9,-82.5555555555556,-75,-86,11
31,RL,0,450,5,-81.4,-75,-85,10
31,RL,0,450,4,-83,-81,-85,4
31,RL,0,450,4,-82,-81,-85,4
31,RL,1,450,10,-80.8,-76,-85,9
31,RL,0,450,1,-81,-81,-81,0
31,RL,0,450,3,-84.3333333333333,-84,-85,1
31,RL,0,450,7,-79.4285714285714,-76,-84,8
31,RL,1,450,9,-79,-76,-87,11
31,RL,0,450,8,-78,-76,-87,11
31,RL,0,450,6,-78,-76,-87,11
31,RL,0,450,3,-79.6666666666667,-76,-87,11
31,RL,0,450,3,-76.3333333333333,-76,-77,1
31,RL,0,450,5,-81.4,-76,-87,11
31,RL,0,450,2,-79,-77,-81,4
31,RL,0,450,6,-81.8333333333333,-77,-87,10
31,RL,0,450,6,-81.1666666666667,-77,-87,10
31,RL,0,450,4,-81,-77,-87,10
31,RL,1,450,10,-78.5,-76,-81,5
31,RL,0,450,3,-78,-77,-80,3
31,RL,0,450,4,-79,-77,-81,4
31,RL,0,450,8,-78,-76,-81,5
31,RL,0,450,2,-81,-81,-81,0
31,RL,0,450,6,-77.6666666666667,-76,-81,5
31,RL,1,450,9,-79.6666666666667,-76,-86,10
31,RL,0,450,7,-80,-76,-86,10
31,RL,0,450,2,-81,-76,-86,10
31,RL,0,450,6,-82.1666666666667,-76,-86,10
31,RL,0,450,6,-81.5,-76,-86,10
31,RL,0,450,2,-80,-76,-84,8
31,RL,0,450,5,-83.8,-82,-86,4
31,RL,0,450,7,-81.1428571428571,-76,-86,10
31,RL,0,450,4,-82.5,-81,-85,4
31,RL,0,450,2,-81.5,-81,-82,1
31,RL,1,450,9,-78.8888888888889,-75,-85,10
31,RL,0,450,4,-77,-75,-81,6
31,RL,0,450,2,-78,-75,-81,6
31,RL,0,450,8,-80.375,-75,-85,10
31,RL,1,450,9,-83,-76,-86,10
31,RL,1,450,9,-82.3333333333333,-75,-86,11
31,RL,0,450,6,-84.6666666666667,-82,-86,4
31,RL,1,450,9,-82.1111111111111,-75,-86,11
31,RL,0,450,8,-81.625,-75,-86,11
31,RL,1,450,9,-80.8888888888889,-75,-86,11
31,RL,0,450,5,-80.2,-75,-86,11
31,RL,1,450,10,-79.4,-75,-85,10
31,RL,0,450,1,-81,-81,-81,0
31,RL,0,450,4,-79.25,-75,-85,10
31,RL,1,450,9,-79.7777777777778,-75,-85,10
31,RL,0,450,6,-79,-75,-82,7
31,RL,1,450,9,-80.2222222222222,-75,-85,10
31,RL,0,450,5,-80,-75,-84,9
31,RL,0,450,6,-80.8333333333333,-75,-85,10
31,RL,0,450,5,-81,-75,-85,10
31,RL,0,450,3,-81.6666666666667,-77,-84,7
31,RL,0,450,1,-77,-77,-77,0
31,RL,0,450,4,-83.5,-76,-89,13
31,RL,0,450,3,-83.3333333333333,-76,-89,13
31,RL,1,450,10,-82.5,-76,-91,15
31,RL,0,450,4,-84,-77,-91,14
31,RL,0,450,3,-81.6666666666667,-77,-91,14
31,RL,0,450,4,-81.5,-77,-91,14
31,RL,1,450,9,-82.2222222222222,-77,-91,14
31,RL,1,450,9,-81.1111111111111,-77,-89,12
31,RL,0,450,5,-80.4,-77,-89,12
31,RL,0,450,7,-81.7142857142857,-77,-89,12
31,RL,0,450,5,-82.8,-77,-89,12
31,RL,1,450,9,-79.2222222222222,-76,-89,13
31,RL,0,450,8,-78.875,-76,-89,13
31,RL,0,450,4,-80.75,-76,-89,13
31,RL,0,450,4,-77.75,-76,-81,5
31,RL,0,450,4,-76.75,-76,-77,1
31,RL,0,450,8,-82.625,-76,-92,16
31,RL,0,450,6,-82.5,-76,-92,16
31,RL,0,450,6,-84.5,-76,-92,16
31,RL,0,450,6,-86.5,-76,-92,16
31,RL,0,450,4,-88.5,-81,-92,11
31,RL,1,450,9,-84.1111111111111,-76,-92,16
31,RL,0,450,3,-86.3333333333333,-81,-89,8
31,RL,0,450,1,-89,-89,-89,0
31,RL,0,450,8,-81.5,-76,-90,14
31,RL,0,450,7,-80.5714285714286,-77,-90,13
31,RL,0,450,4,-81.5,-77,-90,13
31,RL,0,450,3,-82.6666666666667,-77,-90,13
31,RL,0,450,6,-78,-76,-81,5
31,RL,1,450,9,-80.5555555555556,-76,-90,14
31,RL,0,450,8,-81,-76,-90,14
31,RL,1,450,9,-82,-76,-93,17
31,RL,0,450,7,-81.1428571428571,-76,-90,14
31,RL,0,450,5,-82.8,-76,-90,14
31,RL,0,450,4,-84.5,-77,-90,13
31,RL,1,450,9,-82.4444444444444,-76,-93,17
31,RL,0,450,4,-85.25,-77,-93,16
31,RL,0,450,5,-80.8,-76,-93,17
31,RL,0,450,7,-82.1428571428571,-76,-93,17
31,RL,0,450,7,-80.4285714285714,-76,-90,14
31,RL,0,450,3,-81,-76,-90,14
31,RL,0,450,3,-81.3333333333333,-77,-90,13
31,RL,0,450,7,-82,-76,-90,14
31,RL,0,450,6,-81.3333333333333,-76,-88,12
31,RL,0,450,4,-81.5,-76,-88,12
31,RL,0,450,6,-80.5,-76,-88,12
31,RL,0,450,4,-81.5,-76,-88,12
31,RL,0,450,3,-79.3333333333333,-76,-81,5
31,RL,1,450,9,-77.3333333333333,-70,-81,11
31,RL,0,450,2,-76.5,-74,-79,5
31,RL,0,450,7,-77.2857142857143,-70,-82,12
31,RL,1,450,10,-80.1,-70,-87,17
31,RL,0,450,6,-80.6666666666667,-78,-87,9
31,RL,1,450,9,-81.4444444444444,-78,-87,9
31,RL,0,450,1,-78,-78,-78,0
31,RL,0,450,5,-82,-80,-87,7
31,RL,0,450,4,-82,-80,-87,7
31,RL,0,450,6,-83.5,-80,-87,7
31,RL,0,450,8,-85,-80,-92,12
31,RL,0,450,4,-83.25,-80,-87,7
31,RL,0,450,1,-86,-86,-86,0
31,RL,0,450,2,-83.5,-80,-87,7
31,RL,0,450,4,-87.75,-85,-92,7
31,RL,0,450,2,-89,-86,-92,6
31,RL,1,450,9,-85.2222222222222,-80,-92,12
31,RL,1,450,9,-85,-80,-92,12
31,RL,0,450,2,-81,-81,-81,0
31,RL,0,450,7,-85.7142857142857,-81,-92,11
31,RL,0,450,1,-79,-79,-79,0
31,RL,0,450,1,-91,-91,-91,0
31,RL,0,450,8,-85.125,-79,-92,13
31,LR,1,450,10,-91.1,-82,-98,16
31,LR,0,450,4,-90.75,-87,-94,7
31,LR,0,450,1,-87,-87,-87,0
31,LR,0,450,7,-90.8571428571429,-83,-98,15
31,LR,0,450,4,-92.25,-89,-98,9
31,LR,0,450,5,-86.8,-78,-92,14
31,LR,0,450,1,-78,-78,-78,0
31,LR,0,450,2,-80.5,-78,-83,5
31,LR,0,450,7,-82,-77,-88,11
31,LR,1,450,10,-82.8,-77,-88,11
31,LR,0,450,4,-85.5,-83,-88,5
31,LR,0,450,2,-84.5,-83,-86,3
31,LR,0,450,8,-81.625,-77,-87,10
31,LR,0,450,5,-82.6,-81,-87,6
31,LR,0,450,3,-81.6666666666667,-81,-83,2
31,LR,0,450,7,-82.2857142857143,-78,-86,8
31,LR,0,450,4,-81.75,-78,-85,7
31,LR,0,450,7,-84.5714285714286,-78,-90,12
31,LR,0,450,2,-81.5,-78,-85,7
31,LR,1,450,10,-86.5,-80,-93,13
31,LR,0,450,4,-87,-82,-90,8
31,LR,0,450,6,-87.1666666666667,-80,-93,13
31,LR,0,450,1,-90,-90,-90,0
31,LR,0,450,6,-85.3333333333333,-80,-93,13
31,LR,1,450,10,-85.1,-80,-91,11
31,LR,0,450,8,-84.125,-80,-91,11
31,LR,0,450,7,-84.7142857142857,-80,-91,11
31,LR,0,450,8,-85.75,-80,-91,11
31,LR,0,450,5,-88,-82,-91,9
31,LR,0,450,6,-86.6666666666667,-82,-91,9
31,LR,0,450,3,-90,-89,-91,2
31,LR,0,450,8,-85.875,-80,-92,12
31,LR,0,450,3,-84,-82,-87,5
31,LR,1,450,10,-85.2,-80,-92,12
31,LR,0,450,2,-89.5,-87,-92,5
31,LR,0,450,4,-88.25,-80,-92,12
31,LR,0,450,7,-84.4285714285714,-80,-92,12
31,LR,0,450,7,-83.7142857142857,-80,-92,12
31,LR,1,450,9,-85.1111111111111,-80,-92,12
31,LR,0,450,3,-83,-80,-89,9
31,LR,0,450,8,-86.5,-80,-98,18
31,LR,1,450,9,-86.3333333333333,-81,-98,17
31,LR,0,450,5,-85,-81,-90,9
31,LR,1,450,9,-87,-81,-98,17
31,LR,0,450,2,-87,-84,-90,6
31,LR,1,450,9,-88.4444444444444,-81,-98,17
31,LR,0,450,7,-89.4285714285714,-81,-98,17
31,LR,1,450,9,-86.8888888888889,-80,-95,15
31,LR,0,450,8,-87.625,-80,-95,15
31,LR,0,450,4,-90.75,-82,-95,13
31,LR,0,450,1,-94,-94,-94,0
31,LR,0,450,3,-89.6666666666667,-82,-95,13
31,LR,0,450,2,-88.5,-82,-95,13
31,LR,0,450,7,-85.2857142857143,-79,-94,15
31,LR,1,450,10,-86.3,-79,-94,15
31,LR,0,450,7,-84.4285714285714,-79,-94,15
31,LR,0,450,3,-87.3333333333333,-79,-94,15
31,LR,1,450,9,-85.8888888888889,-79,-90,11
31,LR,0,450,7,-84.8571428571429,-79,-90,11
31,LR,0,450,5,-85.8,-81,-90,9
31,LR,0,450,6,-87.3333333333333,-82,-90,8
31,LR,0,450,4,-87,-82,-90,8
31,LR,0,450,6,-88.6666666666667,-86,-90,4
31,LR,1,450,10,-86.3,-78,-90,12
31,LR,0,450,6,-85.1666666666667,-78,-90,12
31,LR,0,450,7,-85.2857142857143,-78,-90,12
31,LR,0,450,4,-83.25,-78,-88,10
31,LR,1,450,9,-84.2222222222222,-78,-90,12
31,LR,0,450,8,-84.875,-78,-90,12
31,LR,0,450,1,-78,-78,-78,0
31,LR,0,450,5,-86,-82,-90,8
31,LR,0,450,7,-87.1428571428571,-82,-98,16
31,LR,0,450,2,-84.5,-82,-87,5
31,LR,0,450,1,-82,-82,-82,0
31,LR,0,450,1,-85,-85,-85,0
31,LR,0,450,6,-87.6666666666667,-81,-98,17
31,LR,1,450,9,-87.5555555555556,-81,-98,17
31,LR,1,450,9,-88.5555555555556,-81,-98,17
31,LR,1,450,9,-86.6666666666667,-81,-94,13
31,LR,1,450,10,-85.3,-80,-94,14
31,LR,0,450,5,-87.8,-83,-94,11
31,LR,1,450,9,-86.2222222222222,-80,-94,14
31,LR,0,450,8,-86.625,-80,-94,14
31,LR,0,450,1,-90,-90,-90,0
31,LR,0,450,3,-87,-81,-94,13
31,LR,1,450,10,-85.6,-80,-92,12
31,LR,0,450,2,-83,-80,-86,6
31,LR,1,450,9,-86.1111111111111,-80,-92,12
31,LR,0,450,4,-86.5,-81,-92,11
31,LR,0,450,3,-88.3333333333333,-81,-92,11
31,LR,0,450,7,-86.7142857142857,-81,-92,11
31,LR,1,450,9,-87,-83,-92,9
31,LR,0,450,1,-91,-91,-91,0
31,LR,0,450,5,-85.4,-83,-89,6
31,LR,0,450,2,-87.5,-86,-89,3
31,LR,0,450,3,-85,-84,-86,2
31,LR,0,450,4,-85.5,-84,-87,3
31,LR,0,450,8,-88.5,-84,-97,13
31,LR,0,450,3,-86.3333333333333,-86,-87,1
31,LR,0,450,2,-86,-86,-86,0
31,LR,1,450,9,-86.7777777777778,-81,-97,16
31,LR,0,450,3,-87.6666666666667,-82,-95,13
31,LR,0,450,5,-84.2,-81,-87,6
31,LR,1,450,10,-86.8,-81,-94,13
31,LR,0,450,8,-86.75,-81,-94,13
31,LR,1,450,10,-89,-82,-94,12
31,LR,0,450,4,-88.25,-82,-94,12
31,LR,0,450,6,-91.3333333333333,-88,-94,6
31,LR,0,450,7,-91.4285714285714,-88,-94,6
31,LR,0,450,5,-90.4,-88,-92,4
31,LR,0,450,8,-91.875,-90,-96,6
31,LR,0,450,2,-90,-90,-90,0
31,LR,1,450,10,-91.6,-87,-96,9
31,LR,0,450,1,-92,-92,-92,0
31,LR,0,450,2,-95,-94,-96,2
31,LR,0,450,4,-91,-87,-96,9
31,LR,0,450,7,-90.2857142857143,-87,-96,9
31,LR,0,450,6,-90.3333333333333,-87,-96,9
31,LR,0,450,1,-96,-96,-96,0
31,LR,0,450,8,-89.125,-84,-96,12
31,LR,1,450,9,-89.6666666666667,-84,-96,12
31,LR,0,450,8,-89.625,-84,-96,12
31,LR,0,450,3,-92,-88,-96,8
31,LR,0,450,7,-89.7142857142857,-83,-96,13
31,LR,0,450,1,-88,-88,-88,0
31,LR,0,450,3,-89.3333333333333,-84,-92,8
31,LR,0,450,3,-89.3333333333333,-83,-93,10
31,LR,0,450,3,-90,-86,-96,10
31,LR,0,450,8,-88.5,-85,-95,10
31,LR,1,450,10,-88.3,-85,-95,10
31,LR,0,450,1,-92,-92,-92,0
31,LR,0,450,5,-88.6,-86,-95,9
31,LR,0,450,1,-86,-86,-86,0
31,LR,0,450,6,-89,-85,-95,10
31,LR,0,450,7,-90.2857142857143,-85,-95,10
31,LR,0,450,8,-90.125,-85,-95,10
31,LR,0,450,7,-90.8571428571429,-85,-95,10
31,LR,0,450,3,-90.3333333333333,-85,-95,10
31,LR,0,450,5,-90.8,-85,-95,10
31,LR,1,450,10,-90.6,-86,-95,9
31,LR,1,450,10,-90.1,-86,-95,9
31,LR,0,450,4,-91,-88,-95,7
31,LR,0,450,1,-88,-88,-88,0
31,LR,0,450,4,-89,-86,-90,4
31,LR,1,450,9,-90.2222222222222,-86,-100,14
31,LR,0,450,7,-90.2857142857143,-86,-100,14
31,LR,1,450,10,-90.2,-87,-100,13
31,LR,1,450,9,-90.3333333333333,-87,-100,13
31,LR,1,450,9,-91.3333333333333,-87,-100,13
31,LR,0,450,6,-88.8333333333333,-87,-90,3
31,LR,0,450,8,-89.75,-86,-99,13
31,LR,1,450,10,-89.3,-86,-99,13
31,LR,0,450,5,-91,-88,-99,11
31,LR,0,450,1,-88,-88,-88,0
31,LR,1,450,10,-88.5,-86,-99,13
31,LR,0,450,6,-89.5,-86,-99,13
31,LR,0,450,3,-87.6666666666667,-86,-90,4
31,LR,0,450,6,-87,-86,-88,2
31,LR,0,450,8,-87.125,-86,-88,2
31,LR,0,450,2,-88,-88,-88,0
31,LR,0,450,6,-87,-86,-88,2
31,LR,0,450,4,-86.5,-86,-87,1
31,LR,0,450,2,-86.5,-86,-87,1
31,LR,1,450,10,-86.1,-83,-88,5
31,LR,0,450,2,-87.5,-87,-88,1
31,LR,0,450,2,-85,-84,-86,2
31,LR,0,450,8,-86,-83,-88,5
31,LR,1,450,10,-85.5,-82,-88,6
31,LR,0,450,1,-86,-86,-86,0
31,LR,1,450,10,-85.2,-81,-88,7
31,LR,0,450,4,-87,-86,-88,2
31,LR,1,450,9,-84.6666666666667,-81,-87,6
31,LR,1,450,10,-85.2,-81,-90,9
31,LR,0,450,6,-84.6666666666667,-81,-87,6
31,LR,0,450,2,-84,-82,-86,4
31,LR,0,450,6,-85,-81,-90,9
31,LR,0,450,5,-84.8,-81,-90,9
31,LR,0,450,5,-84.2,-81,-90,9
31,LR,0,450,6,-84.5,-80,-90,10
31,LR,0,450,6,-84,-78,-90,12
31,LR,1,450,9,-83.7777777777778,-78,-93,15
31,LR,1,450,9,-82.4444444444444,-76,-93,17
31,LR,0,450,4,-84.25,-78,-93,15
31,LR,0,450,1,-78,-78,-78,0
31,LR,0,450,3,-81.6666666666667,-76,-88,12
31,LR,0,450,5,-79,-76,-83,7
31,LR,0,450,8,-80.375,-77,-83,6
31,LR,0,450,6,-80.3333333333333,-77,-83,6
31,LR,1,450,10,-82.6,-77,-86,9
31,LR,0,450,2,-79.5,-77,-82,5
31,LR,0,450,6,-83.3333333333333,-81,-86,5
31,LR,1,450,9,-83,-80,-86,6
31,LR,0,450,6,-83.5,-80,-86,6
31,LR,0,450,2,-86,-86,-86,0
31,LR,0,450,2,-83,-80,-86,6
31,LR,0,450,2,-81.5,-81,-82,1
31,LR,0,450,7,-84.5714285714286,-81,-88,7
31,LR,0,450,1,-88,-88,-88,0
31,LR,1,450,10,-85.5,-81,-90,9
31,LR,0,450,7,-85,-81,-90,9
31,LR,0,450,2,-84.5,-81,-88,7
31,LR,0,450,6,-86.8333333333333,-82,-90,8
31,LR,0,450,1,-84,-84,-84,0
31,LR,1,450,10,-89,-84,-95,11
31,LR,0,450,6,-88.8333333333333,-84,-92,8
31,LR,0,450,7,-89.7142857142857,-84,-95,11
31,LR,0,450,4,-90,-84,-95,11
31,LR,0,450,5,-89.2,-84,-95,11
31,LR,0,450,8,-88.125,-82,-95,13
31,LR,1,450,9,-85.8888888888889,-80,-95,15
31,LR,1,450,10,-84.1,-80,-90,10
31,LR,0,450,8,-83.5,-80,-88,8
31,LR,0,450,6,-82.5,-80,-88,8
31,LR,0,450,7,-81.5714285714286,-80,-85,5
31,LR,0,450,3,-80,-80,-80,0
31,LR,0,450,7,-83,-80,-89,9
31,LR,0,450,6,-83.5,-80,-89,9
31,LR,1,450,10,-80.9,-77,-89,12
31,LR,0,450,5,-83.2,-79,-89,10
31,LR,0,450,2,-79.5,-79,-80,1
31,LR,1,450,9,-79.3333333333333,-76,-85,9
31,LR,0,450,2,-79,-79,-79,0
31,LR,1,450,9,-80.5555555555556,-76,-90,14
31,LR,0,450,7,-79.4285714285714,-76,-85,9
31,LR,0,450,8,-82.25,-76,-90,14
31,LR,0,450,7,-82.8571428571429,-76,-90,14
31,LR,0,450,7,-84,-81,-91,10
31,LR,0,450,3,-82.3333333333333,-81,-84,3
31,LR,0,450,8,-83.75,-80,-91,11
31,LR,0,450,2,-82,-81,-83,2
31,LR,1,450,10,-83.9,-78,-91,13
31,LR,0,450,3,-82.6666666666667,-80,-85,5
31,LR,0,450,8,-82.75,-78,-88,10
31,LR,0,450,7,-83.1428571428571,-78,-88,10
31,LR,0,450,5,-84.2,-79,-88,9
31,LR,0,450,1,-87,-87,-87,0
31,LR,1,450,10,-85.3,-79,-97,18
31,LR,1,450,10,-85.2,-79,-97,18
31,LR,0,450,7,-85.7142857142857,-79,-97,18
31,LR,0,450,4,-86.25,-79,-97,18
31,LR,0,450,2,-83,-79,-87,8
31,LR,1,450,9,-84.1111111111111,-77,-97,20
31,LR,1,450,9,-84.6666666666667,-77,-97,20
31,LR,0,450,6,-81.6666666666667,-77,-90,13
31,LR,0,450,2,-82,-82,-82,0
31,LR,0,450,3,-80.3333333333333,-77,-82,5
31,LR,0,450,6,-81.8333333333333,-77,-92,15
31,LR,1,450,9,-84.2222222222222,-77,-94,17
31,LR,0,450,7,-84.7142857142857,-77,-94,17
31,LR,0,450,2,-87.5,-83,-92,9
31,LR,0,450,5,-86.6,-80,-94,14
31,LR,1,450,9,-82.8888888888889,-77,-94,17
31,LR,0,450,7,-81.7142857142857,-77,-88,11
31,LR,1,450,9,-82,-77,-88,11
31,LR,0,450,7,-80.5714285714286,-77,-88,11
31,LR,0,450,4,-79.25,-77,-84,7
31,LR,0,450,3,-79.6666666666667,-77,-84,7
31,LR,1,450,10,-86.6,-77,-100,23
31,LR,0,450,3,-86.6666666666667,-80,-93,13
31,LR,0,450,2,-90,-87,-93,6
31,LR,0,450,5,-93,-89,-100,11
31,LR,0,450,1,-92,-92,-92,0
31,LR,0,450,8,-91.5,-82,-100,18
31,LR,0,450,7,-91.8571428571429,-82,-100,18
31,LR,0,450,8,-90.125,-82,-100,18
31,LR,0,450,2,-90.5,-87,-94,7
31,LR,0,450,3,-92,-87,-99,12
31,LR,0,450,1,-99,-99,-99,0
31,LR,0,450,6,-87.6666666666667,-82,-94,12
31,LR,0,450,6,-86.3333333333333,-82,-94,12
31,LR,0,450,3,-86.6666666666667,-82,-91,9
31,LR,0,450,6,-89.1666666666667,-82,-95,13
31,LR,1,450,9,-88.1111111111111,-82,-95,13
31,LR,1,450,9,-87.3333333333333,-82,-95,13
31,LR,1,450,10,-86.1,-79,-95,16
31,LR,0,450,2,-88,-86,-90,4
31,LR,1,450,10,-83.5,-79,-90,11
31,LR,0,450,3,-81.6666666666667,-79,-84,5
31,LR,1,450,10,-84.1,-79,-90,11
31,LR,0,450,8,-83.75,-80,-90,10
31,LR,0,450,6,-84,-80,-90,10
31,LR,0,450,5,-85.2,-82,-90,8
31,LR,1,450,9,-82.7777777777778,-79,-87,8
31,LR,0,450,3,-83.3333333333333,-81,-87,6
31,LR,1,450,10,-83.9,-79,-91,12
31,LR,0,450,1,-80,-80,-80,0
31,LR,0,450,5,-82.6,-79,-87,8
31,LR,0,450,8,-86.25,-79,-91,12
31,LR,0,450,6,-86.6666666666667,-81,-91,10
31,LR,0,450,7,-87.1428571428571,-81,-91,10
31,LR,0,450,6,-87.1666666666667,-81,-91,10
31,LR,1,450,9,-87.2222222222222,-84,-91,7
31,LR,0,450,4,-87.75,-86,-91,5
31,LR,0,450,3,-87.6666666666667,-86,-91,5
31,LR,0,450,5,-86.6,-84,-91,7
31,LR,1,450,9,-85.6666666666667,-82,-88,6
31,LR,0,450,4,-85.25,-84,-87,3
31,LR,0,450,4,-84.75,-82,-87,5
31,LR,0,450,3,-84.6666666666667,-82,-87,5
31,LR,0,450,8,-85.875,-80,-94,14
31,LR,0,450,1,-82,-82,-82,0
31,LR,0,450,3,-87,-80,-94,14
31,LR,0,450,7,-87.8571428571429,-80,-94,14
31,LR,0,450,1,-85,-85,-85,0
31,LR,0,450,5,-88.2,-85,-90,5
31,LR,1,450,10,-88.1,-84,-90,6
31,LR,0,450,5,-87.4,-84,-90,6
31,LR,0,450,2,-87.5,-85,-90,5
31,LR,0,450,2,-86.5,-85,-88,3
31,LR,0,450,3,-86.6666666666667,-84,-88,4
31,LR,0,450,1,-84,-84,-84,0
31,LR,0,450,3,-88,-86,-90,4
31,LR,0,450,1,-90,-90,-90,0
31,LR,0,450,8,-88.875,-86,-92,6
31,LR,1,450,10,-88.3,-84,-92,8
31,LR,0,450,7,-88.7142857142857,-86,-92,6
31,LR,1,450,9,-87.5555555555556,-84,-90,6
31,LR,0,450,4,-87,-86,-88,2
31,LR,1,450,9,-87.5555555555556,-84,-89,5
31,LR,0,450,6,-87.5,-84,-89,5
31,LR,0,450,2,-86,-84,-88,4
31,LR,0,450,6,-87.6666666666667,-84,-89,5
31,LR,0,450,5,-88,-84,-92,8
31,LR,0,450,5,-87.4,-84,-92,8
31,LR,0,450,5,-87.6,-84,-92,8
31,LR,0,450,6,-86.8333333333333,-84,-92,8
31,LR,0,450,4,-87.5,-85,-92,7
31,LR,0,450,5,-86.6,-85,-88,3
31,LR,0,450,1,-85,-85,-85,0
31,LR,0,450,6,-87.5,-85,-92,7
31,LR,0,450,5,-86.8,-85,-88,3
31,LR,0,450,4,-86.75,-86,-88,2
31,LR,0,450,7,-86.8571428571429,-85,-88,3
31,LR,0,450,5,-87.2,-86,-88,2
26,RL,0,450,1,-86,-86,-86,0
26,RL,1,450,10,-79.2,-73,-85,12
26,RL,0,450,8,-79.25,-73,-85,12
26,RL,1,450,10,-77.5,-72,-85,13
26,RL,0,450,2,-83.5,-82,-85,3
26,RL,0,450,5,-76.2,-73,-85,12
26,RL,0,450,3,-73.3333333333333,-73,-74,1
26,RL,1,450,9,-75.6666666666667,-72,-84,12
26,RL,0,450,4,-74.25,-72,-76,4
26,RL,0,450,8,-76.25,-72,-84,12
26,RL,0,450,8,-76,-72,-84,12
26,RL,0,450,6,-77,-73,-84,11
26,RL,0,450,3,-75.3333333333333,-74,-78,4
26,RL,0,450,3,-75.3333333333333,-73,-79,6
26,RL,1,450,10,-79,-73,-84,11
26,RL,0,450,7,-78.5714285714286,-73,-83,10
26,RL,1,450,10,-78.3,-73,-84,11
26,RL,0,450,3,-77.3333333333333,-76,-80,4
26,RL,0,450,4,-78.75,-76,-82,6
26,RL,1,450,9,-79.1111111111111,-73,-84,11
26,RL,1,450,10,-78.2,-73,-84,11
26,RL,0,450,5,-78.8,-73,-84,11
26,RL,0,450,1,-77,-77,-77,0
26,RL,1,450,9,-77.6666666666667,-73,-82,9
26,RL,1,450,10,-77.9,-75,-82,7
26,RL,0,450,7,-78.2857142857143,-75,-82,7
26,RL,0,450,5,-77.6,-75,-82,7
26,RL,0,450,6,-78,-75,-82,7
26,RL,0,450,4,-77.75,-75,-82,7
26,RL,1,450,9,-77.7777777777778,-76,-82,6
26,RL,1,450,10,-78.5,-76,-84,8
26,RL,1,450,9,-78.1111111111111,-76,-84,8
26,RL,0,450,6,-77.3333333333333,-76,-80,4
26,RL,0,450,3,-78.3333333333333,-77,-80,3
26,RL,0,450,3,-77.6666666666667,-76,-80,4
26,RL,0,450,8,-80,-76,-84,8
26,RL,0,450,5,-80.4,-76,-84,8
26,RL,0,450,3,-81,-76,-84,8
26,RL,0,450,4,-80.75,-76,-83,7
26,RL,0,450,3,-82.3333333333333,-82,-83,1
26,RL,0,450,1,-82,-82,-82,0
26,RL,1,450,9,-80.6666666666667,-76,-84,8
26,RL,1,450,10,-81.8,-78,-88,10
26,RL,0,450,3,-80.3333333333333,-78,-84,6
26,RL,0,450,2,-78.5,-78,-79,1
26,RL,0,450,1,-78,-78,-78,0
26,RL,0,450,6,-82.3333333333333,-79,-88,9
26,RL,1,450,9,-81.1111111111111,-76,-88,12
26,RL,0,450,1,-84,-84,-84,0
26,RL,0,450,6,-81.1666666666667,-76,-88,12
26,RL,0,450,5,-81.6,-76,-88,12
26,RL,1,450,10,-79.5,-76,-87,11
26,RL,0,450,4,-80,-76,-87,11
26,RL,0,450,1,-87,-87,-87,0
26,RL,0,450,5,-78,-76,-80,4
26,RL,0,450,1,-77,-77,-77,0
26,RL,0,450,1,-80,-80,-80,0
26,RL,0,450,3,-79.3333333333333,-77,-84,7
26,RL,0,450,8,-78.125,-73,-85,12
26,RL,0,450,2,-80.5,-77,-84,7
26,RL,0,450,1,-77,-77,-77,0
26,RL,1,450,9,-75.5555555555556,-72,-79,7
26,RL,0,450,5,-75.4,-73,-79,6
26,RL,1,450,10,-76.1,-72,-79,7
26,RL,0,450,4,-75.5,-73,-78,5
26,RL,0,450,2,-75.5,-73,-78,5
26,RL,0,450,2,-75,-72,-78,6
26,RL,0,450,7,-76.8571428571429,-72,-79,7
26,RL,0,450,7,-77.1428571428571,-74,-79,5
26,RL,1,450,9,-77.1111111111111,-74,-79,5
26,RL,0,450,1,-79,-79,-79,0
26,RL,0,450,8,-76.625,-74,-79,5
26,RL,0,450,4,-76.25,-74,-79,5
26,RL,0,450,1,-79,-79,-79,0
26,RL,0,450,4,-76,-74,-78,4
26,RL,0,450,8,-75.375,-73,-78,5
26,RL,0,450,1,-74,-74,-74,0
26,RL,0,450,2,-75.5,-73,-78,5
26,RL,0,450,5,-76.6,-74,-78,4
26,RL,0,450,8,-77.5,-74,-79,5
26,RL,0,450,5,-76.8,-74,-79,5
26,RL,0,450,3,-77.6666666666667,-75,-79,4
26,RL,0,450,2,-77,-75,-79,4
26,RL,0,450,6,-76.6666666666667,-73,-79,6
26,RL,0,450,6,-76.6666666666667,-73,-79,6
26,RL,0,450,3,-75,-73,-78,5
26,RL,0,450,4,-77,-74,-79,5
26,RL,0,450,4,-76.75,-73,-79,6
26,RL,0,450,8,-77.375,-73,-80,7
26,RL,0,450,5,-77.4,-73,-79,6
26,RL,1,450,9,-77.4444444444444,-73,-80,7
26,RL,0,450,6,-78,-75,-80,5
26,RL,1,450,10,-78.8,-75,-83,8
26,RL,0,450,1,-79,-79,-79,0
26,RL,0,450,3,-77.6666666666667,-75,-80,5
26,RL,0,450,8,-78.625,-74,-83,9
26,RL,0,450,5,-78.6,-76,-83,7
26,RL,0,450,1,-78,-78,-78,0
26,RL,0,450,3,-79,-76,-83,7
26,RL,0,450,1,-83,-83,-83,0
26,RL,0,450,5,-77.2,-74,-82,8
26,RL,0,450,4,-76,-74,-77,3
26,RL,0,450,4,-76.25,-76,-77,1
26,RL,0,450,4,-75.5,-73,-77,4
26,RL,0,450,1,-76,-76,-76,0
26,RL,0,450,8,-75.375,-73,-79,6
26,RL,0,450,5,-75.6,-73,-79,6
26,RL,0,450,1,-79,-79,-79,0
26,RL,0,450,8,-75.5,-73,-79,6
26,RL,1,450,10,-76.1,-73,-79,6
26,RL,0,450,7,-76,-73,-78,5
26,RL,1,450,9,-76.6666666666667,-74,-78,4
26,RL,0,450,2,-77.5,-77,-78,1
26,RL,0,450,8,-76.375,-74,-78,4
26,RL,0,450,6,-76.5,-74,-78,4
26,RL,0,450,8,-76.125,-73,-78,5
26,RL,0,450,1,-76,-76,-76,0
26,RL,0,450,6,-76.5,-73,-79,6
26,RL,1,450,9,-76.3333333333333,-73,-79,6
26,RL,0,450,5,-76.8,-73,-79,6
26,RL,0,450,6,-77,-73,-79,6
26,RL,0,450,2,-78.5,-78,-79,1
26,RL,1,450,10,-77.5,-74,-80,6
26,RL,1,450,9,-78.1111111111111,-76,-80,4
26,RL,0,450,2,-78,-76,-80,4
26,RL,0,450,3,-77,-76,-78,2
26,RL,0,450,4,-78,-77,-79,2
26,RL,1,450,9,-78,-75,-80,5
26,RL,0,450,7,-77.8571428571429,-75,-80,5
26,RL,0,450,6,-77.8333333333333,-75,-80,5
26,RL,1,450,9,-77.4444444444444,-75,-80,5
26,RL,0,450,2,-77.5,-75,-80,5
26,RL,0,450,5,-78,-75,-80,5
26,RL,0,450,2,-77.5,-75,-80,5
26,RL,0,450,2,-79.5,-79,-80,1
26,RL,0,450,5,-76.8,-75,-79,4
26,RL,0,450,4,-76.25,-75,-79,4
26,RL,0,450,4,-78,-75,-83,8
26,RL,0,450,8,-77.875,-75,-83,8
26,RL,0,450,4,-78.75,-75,-83,8
26,RL,0,450,4,-80.75,-77,-84,7
26,RL,0,450,8,-80.5,-73,-88,15
26,RL,1,450,9,-79.7777777777778,-73,-88,15
26,RL,0,450,1,-78,-78,-78,0
26,RL,0,450,8,-79.75,-73,-88,15
26,RL,0,450,6,-79.8333333333333,-74,-88,14
26,RL,0,450,7,-81.2857142857143,-74,-88,14
26,RL,1,450,9,-79.2222222222222,-74,-84,10
26,RL,0,450,8,-79.875,-74,-84,10
26,RL,0,450,8,-80.625,-74,-84,10
26,RL,1,450,10,-78.1,-74,-84,10
26,RL,1,450,10,-77.9,-74,-85,11
26,RL,0,450,2,-77,-74,-80,6
26,RL,0,450,2,-76.5,-74,-79,5
26,RL,1,450,9,-79.5555555555556,-75,-86,11
26,RL,0,450,6,-78.6666666666667,-75,-85,10
26,RL,0,450,4,-79.75,-75,-85,10
26,RL,0,450,3,-81.3333333333333,-79,-85,6
26,RL,0,450,6,-81.5,-78,-86,8
26,RL,0,450,6,-80.5,-78,-86,8
26,RL,0,450,2,-78.5,-78,-79,1
26,RL,1,450,9,-80.7777777777778,-76,-87,11
26,RL,0,450,3,-82.3333333333333,-79,-86,7
26,RL,0,450,4,-79.75,-76,-82,6
26,RL,0,450,2,-80.5,-79,-82,3
26,RL,0,450,3,-81.6666666666667,-76,-87,11
26,RL,0,450,2,-81.5,-76,-87,11
26,RL,0,450,8,-79.5,-76,-87,11
26,RL,0,450,6,-78.5,-76,-80,4
26,RL,0,450,7,-77.8571428571429,-76,-80,4
26,RL,1,450,10,-77.8,-76,-80,4
26,RL,0,450,1,-80,-80,-80,0
26,RL,1,450,10,-77.4,-76,-79,3
26,RL,0,450,1,-78,-78,-78,0
26,RL,0,450,8,-77.25,-76,-79,3
26,RL,1,450,10,-77.2,-73,-79,6
26,RL,1,450,9,-77.3333333333333,-73,-79,6
26,RL,1,450,9,-76.8888888888889,-73,-79,6
26,RL,0,450,1,-77,-77,-77,0
26,RL,0,450,4,-78,-77,-79,2
26,RL,0,450,7,-76.5714285714286,-73,-79,6
26,RL,0,450,2,-78.5,-78,-79,1
26,RL,1,450,10,-77.3,-73,-79,6
26,RL,0,450,5,-76.4,-73,-79,6
26,RL,0,450,4,-78.75,-78,-79,1
26,RL,0,450,3,-79,-79,-79,0
26,RL,0,450,7,-78.4285714285714,-77,-80,3
26,RL,0,450,1,-79,-79,-79,0
26,RL,0,450,8,-76.875,-73,-80,7
26,RL,0,450,7,-76.7142857142857,-73,-80,7
26,RL,1,450,9,-76.1111111111111,-73,-80,7
26,RL,1,450,9,-76.3333333333333,-73,-80,7
26,RL,0,450,7,-75.2857142857143,-73,-79,6
26,RL,0,450,5,-75.2,-73,-79,6
26,RL,0,450,5,-76.6,-73,-80,7
26,RL,0,450,5,-76.6,-73,-80,7
26,RL,0,450,3,-77.3333333333333,-73,-80,7
26,RL,0,450,1,-80,-80,-80,0
26,RL,1,450,9,-77.8888888888889,-74,-81,7
26,RL,0,450,5,-76.8,-74,-80,6
26,RL,0,450,3,-76.6666666666667,-74,-78,4
26,RL,0,450,2,-76,-74,-78,4
26,RL,0,450,7,-78,-74,-81,7
26,RL,0,450,4,-78.5,-75,-81,6
26,RL,1,450,9,-76.1111111111111,-73,-80,7
26,RL,0,450,6,-77.3333333333333,-73,-80,7
26,RL,0,450,3,-75.6666666666667,-73,-79,6
26,RL,0,450,5,-75.4,-73,-79,6
26,RL,0,450,6,-74.1666666666667,-73,-79,6
26,RL,1,450,9,-75.5555555555556,-73,-82,9
26,RL,0,450,1,-73,-73,-73,0
26,RL,1,450,10,-77,-73,-82,9
26,RL,0,450,2,-73.5,-73,-74,1
26,RL,1,450,10,-77.7,-74,-82,8
26,RL,1,450,10,-78.2,-74,-82,8
26,RL,0,450,8,-78.625,-74,-82,8
26,RL,0,450,5,-79.6,-74,-82,8
26,RL,1,450,9,-79.1111111111111,-75,-82,7
26,RL,0,450,8,-78.75,-75,-82,7
26,RL,0,450,2,-80,-78,-82,4
26,RL,0,450,2,-76.5,-75,-78,3
26,RL,0,450,7,-78.2857142857143,-74,-81,7
26,RL,0,450,7,-78.7142857142857,-74,-82,8
26,RL,0,450,8,-78.75,-74,-82,8
26,RL,0,450,8,-79.75,-74,-82,8
26,RL,0,450,1,-79,-79,-79,0
26,RL,0,450,7,-79.8571428571429,-74,-82,8
26,RL,0,450,2,-80.5,-79,-82,3
26,RL,0,450,8,-79.125,-74,-82,8
26,RL,1,450,9,-78.7777777777778,-74,-83,9
26,RL,0,450,7,-79,-74,-83,9
26,RL,1,450,10,-78.3,-73,-83,10
26,RL,0,450,7,-77.1428571428571,-73,-83,10
26,RL,0,450,8,-78.375,-73,-83,10
26,RL,0,450,2,-78,-75,-81,6
26,RL,0,450,5,-79.6,-73,-83,10
26,RL,0,450,8,-78.375,-73,-83,10
26,RL,1,450,10,-78.7,-74,-83,9
26,RL,0,450,3,-81.3333333333333,-79,-83,4
26,RL,0,450,7,-77.5714285714286,-74,-82,8
26,RL,1,450,9,-76.5555555555556,-74,-81,7
26,RL,0,450,7,-77.2857142857143,-74,-81,7
26,RL,0,450,3,-77.6666666666667,-74,-81,7
26,RL,0,450,8,-77.375,-74,-81,7
26,RL,1,450,10,-77.5,-74,-86,12
26,RL,0,450,8,-76.75,-74,-84,10
26,RL,0,450,2,-76.5,-74,-79,5
26,RL,1,450,9,-79.4444444444444,-74,-88,14
26,RL,0,450,5,-76.4,-74,-84,10
26,RL,1,450,10,-79.6,-74,-88,14
26,RL,0,450,5,-80,-75,-86,11
26,RL,0,450,5,-83.4,-79,-88,9
26,RL,0,450,2,-83,-80,-86,6
26,RL,0,450,7,-80.5714285714286,-74,-88,14
26,RL,0,450,8,-79.75,-74,-88,14
26,RL,0,450,4,-77,-74,-80,6
26,RL,0,450,8,-78.25,-74,-88,14
26,RL,1,450,9,-77.8888888888889,-74,-88,14
26,RL,0,450,3,-80.6666666666667,-75,-88,13
26,RL,0,450,6,-77.3333333333333,-75,-80,5
26,RL,0,450,7,-76.2857142857143,-74,-80,6
26,RL,0,450,5,-77.4,-74,-83,9
26,RL,0,450,1,-75,-75,-75,0
26,RL,0,450,6,-77.5,-74,-83,9
26,RL,0,450,1,-83,-83,-83,0
26,RL,0,450,8,-77,-74,-80,6
26,RL,1,450,9,-76.7777777777778,-74,-80,6
26,RL,0,450,4,-75.75,-74,-80,6
26,RL,0,450,4,-77,-74,-80,6
26,RL,0,450,3,-77.6666666666667,-74,-80,6
26,RL,0,450,2,-79.5,-79,-80,1
26,RL,0,450,3,-80.3333333333333,-75,-86,11
26,RL,0,450,4,-79,-75,-86,11
26,RL,1,450,9,-80.6666666666667,-75,-86,11
26,RL,0,450,1,-75,-75,-75,0
26,RL,0,450,2,-77.5,-76,-79,3
26,RL,0,450,3,-80.6666666666667,-76,-85,9
26,RL,1,450,10,-79.9,-74,-85,11
26,RL,0,450,4,-81.25,-80,-84,4
26,RL,1,450,9,-79.5555555555556,-74,-85,11
26,RL,0,450,4,-76,-74,-81,7
26,RL,0,450,2,-74.5,-74,-75,1
26,RL,0,450,7,-80.4285714285714,-74,-86,12
26,RL,0,450,7,-81.1428571428571,-74,-86,12
26,RL,0,450,6,-80.5,-74,-86,12
26,RL,0,450,7,-79.1428571428571,-74,-86,12
26,RL,0,450,3,-80,-74,-86,12
26,RL,0,450,4,-80,-74,-86,12
26,RL,0,450,2,-77,-74,-80,6
26,RL,0,450,5,-80.2,-76,-84,8
26,RL,0,450,4,-80.25,-76,-84,8
26,RL,1,450,10,-80.1,-74,-89,15
26,RL,0,450,1,-80,-80,-80,0
26,RL,1,450,10,-81.5,-74,-91,17
26,RL,0,450,7,-81.1428571428571,-74,-91,17
26,RL,1,450,10,-81,-74,-91,17
26,RL,0,450,7,-82,-74,-91,17
26,RL,0,450,8,-80.875,-74,-91,17
26,RL,0,450,7,-81,-74,-91,17
26,RL,0,450,3,-83.6666666666667,-80,-91,11
26,RL,0,450,7,-82.5714285714286,-75,-91,16
26,RL,0,450,7,-82.2857142857143,-75,-90,15
26,RL,0,450,2,-78,-76,-80,4
26,RL,0,450,4,-81.75,-75,-90,15
26,RL,1,450,10,-83,-75,-90,15
26,RL,0,450,2,-82.5,-75,-90,15
26,RL,1,450,9,-83.2222222222222,-75,-90,15
26,RL,1,450,9,-81.5555555555556,-75,-89,14
26,RL,1,450,9,-80,-75,-88,13
26,RL,0,450,7,-80.7142857142857,-75,-88,13
26,RL,1,450,10,-80.8,-75,-88,13
26,RL,0,450,3,-81,-75,-88,13
26,RL,1,450,9,-78.3333333333333,-72,-88,16
26,RL,0,450,3,-76.6666666666667,-75,-80,5
26,RL,1,450,9,-77.2222222222222,-68,-88,20
26,RL,0,450,3,-80.6666666666667,-75,-87,12
26,RL,0,450,4,-82,-73,-88,15
26,RL,0,450,5,-76.2,-68,-88,20
26,RL,0,450,4,-72.5,-68,-77,9
26,RL,0,450,8,-78.75,-72,-88,16
26,RL,0,450,1,-68,-68,-68,0
26,RL,0,450,4,-80,-77,-85,8
26,RL,0,450,8,-78,-68,-88,20
26,RL,0,450,5,-75,-68,-79,11
26,RL,1,450,9,-77.8888888888889,-68,-88,20
26,RL,0,450,1,-75,-75,-75,0
26,RL,0,450,8,-76.75,-68,-85,17
26,LR,0,450,8,-84.5,-80,-90,10
26,LR,0,450,4,-84.5,-80,-90,10
26,LR,0,450,4,-83.25,-80,-90,10
26,LR,0,450,6,-85.1666666666667,-80,-90,10
26,LR,0,450,7,-87.1428571428571,-81,-94,13
26,LR,0,450,1,-81,-81,-81,0
26,LR,1,450,9,-84.8888888888889,-80,-94,14
26,LR,0,450,1,-85,-85,-85,0
26,LR,0,450,2,-91,-88,-94,6
26,LR,0,450,2,-89.5,-85,-94,9
26,LR,0,450,5,-82,-80,-85,5
26,LR,0,450,4,-80.75,-80,-82,2
26,LR,0,450,5,-84.4,-80,-93,13
26,LR,0,450,5,-86,-79,-93,14
26,LR,0,450,7,-82.2857142857143,-78,-87,9
26,LR,0,450,2,-81.5,-79,-84,5
26,LR,1,450,10,-83.5,-78,-92,14
26,LR,1,450,9,-83.4444444444444,-78,-92,14
26,LR,0,450,3,-79.6666666666667,-78,-82,4
26,LR,1,450,10,-85.3,-78,-92,14
26,LR,0,450,6,-84.5,-82,-92,10
26,LR,0,450,2,-82.5,-82,-83,1
26,LR,1,450,9,-87.8888888888889,-79,-96,17
26,LR,0,450,7,-89,-79,-96,17
26,LR,0,450,2,-88.5,-88,-89,1
26,LR,0,450,7,-87.4285714285714,-79,-96,17
26,LR,1,450,9,-84.2222222222222,-77,-96,19
26,LR,0,450,6,-84.8333333333333,-77,-96,19
26,LR,1,450,9,-83.1111111111111,-75,-96,21
26,LR,0,450,5,-81.4,-77,-87,10
26,LR,0,450,8,-82.125,-75,-87,12
26,LR,0,450,4,-79.5,-75,-84,9
26,LR,1,450,10,-80.6,-75,-86,11
26,LR,0,450,2,-78.5,-75,-82,7
26,LR,0,450,6,-81.8333333333333,-75,-86,11
26,LR,0,450,5,-83.2,-80,-86,6
26,LR,1,450,9,-81.5555555555556,-76,-87,11
26,LR,0,450,7,-80.4285714285714,-76,-84,8
26,LR,0,450,4,-80,-76,-84,8
26,LR,0,450,5,-80.2,-76,-84,8
26,LR,0,450,2,-76.5,-76,-77,1
26,LR,0,450,7,-84.4285714285714,-77,-90,13
26,LR,1,450,9,-84.8888888888889,-80,-90,10
26,LR,0,450,4,-85.75,-80,-90,10
26,LR,0,450,6,-85.5,-80,-90,10
26,LR,0,450,1,-90,-90,-90,0
26,LR,0,450,5,-83,-80,-87,7
26,LR,1,450,10,-85.3,-80,-91,11
26,LR,0,450,3,-83,-80,-87,7
26,LR,0,450,5,-84.4,-80,-87,7
26,LR,0,450,6,-86,-80,-91,11
26,LR,0,450,3,-84.3333333333333,-80,-87,7
26,LR,0,450,7,-88.4285714285714,-83,-95,12
26,LR,0,450,7,-88.4285714285714,-83,-95,12
26,LR,0,450,5,-88.4,-83,-95,12
26,LR,1,450,10,-86,-80,-95,15
26,LR,0,450,8,-85.5,-80,-94,14
26,LR,0,450,8,-84.875,-80,-94,14
26,LR,0,450,5,-85.6,-80,-94,14
26,LR,0,450,1,-80,-80,-80,0
26,LR,0,450,3,-88,-81,-92,11
26,LR,0,450,6,-86.6666666666667,-81,-91,10
26,LR,0,450,8,-84.75,-79,-97,18
26,LR,0,450,1,-88,-88,-88,0
26,LR,0,450,4,-85.5,-79,-97,18
26,LR,0,450,2,-88,-79,-97,18
26,LR,1,450,10,-86.1,-79,-97,18
26,LR,0,450,8,-86,-79,-97,18
26,LR,0,450,1,-80,-80,-80,0
26,LR,0,450,8,-88.5,-78,-97,19
26,LR,0,450,2,-88.5,-84,-93,9
26,LR,0,450,2,-86,-79,-93,14
26,LR,0,450,8,-85.375,-78,-94,16
26,LR,0,450,7,-84.1428571428571,-78,-92,14
26,LR,0,450,6,-85.1666666666667,-78,-92,14
26,LR,0,450,6,-84.1666666666667,-78,-92,14
26,LR,0,450,3,-86.6666666666667,-80,-92,12
26,LR,0,450,6,-84,-80,-88,8
26,LR,0,450,1,-88,-88,-88,0
26,LR,0,450,6,-84,-81,-88,7
26,LR,0,450,3,-85,-81,-88,7
26,LR,0,450,3,-85,-81,-88,7
26,LR,1,450,9,-82.8888888888889,-76,-88,12
26,LR,1,450,10,-84.5,-76,-93,17
26,LR,0,450,4,-82.5,-76,-87,11
26,LR,0,450,1,-76,-76,-76,0
26,LR,0,450,8,-85.375,-80,-93,13
26,LR,0,450,4,-84,-80,-88,8
26,LR,0,450,1,-80,-80,-80,0
26,LR,0,450,7,-88.5714285714286,-81,-99,18
26,LR,0,450,1,-93,-93,-93,0
26,LR,0,450,3,-86.3333333333333,-81,-95,14
26,LR,0,450,8,-84.875,-81,-99,18
26,LR,0,450,3,-87,-81,-99,18
26,LR,0,450,8,-86.25,-81,-99,18
26,LR,0,450,6,-83.5,-81,-88,7
26,LR,1,450,9,-85.8888888888889,-81,-92,11
26,LR,0,450,4,-84.75,-82,-88,6
26,LR,0,450,2,-86,-84,-88,4
26,LR,0,450,7,-86.7142857142857,-81,-92,11
26,LR,0,450,5,-87.6,-81,-92,11
26,LR,0,450,6,-86.5,-81,-94,13
26,LR,1,450,9,-85.2222222222222,-81,-94,13
26,LR,0,450,1,-81,-81,-81,0
26,LR,0,450,8,-85.125,-81,-94,13
26,LR,1,450,9,-86.3333333333333,-82,-94,12
26,LR,0,450,1,-82,-82,-82,0
26,LR,0,450,8,-85.375,-82,-90,8
26,LR,0,450,3,-85.6666666666667,-84,-87,3
26,LR,1,450,10,-85.8,-82,-90,8
26,LR,0,450,8,-85.625,-82,-90,8
26,LR,0,450,7,-85.4285714285714,-82,-90,8
26,LR,1,450,10,-85.9,-82,-94,12
26,LR,0,450,3,-85,-82,-87,5
26,LR,0,450,8,-85.25,-82,-94,12
26,LR,0,450,1,-86,-86,-86,0
26,LR,0,450,4,-84.5,-83,-87,4
26,LR,0,450,6,-86.6666666666667,-82,-94,12
26,LR,1,450,10,-90,-82,-98,16
26,LR,0,450,5,-89.4,-82,-98,16
26,LR,0,450,2,-88,-82,-94,12
26,LR,0,450,7,-90.8571428571429,-82,-98,16
26,LR,0,450,6,-92.3333333333333,-87,-98,11
26,LR,0,450,5,-92.8,-87,-98,11
26,LR,0,450,4,-91.5,-87,-95,8
26,LR,0,450,2,-89.5,-87,-92,5
26,LR,0,450,1,-87,-87,-87,0
26,LR,0,450,7,-92.1428571428571,-87,-100,13
26,LR,1,450,9,-88.7777777777778,-83,-100,17
26,LR,0,450,2,-89.5,-89,-90,1
26,LR,0,450,6,-85.8333333333333,-83,-89,6
26,LR,1,450,9,-87.8888888888889,-83,-94,11
26,LR,1,450,9,-88.2222222222222,-83,-94,11
26,LR,1,450,10,-88.6,-83,-94,11
26,LR,1,450,10,-88.8,-83,-92,9
26,LR,0,450,5,-89.4,-83,-92,9
26,LR,0,450,2,-87.5,-83,-92,9
26,LR,0,450,5,-87.6,-83,-92,9
26,LR,1,450,10,-88.5,-85,-93,8
26,LR,0,450,5,-89.2,-85,-92,7
26,LR,0,450,6,-89.1666666666667,-85,-93,8
26,LR,0,450,2,-89.5,-89,-90,1
26,LR,0,450,8,-88.125,-84,-93,9
26,LR,1,450,10,-88.4,-84,-94,10
26,LR,0,450,8,-87.5,-84,-93,9
26,LR,0,450,6,-86.5,-84,-91,7
26,LR,0,450,7,-88.1428571428571,-84,-94,10
26,LR,0,450,8,-88.75,-85,-94,9
26,LR,0,450,2,-90,-86,-94,8
26,LR,0,450,3,-89.3333333333333,-87,-94,7
26,LR,1,450,9,-89,-85,-94,9
26,LR,1,450,10,-89.6,-85,-97,12
26,LR,0,450,1,-90,-90,-90,0
26,LR,0,450,1,-89,-89,-89,0
26,LR,0,450,2,-89.5,-85,-94,9
26,LR,0,450,6,-91.1666666666667,-86,-97,11
26,LR,1,450,9,-89.7777777777778,-84,-99,15
26,LR,0,450,1,-89,-89,-89,0
26,LR,1,450,9,-90.1111111111111,-84,-99,15
26,LR,0,450,2,-87.5,-86,-89,3
26,LR,0,450,1,-89,-89,-89,0
26,LR,1,450,9,-88.7777777777778,-84,-99,15
26,LR,0,450,3,-89.6666666666667,-84,-99,15
26,LR,0,450,3,-88.6666666666667,-84,-96,12
26,LR,1,450,10,-88.6,-85,-99,14
26,LR,1,450,9,-88.6666666666667,-85,-99,14
26,LR,1,450,9,-89,-86,-99,13
26,LR,1,450,9,-89,-86,-99,13
26,LR,0,450,6,-89.5,-86,-99,13
26,LR,0,450,3,-90.3333333333333,-86,-99,13
26,LR,0,450,3,-88,-87,-89,2
26,LR,0,450,8,-89.625,-86,-96,10
26,LR,0,450,3,-89.6666666666667,-88,-92,4
26,LR,0,450,4,-90.5,-86,-96,10
26,LR,0,450,5,-89.8,-86,-96,10
26,LR,0,450,5,-89.6,-86,-96,10
26,LR,0,450,1,-86,-86,-86,0
26,LR,1,450,10,-85.7,-83,-93,10
26,LR,0,450,4,-86.25,-83,-88,5
26,LR,0,450,6,-84,-83,-88,5
26,LR,0,450,6,-83,-82,-84,2
26,LR,0,450,7,-84.2857142857143,-82,-88,6
26,LR,0,450,3,-83,-83,-83,0
26,LR,0,450,6,-85,-82,-88,6
26,LR,0,450,7,-85.8571428571429,-82,-88,6
26,LR,0,450,6,-86.5,-82,-88,6
26,LR,0,450,6,-85,-79,-88,9
26,LR,0,450,6,-84.8333333333333,-79,-88,9
26,LR,0,450,4,-83.75,-79,-88,9
26,LR,1,450,9,-85.6666666666667,-79,-88,9
26,LR,0,450,8,-85.375,-79,-88,9
26,LR,0,450,8,-85,-79,-88,9
26,LR,0,450,5,-86.4,-84,-88,4
26,LR,1,450,9,-84.5555555555556,-82,-88,6
26,LR,0,450,6,-84.5,-82,-88,6
26,LR,1,450,9,-82.6666666666667,-80,-88,8
26,LR,1,450,10,-83.4,-80,-88,8
26,LR,0,450,8,-83.75,-80,-88,8
26,LR,0,450,2,-84.5,-81,-88,7
26,LR,0,450,8,-85.875,-80,-90,10
26,LR,1,450,9,-85.4444444444444,-78,-92,14
26,LR,1,450,10,-84.5,-76,-92,16
26,LR,0,450,3,-87.3333333333333,-86,-89,3
26,LR,1,450,10,-82.6,-75,-92,17
26,LR,0,450,2,-88,-86,-90,4
26,LR,1,450,9,-80.8888888888889,-75,-92,17
26,LR,0,450,7,-80.1428571428571,-75,-92,17
26,LR,0,450,2,-77,-76,-78,2
26,LR,0,450,7,-79.1428571428571,-75,-82,7
26,LR,0,450,8,-79.25,-75,-82,7
26,LR,0,450,6,-78.6666666666667,-75,-82,7
26,LR,1,450,9,-80.2222222222222,-75,-84,9
26,LR,0,450,3,-79.3333333333333,-75,-82,7
26,LR,0,450,7,-80.1428571428571,-75,-84,9
26,LR,0,450,6,-79.8333333333333,-75,-84,9
26,LR,0,450,1,-83,-83,-83,0
26,LR,0,450,4,-82.75,-80,-84,4
26,LR,0,450,5,-84.2,-80,-90,10
26,LR,0,450,2,-83.5,-83,-84,1
26,LR,0,450,6,-83.6666666666667,-79,-90,11
26,LR,1,450,10,-83.7,-79,-90,11
26,LR,0,450,8,-82.375,-79,-86,7
26,LR,0,450,1,-79,-79,-79,0
26,LR,0,450,8,-84,-79,-88,9
26,LR,0,450,8,-85.25,-80,-93,13
26,LR,0,450,2,-81.5,-80,-83,3
26,LR,1,450,10,-87.5,-82,-94,12
26,LR,0,450,2,-86,-84,-88,4
26,LR,0,450,2,-88,-88,-88,0
26,LR,0,450,4,-88.25,-82,-94,12
26,LR,0,450,3,-90.3333333333333,-84,-94,10
26,LR,0,450,5,-89,-84,-94,10
26,LR,1,450,10,-84.3,-79,-90,11
26,LR,0,450,5,-84,-79,-89,10
26,LR,0,450,1,-88,-88,-88,0
26,LR,1,450,10,-81.3,-76,-87,11
26,LR,0,450,6,-82.3333333333333,-79,-87,8
26,LR,0,450,5,-83,-80,-87,7
26,LR,0,450,3,-83,-80,-87,7
26,LR,1,450,10,-80.8,-76,-87,11
26,LR,0,450,7,-78.7142857142857,-76,-82,6
26,LR,1,450,9,-78.8888888888889,-76,-84,8
26,LR,0,450,2,-79,-76,-82,6
26,LR,0,450,7,-79.5714285714286,-76,-84,8
26,LR,0,450,3,-78,-76,-81,5
26,LR,0,450,5,-79.8,-77,-84,7
26,LR,0,450,6,-80.6666666666667,-78,-84,6
26,LR,0,450,2,-78.5,-78,-79,1
26,LR,0,450,4,-80.5,-79,-82,3
26,LR,0,450,6,-81,-76,-88,12
26,LR,0,450,5,-80.8,-76,-88,12
26,LR,1,450,10,-82.4,-76,-89,13
26,LR,0,450,4,-80.75,-76,-88,12
26,LR,0,450,1,-79,-79,-79,0
26,LR,1,450,9,-83,-78,-89,11
26,LR,0,450,7,-83,-78,-89,11
26,LR,1,450,10,-82.8,-78,-89,11
26,LR,0,450,7,-82.2857142857143,-78,-89,11
26,LR,1,450,10,-82,-78,-89,11
26,LR,0,450,7,-80.8571428571429,-78,-86,8
26,LR,0,450,5,-81.2,-78,-86,8
26,LR,0,450,3,-80.3333333333333,-78,-85,7
26,LR,1,450,9,-83.2222222222222,-78,-90,12
26,LR,0,450,2,-82,-78,-86,8
26,LR,0,450,3,-83.3333333333333,-82,-86,4
26,LR,0,450,6,-83.3333333333333,-80,-90,10
26,LR,1,450,10,-84,-80,-90,10
26,LR,0,450,1,-80,-80,-80,0
26,LR,0,450,1,-90,-90,-90,0
26,LR,0,450,2,-83,-83,-83,0
26,LR,0,450,5,-83.8,-80,-87,7
26,LR,0,450,1,-86,-86,-86,0
26,LR,0,450,1,-83,-83,-83,0
26,LR,0,450,4,-85,-80,-87,7
26,LR,0,450,3,-86.6666666666667,-86,-87,1
26,LR,0,450,4,-85,-82,-87,5
26,LR,1,450,10,-83.6,-76,-93,17
26,LR,0,450,3,-81,-76,-85,9
26,LR,0,450,6,-81.3333333333333,-76,-90,14
26,LR,0,450,4,-79,-76,-85,9
26,LR,1,450,9,-85.7777777777778,-75,-98,23
26,LR,0,450,5,-85.2,-77,-93,16
26,LR,0,450,7,-88.1428571428571,-75,-98,23
26,LR,0,450,7,-86.1428571428571,-75,-98,23
26,LR,0,450,8,-86.125,-75,-98,23
26,LR,0,450,5,-84.4,-75,-98,23
26,LR,0,450,6,-87.3333333333333,-75,-98,23
26,LR,0,450,4,-83.25,-75,-96,21
26,LR,0,450,4,-83.75,-76,-93,17
26,LR,0,450,8,-86.75,-79,-94,15
26,LR,1,450,10,-87.8,-79,-104,25
26,LR,0,450,8,-85.875,-79,-104,25
26,LR,0,450,3,-95.3333333333333,-90,-104,14
26,LR,0,450,8,-88.5,-80,-104,24
26,LR,0,450,7,-88,-80,-104,24
26,LR,1,450,10,-87.3,-80,-97,17
26,LR,0,450,6,-85.3333333333333,-80,-97,17
26,LR,0,450,3,-87.6666666666667,-81,-97,16
26,LR,0,450,1,-88,-88,-88,0
26,LR,0,450,4,-90.25,-80,-96,16
26,LR,0,450,6,-90,-80,-96,16
26,LR,0,450,3,-91.6666666666667,-90,-94,4
26,LR,0,450,7,-87.1428571428571,-80,-94,14
26,LR,0,450,2,-85,-80,-90,10
26,LR,0,450,4,-85.75,-80,-94,14
26,LR,0,450,4,-86.75,-80,-94,14
26,LR,0,450,6,-85.3333333333333,-80,-94,14
26,LR,0,450,6,-83.5,-80,-90,10
26,LR,0,450,7,-84.4285714285714,-80,-90,10
26,LR,0,450,2,-82.5,-80,-85,5
26,LR,0,450,8,-83.625,-80,-88,8
26,LR,0,450,2,-86.5,-85,-88,3
26,LR,0,450,7,-80.7142857142857,-78,-86,8
26,LR,0,450,2,-83,-80,-86,6
26,LR,0,450,4,-79,-78,-80,2
26,LR,0,450,5,-79.8,-78,-84,6
26,LR,1,450,9,-83,-79,-87,8
26,LR,0,450,6,-84.3333333333333,-79,-87,8
26,LR,0,450,5,-85.4,-84,-87,3
26,LR,0,450,8,-85.125,-83,-87,4
26,LR,0,450,1,-87,-87,-87,0
26,LR,0,450,7,-84.8571428571429,-83,-86,3
26,LR,1,450,10,-84.6,-82,-86,4
26,LR,0,450,5,-84.6,-84,-86,2
26,LR,0,450,1,-85,-85,-85,0
26,LR,0,450,4,-85,-84,-86,2
26,LR,0,450,7,-84,-79,-88,9
26,LR,0,450,2,-84,-82,-86,4
26,LR,0,450,3,-82,-79,-86,7
26,LR,0,450,8,-84.375,-79,-88,9
26,LR,0,450,6,-85.6666666666667,-79,-88,9
26,LR,0,450,4,-86.75,-86,-88,2
26,LR,1,450,9,-85,-80,-88,8
26,LR,0,450,3,-85,-80,-88,8
26,LR,0,450,8,-85,-80,-88,8
26,LR,0,450,7,-85,-83,-88,5
26,LR,0,450,8,-84.5,-83,-88,5
26,LR,0,450,1,-86,-86,-86,0
26,LR,0,450,4,-85,-83,-88,5
26,LR,0,450,7,-85.8571428571429,-83,-90,7
26,LR,1,450,10,-86.4,-82,-92,10
26,LR,0,450,1,-83,-83,-83,0
26,LR,0,450,5,-89,-87,-92,5
26,LR,1,450,9,-86.6666666666667,-82,-92,10
26,LR,1,450,9,-85.7777777777778,-82,-92,10
26,LR,0,450,7,-86.1428571428571,-82,-92,10
26,LR,0,450,2,-87,-82,-92,10
26,LR,1,450,9,-86,-82,-90,8
26,LR,0,450,8,-85.75,-82,-90,8
26,LR,1,450,10,-86.1,-82,-90,8
26,LR,0,450,2,-86,-82,-90,8
26,LR,0,450,8,-87.5,-84,-91,7
26,LR,0,450,5,-86.4,-84,-89,5
26,LR,0,450,5,-86.6,-84,-89,5
26,LR,0,450,3,-86.6666666666667,-84,-89,5
26,LR,0,450,5,-86,-81,-91,10
26,LR,0,450,7,-84.5714285714286,-80,-91,11
26,LR,0,450,2,-86,-81,-91,10
26,LR,0,450,5,-82.8,-80,-87,7
26,LR,0,450,1,-82,-82,-82,0
26,LR,0,450,8,-85.125,-80,-91,11
26,LR,0,450,5,-84.2,-80,-91,11
26,LR,0,450,4,-84.5,-80,-87,7
26,LR,0,450,4,-86.25,-84,-87,3
31,RL,1,500,10,-77.5,-72,-82,10
31,RL,0,500,2,-80,-80,-80,0
31,RL,0,500,4,-79.25,-75,-82,7
31,RL,0,500,6,-79.5,-72,-89,17
31,RL,0,500,5,-82.8,-72,-90,18
31,RL,0,500,3,-84,-78,-89,11
31,RL,0,500,6,-88.6666666666667,-85,-91,6
31,RL,0,500,6,-88.6666666666667,-85,-91,6
31,RL,0,500,5,-88.4,-85,-91,6
31,RL,0,500,1,-88,-88,-88,0
31,RL,1,500,9,-88,-84,-92,8
31,RL,1,500,10,-89.1,-84,-99,15
31,RL,1,500,10,-88.6,-84,-99,15
31,RL,0,500,3,-86.3333333333333,-84,-91,7
31,RL,0,500,1,-84,-84,-84,0
31,RL,0,500,2,-84.5,-84,-85,1
31,RL,0,500,8,-88.375,-82,-99,17
31,RL,1,500,10,-87.1,-82,-99,17
31,RL,0,500,7,-88,-82,-99,17
31,RL,0,500,5,-86.2,-82,-91,9
31,RL,0,500,4,-85,-82,-88,6
31,RL,0,500,4,-85.25,-82,-88,6
31,RL,0,500,2,-85.5,-83,-88,5
31,RL,1,500,9,-82.7777777777778,-78,-88,10
31,RL,1,500,9,-83,-78,-88,10
31,RL,0,500,1,-82,-82,-82,0
31,RL,0,500,6,-82.5,-78,-85,7
31,RL,1,500,10,-82.2,-78,-86,8
31,RL,0,500,2,-84,-84,-84,0
31,RL,1,500,9,-82.1111111111111,-78,-86,8
31,RL,1,500,9,-81.7777777777778,-78,-86,8
31,RL,0,500,8,-82.25,-79,-86,7
31,RL,0,500,8,-81.875,-79,-86,7
31,RL,1,500,10,-81.7,-80,-85,5
31,RL,0,500,6,-82.3333333333333,-81,-85,4
31,RL,0,500,3,-81.6666666666667,-81,-82,1
31,RL,0,500,1,-82,-82,-82,0
31,RL,0,500,3,-81.6666666666667,-81,-82,1
31,RL,0,500,6,-81.1666666666667,-80,-83,3
31,RL,0,500,8,-81.875,-80,-84,4
31,RL,1,500,9,-82.1111111111111,-80,-84,4
31,RL,0,500,5,-82.2,-80,-84,4
31,RL,0,500,8,-82.625,-80,-86,6
31,RL,0,500,4,-83,-82,-84,2
31,RL,1,500,9,-82.4444444444444,-80,-86,6
31,RL,0,500,8,-82.5,-80,-86,6
31,RL,0,500,2,-83,-80,-86,6
31,RL,0,500,8,-82.75,-81,-84,3
31,RL,0,500,4,-83.25,-82,-84,2
31,RL,0,500,2,-83,-82,-84,2
31,RL,0,500,5,-82.6,-82,-84,2
31,RL,0,500,7,-82.4285714285714,-81,-84,3
31,RL,0,500,8,-82.25,-81,-84,3
31,RL,0,500,2,-83,-82,-84,2
31,RL,0,500,4,-82.5,-81,-84,3
31,RL,0,500,3,-82,-81,-83,2
31,RL,0,500,6,-81.8333333333333,-81,-83,2
31,RL,0,500,6,-81.6666666666667,-81,-83,2
31,RL,0,500,4,-81.5,-81,-83,2
31,RL,1,500,10,-80.8,-78,-83,5
31,RL,0,500,2,-81,-81,-81,0
31,RL,0,500,7,-80.7142857142857,-78,-83,5
31,RL,1,500,9,-81,-78,-86,8
31,RL,1,500,10,-81.2,-78,-87,9
31,RL,0,500,6,-81,-78,-86,8
31,RL,1,500,10,-82.9,-78,-87,9
31,RL,0,500,7,-82,-78,-87,9
31,RL,0,500,8,-83.375,-78,-87,9
31,RL,0,500,1,-86,-86,-86,0
31,RL,0,500,2,-86.5,-86,-87,1
31,RL,0,500,6,-81.1666666666667,-78,-87,9
31,RL,0,500,3,-78.3333333333333,-78,-79,1
31,RL,0,500,6,-83.8333333333333,-78,-92,14
31,RL,0,500,7,-86.1428571428571,-78,-92,14
31,RL,0,500,7,-89.5714285714286,-84,-93,9
31,RL,0,500,6,-90.5,-87,-93,6
31,RL,0,500,1,-92,-92,-92,0
31,RL,1,500,9,-86.2222222222222,-80,-93,13
31,RL,0,500,2,-90,-87,-93,6
31,RL,0,500,4,-88.5,-81,-93,12
31,RL,0,500,1,-81,-81,-81,0
31,RL,0,500,4,-86,-80,-92,12
31,RL,1,500,10,-85.3,-80,-94,14
31,RL,0,500,4,-84.5,-80,-90,10
31,RL,0,500,4,-87.5,-84,-92,8
31,RL,0,500,8,-86.625,-81,-94,13
31,RL,0,500,5,-88,-82,-94,12
31,RL,0,500,3,-89.3333333333333,-82,-94,12
31,RL,0,500,1,-94,-94,-94,0
31,RL,0,500,6,-84.5,-81,-90,9
31,RL,0,500,6,-85.6666666666667,-81,-90,9
31,RL,0,500,4,-87,-84,-90,6
31,RL,0,500,6,-85.8333333333333,-84,-90,6
31,RL,0,500,1,-84,-84,-84,0
31,RL,0,500,5,-86.2,-85,-90,5
31,RL,1,500,10,-84.9,-81,-90,9
31,RL,0,500,3,-86.6666666666667,-85,-90,5
31,RL,0,500,8,-84.875,-81,-90,9
31,RL,0,500,5,-86.4,-83,-90,7
31,RL,0,500,6,-84,-81,-88,7
31,RL,0,500,6,-82.6666666666667,-80,-87,7
31,RL,0,500,6,-82.1666666666667,-80,-87,7
31,RL,0,500,5,-81.2,-80,-84,4
31,RL,0,500,4,-81.25,-80,-84,4
31,RL,1,500,10,-84.2,-79,-92,13
31,RL,0,500,8,-84,-79,-92,13
31,RL,0,500,2,-85.5,-82,-89,7
31,RL,0,500,8,-84.625,-79,-92,13
31,RL,0,500,4,-84.5,-79,-87,8
31,RL,0,500,3,-86.3333333333333,-86,-87,1
31,RL,0,500,7,-84.8571428571429,-80,-89,9
31,RL,1,500,9,-83.4444444444444,-80,-89,9
31,RL,0,500,5,-84.2,-80,-89,9
31,RL,0,500,7,-83,-80,-89,9
31,RL,0,500,6,-83.5,-81,-89,8
31,RL,0,500,3,-84,-81,-89,8
31,RL,0,500,6,-82.3333333333333,-81,-86,5
31,RL,0,500,6,-82.5,-81,-86,5
31,RL,1,500,10,-84.5,-81,-87,6
31,RL,0,500,4,-83.25,-81,-86,5
31,RL,0,500,4,-84,-83,-86,3
31,RL,0,500,2,-83,-83,-83,0
31,RL,0,500,8,-85.25,-80,-88,8
31,RL,0,500,7,-85.5714285714286,-80,-88,8
31,RL,0,500,3,-87,-87,-87,0
31,RL,0,500,6,-85,-80,-88,8
31,RL,0,500,6,-83.8333333333333,-80,-88,8
31,RL,0,500,2,-87,-86,-88,2
31,RL,1,500,10,-83.2,-80,-88,8
31,RL,0,500,2,-82.5,-80,-85,5
31,RL,0,500,4,-84,-81,-86,5
31,RL,0,500,8,-83.875,-81,-88,7
31,RL,0,500,6,-82.8333333333333,-81,-85,4
31,RL,0,500,3,-82.3333333333333,-81,-85,4
31,RL,0,500,2,-83,-81,-85,4
31,RL,1,500,9,-84.7777777777778,-80,-90,10
31,RL,0,500,5,-84.8,-80,-90,10
31,RL,1,500,9,-85.2222222222222,-80,-90,10
31,RL,0,500,8,-84.875,-80,-90,10
31,RL,0,500,7,-85.5714285714286,-80,-90,10
31,RL,1,500,9,-85.2222222222222,-80,-89,9
31,RL,0,500,5,-83,-80,-89,9
31,RL,0,500,5,-84.6,-80,-89,9
31,RL,0,500,7,-84.8571428571429,-80,-89,9
31,RL,0,500,1,-80,-80,-80,0
31,RL,0,500,2,-88,-88,-88,0
31,RL,0,500,7,-84.5714285714286,-82,-88,6
31,RL,0,500,4,-84.25,-82,-87,5
31,RL,0,500,5,-83.4,-82,-86,4
31,RL,0,500,7,-83.8571428571429,-82,-86,4
31,RL,0,500,1,-82,-82,-82,0
31,RL,0,500,5,-83.8,-83,-85,2
31,RL,0,500,4,-83.75,-83,-85,2
31,RL,0,500,6,-84.8333333333333,-83,-87,4
31,RL,0,500,7,-85,-83,-87,4
31,RL,0,500,8,-84.5,-82,-87,5
31,RL,0,500,1,-86,-86,-86,0
31,RL,1,500,10,-85.5,-82,-94,12
31,RL,0,500,8,-85.5,-82,-94,12
31,RL,0,500,2,-85,-84,-86,2
31,RL,0,500,7,-85.1428571428571,-82,-94,12
31,RL,1,500,9,-85.5555555555556,-81,-94,13
31,RL,0,500,1,-84,-84,-84,0
31,RL,0,500,3,-86.6666666666667,-82,-94,12
31,RL,0,500,2,-88,-82,-94,12
31,RL,0,500,3,-84,-81,-90,9
31,RL,0,500,5,-84.4,-81,-88,7
31,RL,0,500,1,-81,-81,-81,0
31,RL,1,500,9,-85.4444444444444,-82,-88,6
31,RL,0,500,1,-88,-88,-88,0
31,RL,0,500,7,-84.7142857142857,-82,-88,6
31,RL,0,500,2,-84,-84,-84,0
31,RL,0,500,5,-85,-82,-88,6
31,RL,0,500,6,-86.1666666666667,-82,-92,10
31,RL,1,500,9,-87.1111111111111,-84,-92,8
31,RL,0,500,1,-87,-87,-87,0
31,RL,0,500,6,-86.5,-84,-92,8
31,RL,0,500,3,-86.6666666666667,-84,-92,8
31,RL,1,500,9,-85.8888888888889,-82,-92,10
31,RL,0,500,1,-84,-84,-84,0
31,RL,0,500,6,-85.5,-82,-91,9
31,RL,0,500,4,-84.75,-82,-90,8
31,RL,1,500,10,-82.4,-81,-83,2
31,RL,0,500,4,-82.5,-82,-83,1
31,RL,0,500,3,-82.6666666666667,-82,-83,1
31,RL,0,500,3,-82.6666666666667,-82,-83,1
31,RL,0,500,2,-83,-83,-83,0
31,RL,0,500,6,-83,-81,-86,5
31,RL,0,500,8,-82.5,-79,-86,7
31,RL,0,500,8,-82.875,-79,-86,7
31,RL,1,500,9,-82.3333333333333,-79,-86,7
31,RL,0,500,2,-84.5,-83,-86,3
31,RL,0,500,4,-82.75,-79,-86,7
31,RL,1,500,10,-81.7,-79,-84,5
31,RL,1,500,10,-81.6,-79,-84,5
31,RL,0,500,8,-82,-79,-84,5
31,RL,0,500,3,-81.3333333333333,-80,-84,4
31,RL,0,500,7,-81.2857142857143,-79,-84,5
31,RL,1,500,10,-80.7,-79,-84,5
31,RL,0,500,8,-80.875,-79,-84,5
31,RL,0,500,4,-81.25,-79,-83,4
31,RL,0,500,6,-80.1666666666667,-79,-83,4
31,RL,0,500,6,-80.3333333333333,-79,-83,4
31,RL,0,500,7,-80,-79,-81,2
31,RL,0,500,3,-79.3333333333333,-79,-80,1
31,RL,0,500,4,-79.75,-79,-80,1
31,RL,0,500,8,-81.5,-77,-92,15
31,RL,0,500,5,-82.8,-80,-92,12
31,RL,1,500,10,-81.1,-77,-92,15
31,RL,0,500,6,-81.3333333333333,-77,-92,15
31,RL,0,500,6,-79.6666666666667,-77,-83,6
31,RL,0,500,2,-78,-77,-79,2
31,RL,0,500,8,-82.75,-79,-90,11
31,RL,0,500,7,-83.2857142857143,-79,-90,11
31,RL,0,500,1,-83,-83,-83,0
31,RL,0,500,6,-86,-79,-93,14
31,RL,0,500,6,-87.1666666666667,-84,-93,9
31,RL,0,500,5,-89.4,-85,-93,8
31,RL,0,500,7,-91.7142857142857,-86,-97,11
31,RL,0,500,6,-91.5,-86,-97,11
31,RL,0,500,7,-91,-86,-97,11
31,RL,0,500,5,-88.6,-86,-94,8
31,RL,0,500,8,-85.625,-82,-89,7
31,RL,1,500,10,-84.5,-82,-88,6
31,RL,0,500,7,-84.5714285714286,-82,-86,4
31,RL,0,500,4,-85,-82,-86,4
31,RL,1,500,10,-83.8,-82,-86,4
31,RL,0,500,4,-82.75,-82,-84,2
31,RL,0,500,7,-83,-81,-85,4
31,RL,0,500,8,-82.625,-81,-85,4
31,RL,1,500,10,-82.7,-81,-85,4
31,RL,0,500,1,-84,-84,-84,0
31,RL,0,500,3,-81.6666666666667,-81,-82,1
31,RL,0,500,2,-82,-82,-82,0
31,RL,0,500,6,-82.6666666666667,-81,-85,4
31,RL,0,500,3,-82.6666666666667,-81,-84,3
31,RL,0,500,7,-83.8571428571429,-81,-86,5
31,RL,0,500,6,-83.6666666666667,-81,-86,5
31,RL,0,500,7,-84.7142857142857,-81,-89,8
31,RL,0,500,7,-84.8571428571429,-81,-89,8
31,RL,0,500,1,-85,-85,-85,0
31,RL,0,500,8,-85.25,-81,-89,8
31,RL,0,500,4,-84.75,-81,-89,8
31,RL,0,500,8,-85.375,-82,-89,7
31,RL,0,500,4,-87.25,-85,-89,4
31,RL,0,500,5,-84.8,-82,-88,6
31,RL,0,500,3,-85.6666666666667,-82,-88,6
31,RL,0,500,4,-84.25,-82,-87,5
31,RL,0,500,7,-84.7142857142857,-82,-86,4
31,RL,1,500,10,-84.8,-81,-86,5
31,RL,0,500,1,-86,-86,-86,0
31,RL,0,500,2,-85.5,-85,-86,1
31,RL,0,500,4,-85.75,-85,-86,1
31,RL,0,500,2,-86,-86,-86,0
31,RL,0,500,1,-86,-86,-86,0
31,RL,0,500,1,-86,-86,-86,0
31,RL,0,500,5,-84.6,-81,-87,6
31,RL,1,500,9,-85.6666666666667,-82,-91,9
31,RL,0,500,3,-83.6666666666667,-82,-85,3
31,RL,0,500,1,-84,-84,-84,0
31,RL,1,500,10,-88,-82,-94,12
31,RL,0,500,8,-88.5,-82,-94,12
31,RL,0,500,5,-88,-82,-92,10
31,RL,0,500,7,-90.1428571428571,-85,-94,9
31,RL,0,500,4,-91.75,-90,-94,4
31,RL,0,500,7,-91.4285714285714,-89,-94,5
31,RL,0,500,7,-91.5714285714286,-89,-94,5
31,RL,1,500,10,-91.1,-86,-94,8
31,RL,1,500,9,-90.7777777777778,-86,-94,8
31,RL,0,500,1,-90,-90,-90,0
31,RL,0,500,7,-91.1428571428571,-86,-94,8
31,RL,0,500,3,-93,-92,-94,2
31,RL,0,500,1,-92,-92,-92,0
31,RL,0,500,3,-90,-86,-93,7
31,RL,0,500,1,-86,-86,-86,0
31,RL,0,500,7,-90.1428571428571,-87,-92,5
31,RL,0,500,3,-89.6666666666667,-87,-92,5
31,RL,0,500,1,-87,-87,-87,0
31,RL,0,500,1,-90,-90,-90,0
31,RL,1,500,10,-89,-87,-93,6
31,RL,0,500,5,-88.8,-87,-93,6
31,RL,0,500,6,-88.6666666666667,-87,-93,6
31,RL,0,500,7,-88.7142857142857,-87,-93,6
31,RL,0,500,4,-89,-87,-93,6
31,RL,1,500,10,-89.5,-87,-93,6
31,RL,0,500,2,-87.5,-87,-88,1
31,RL,0,500,1,-90,-90,-90,0
31,RL,0,500,1,-90,-90,-90,0
31,RL,0,500,8,-92,-89,-100,11
31,RL,0,500,5,-90.8,-89,-95,6
31,RL,1,500,10,-91.8,-86,-100,14
31,RL,0,500,1,-89,-89,-89,0
31,RL,0,500,2,-96,-92,-100,8
31,RL,0,500,8,-91.125,-86,-100,14
31,RL,0,500,4,-91.5,-86,-100,14
31,RL,1,500,10,-88.1,-84,-90,6
31,RL,0,500,3,-88.6666666666667,-88,-90,2
31,RL,0,500,3,-89.3333333333333,-88,-90,2
31,RL,0,500,2,-89,-88,-90,2
31,RL,0,500,4,-87.25,-84,-89,5
31,RL,0,500,2,-88,-88,-88,0
31,RL,0,500,6,-88,-84,-96,12
31,RL,0,500,1,-96,-96,-96,0
31,RL,0,500,4,-86,-84,-88,4
31,RL,1,500,10,-87.2,-82,-94,12
31,RL,0,500,5,-86.8,-82,-94,12
31,RL,0,500,5,-87.4,-82,-94,12
31,RL,0,500,7,-87.8571428571429,-82,-94,12
31,RL,0,500,3,-86.3333333333333,-82,-89,7
31,RL,1,500,10,-86.4,-81,-92,11
31,RL,0,500,4,-88.5,-84,-92,8
31,RL,0,500,5,-87.4,-83,-92,9
31,RL,0,500,2,-86,-84,-88,4
31,RL,1,500,10,-83.2,-80,-88,8
31,RL,0,500,6,-81.8333333333333,-80,-84,4
31,RL,0,500,4,-81.25,-80,-83,3
31,RL,1,500,10,-85.5,-80,-92,12
31,RL,0,500,8,-85.375,-82,-92,10
31,RL,1,500,9,-86.7777777777778,-82,-92,10
31,RL,1,500,9,-87,-82,-92,10
31,RL,0,500,8,-88.375,-84,-92,8
31,RL,0,500,4,-89,-86,-92,6
31,RL,0,500,2,-89,-86,-92,6
31,RL,0,500,3,-91,-89,-92,3
31,RL,0,500,2,-86.5,-84,-89,5
31,RL,0,500,1,-84,-84,-84,0
31,RL,0,500,2,-90.5,-89,-92,3
31,RL,0,500,4,-90.5,-89,-92,3
31,RL,0,500,8,-89,-81,-92,11
31,RL,0,500,2,-90.5,-90,-91,1
31,RL,0,500,6,-88.1666666666667,-81,-92,11
31,RL,0,500,2,-91,-90,-92,2
31,RL,0,500,4,-86,-81,-92,11
31,RL,1,500,10,-83.2,-79,-88,9
31,RL,0,500,2,-84,-81,-87,6
31,RL,0,500,1,-87,-87,-87,0
31,RL,0,500,6,-83.3333333333333,-79,-88,9
31,RL,0,500,1,-85,-85,-85,0
31,RL,0,500,3,-82.3333333333333,-79,-84,5
31,RL,0,500,5,-82.2,-79,-88,9
31,RL,0,500,3,-82.3333333333333,-79,-88,9
31,RL,0,500,2,-80,-80,-80,0
31,RL,0,500,1,-80,-80,-80,0
31,RL,0,500,7,-82.2857142857143,-79,-89,10
31,RL,0,500,8,-82.75,-79,-89,10
31,RL,0,500,4,-83.25,-80,-89,9
31,RL,0,500,5,-81.8,-79,-86,7
31,RL,0,500,2,-84,-82,-86,4
31,RL,1,500,10,-82.3,-79,-86,7
31,RL,0,500,7,-82.1428571428571,-79,-86,7
31,RL,0,500,4,-83.75,-82,-86,4
31,RL,0,500,8,-82.625,-79,-86,7
31,RL,1,500,10,-83.5,-79,-87,8
31,RL,0,500,7,-82.4285714285714,-79,-87,8
31,RL,0,500,8,-83.875,-79,-88,9
31,RL,0,500,8,-84.875,-82,-88,6
31,RL,0,500,8,-84.375,-80,-88,8
31,RL,0,500,5,-86.2,-82,-88,6
31,RL,0,500,4,-86,-82,-88,6
31,RL,1,500,9,-83,-79,-88,9
31,RL,0,500,1,-88,-88,-88,0
31,RL,1,500,10,-82.1,-79,-86,7
31,RL,0,500,1,-79,-79,-79,0
31,RL,0,500,4,-81.5,-79,-86,7
31,RL,0,500,3,-80.3333333333333,-79,-82,3
31,RL,0,500,7,-83.2857142857143,-79,-86,7
31,RL,1,500,10,-83.5,-80,-86,6
31,RL,0,500,4,-84.75,-84,-86,2
31,RL,1,500,10,-83.7,-80,-86,6
31,RL,0,500,3,-84,-84,-84,0
31,RL,0,500,5,-82.4,-80,-84,4
31,RL,0,500,4,-82.25,-80,-85,5
31,RL,0,500,6,-83.1666666666667,-80,-86,6
31,RL,0,500,4,-84.75,-84,-86,2
31,RL,0,500,6,-83.6666666666667,-80,-86,6
31,RL,0,500,4,-83,-80,-85,5
31,RL,1,500,9,-83.6666666666667,-80,-86,6
31,RL,0,500,4,-84.25,-83,-85,2
31,RL,0,500,7,-84.2857142857143,-82,-86,4
31,RL,0,500,4,-84.75,-84,-86,2
31,RL,0,500,2,-84,-84,-84,0
31,RL,0,500,4,-84,-82,-86,4
31,RL,1,500,10,-83.7,-80,-90,10
31,RL,1,500,10,-83.4,-80,-90,10
31,RL,0,500,7,-83.4285714285714,-80,-90,10
31,RL,0,500,6,-83.6666666666667,-80,-90,10
31,RL,0,500,7,-83.2857142857143,-80,-90,10
31,RL,0,500,1,-90,-90,-90,0
31,RL,1,500,10,-82.2,-79,-83,4
31,RL,1,500,9,-82.1111111111111,-79,-83,4
31,RL,0,500,8,-82.25,-79,-83,4
31,RL,1,500,10,-82.9,-79,-86,7
31,RL,1,500,10,-83,-79,-86,7
31,RL,1,500,9,-83,-79,-86,7
31,RL,0,500,1,-82,-82,-82,0
31,RL,0,500,1,-82,-82,-82,0
31,RL,1,500,10,-82.5,-79,-87,8
31,RL,0,500,7,-83.8571428571429,-80,-87,7
31,RL,0,500,8,-82.875,-79,-87,8
31,RL,1,500,9,-83.6666666666667,-79,-89,10
31,RL,0,500,8,-84.125,-79,-89,10
31,RL,1,500,10,-84.2,-80,-89,9
31,RL,1,500,9,-84.6666666666667,-82,-89,7
31,RL,0,500,5,-84.4,-82,-89,7
31,RL,1,500,9,-85,-82,-90,8
31,RL,0,500,8,-85,-82,-90,8
31,RL,1,500,10,-83.8,-81,-90,9
31,RL,0,500,6,-84.8333333333333,-82,-90,8
31,RL,0,500,5,-85.4,-83,-90,7
31,RL,0,500,7,-84.4285714285714,-81,-90,9
31,RL,1,500,10,-83.3,-80,-90,10
31,RL,0,500,4,-84.25,-81,-90,9
31,RL,1,500,10,-81.5,-79,-83,4
31,RL,0,500,7,-82.1428571428571,-80,-83,3
31,RL,1,500,9,-81.3333333333333,-79,-83,4
31,RL,0,500,4,-82.25,-81,-83,2
31,RL,0,500,5,-81.4,-79,-83,4
31,RL,0,500,5,-81,-79,-83,4
31,RL,0,500,4,-80.5,-79,-82,3
31,RL,0,500,7,-83,-81,-84,3
31,RL,1,500,9,-83.1111111111111,-80,-84,4
31,RL,1,500,10,-82.9,-80,-84,4
31,RL,0,500,4,-82.75,-80,-84,4
31,RL,1,500,9,-82.3333333333333,-80,-84,4
31,RL,0,500,4,-82.75,-80,-84,4
31,RL,1,500,10,-82.2,-80,-84,4
31,RL,0,500,7,-82,-80,-84,4
31,RL,0,500,4,-81.5,-80,-83,3
31,RL,0,500,1,-83,-83,-83,0
31,RL,0,500,6,-82,-80,-84,4
31,RL,1,500,9,-82.8888888888889,-80,-84,4
31,RL,0,500,1,-80,-80,-80,0
31,RL,0,500,6,-83.6666666666667,-83,-84,1
31,RL,0,500,6,-83.6666666666667,-83,-84,1
31,RL,0,500,4,-83.5,-83,-84,1
31,RL,0,500,6,-82.8333333333333,-80,-84,4
31,RL,0,500,3,-83.3333333333333,-83,-84,1
31,RL,0,500,5,-82.8,-80,-84,4
31,RL,0,500,2,-82,-80,-84,4
31,RL,0,500,2,-81.5,-80,-83,3
31,RL,0,500,8,-81.75,-80,-84,4
31,RL,0,500,7,-81.5714285714286,-80,-84,4
31,RL,0,500,7,-81.1428571428571,-80,-84,4
31,RL,0,500,3,-80,-80,-80,0
31,RL,0,500,5,-81,-80,-84,4
31,RL,0,500,3,-81.3333333333333,-80,-84,4
31,RL,1,500,10,-81.8,-80,-83,3
31,RL,1,500,9,-82,-80,-83,3
31,RL,0,500,5,-82.6,-82,-83,1
31,RL,0,500,3,-83,-83,-83,0
31,RL,0,500,6,-82.5,-80,-85,5
31,RL,1,500,9,-82,-80,-85,5
31,RL,1,500,10,-82,-80,-85,5
31,RL,0,500,8,-82.125,-80,-85,5
31,RL,0,500,3,-83.3333333333333,-82,-85,3
31,RL,0,500,8,-82.125,-80,-83,3
31,RL,0,500,7,-82,-80,-83,3
31,RL,0,500,4,-82.25,-81,-83,2
31,RL,0,500,4,-82.75,-82,-83,1
31,RL,1,500,10,-83.6,-80,-90,10
31,RL,0,500,6,-82.3333333333333,-80,-86,6
31,RL,1,500,10,-84.1,-80,-90,10
31,RL,0,500,3,-82.6666666666667,-80,-86,6
31,RL,0,500,5,-84.2,-80,-90,10
31,RL,0,500,5,-85.2,-80,-90,10
31,RL,0,500,4,-85,-80,-90,10
31,RL,0,500,7,-84.1428571428571,-79,-90,11
31,RL,0,500,3,-84.3333333333333,-83,-85,2
31,RL,1,500,9,-85.7777777777778,-79,-96,17
31,RL,0,500,2,-85,-83,-87,4
31,RL,0,500,2,-79.5,-79,-80,1
31,RL,0,500,3,-90,-85,-96,11
31,RL,0,500,1,-89,-89,-89,0
31,RL,0,500,2,-92,-88,-96,8
31,RL,0,500,6,-82.3333333333333,-78,-88,10
31,RL,0,500,8,-82.625,-78,-90,12
31,RL,1,500,9,-82,-78,-90,12
31,RL,0,500,3,-81.3333333333333,-79,-84,5
31,RL,1,500,10,-83.7,-78,-90,12
31,RL,1,500,10,-83.6,-78,-90,12
31,RL,0,500,8,-84.25,-78,-90,12
31,RL,0,500,6,-83,-78,-90,12
31,RL,0,500,3,-83.6666666666667,-79,-90,11
31,RL,0,500,7,-81.8571428571429,-78,-90,12
31,RL,0,500,1,-90,-90,-90,0
31,RL,0,500,3,-82,-78,-89,11
31,RL,0,500,5,-82.2,-78,-89,11
31,RL,0,500,3,-82.3333333333333,-78,-89,11
31,RL,0,500,6,-81,-79,-83,4
31,RL,1,500,10,-85.9,-79,-99,20
31,RL,0,500,7,-85.5714285714286,-79,-95,16
31,RL,0,500,4,-82.75,-79,-90,11
31,RL,0,500,3,-84,-80,-90,10
31,RL,1,500,9,-86.3333333333333,-77,-99,22
31,RL,0,500,2,-90,-90,-90,0
31,RL,0,500,4,-90.75,-79,-99,20
31,RL,0,500,3,-91,-79,-99,20
31,RL,0,500,3,-87,-79,-99,20
31,RL,1,500,9,-83.2222222222222,-77,-99,22
31,RL,0,500,2,-82.5,-82,-83,1
31,RL,0,500,8,-80.625,-77,-90,13
31,RL,0,500,5,-81.6,-78,-90,12
31,RL,1,500,10,-82.1,-78,-92,14
31,RL,0,500,2,-80,-78,-82,4
31,RL,0,500,4,-82.75,-78,-92,14
31,RL,0,500,4,-85.25,-78,-92,14
31,RL,0,500,3,-84.3333333333333,-79,-92,13
31,RL,0,500,6,-82.1666666666667,-79,-92,13
31,RL,0,500,8,-82.5,-79,-90,11
31,RL,0,500,4,-82.25,-79,-89,10
31,RL,0,500,5,-83.8,-79,-90,11
31,RL,0,500,2,-89.5,-89,-90,1
31,RL,0,500,6,-80.1666666666667,-79,-81,2
31,RL,0,500,3,-80.3333333333333,-79,-81,2
31,RL,0,500,5,-79.8,-79,-81,2
31,RL,0,500,1,-81,-81,-81,0
31,RL,1,500,10,-82.4,-79,-95,16
31,RL,0,500,4,-81,-79,-82,3
31,RL,0,500,5,-86.8,-80,-95,15
31,RL,0,500,6,-86,-80,-95,15
31,RL,1,500,10,-84.7,-80,-95,15
31,RL,0,500,3,-85.3333333333333,-80,-94,14
31,RL,1,500,9,-83.6666666666667,-80,-95,15
31,RL,0,500,2,-83.5,-83,-84,1
31,RL,0,500,3,-82,-81,-83,2
31,RL,1,500,10,-84.4,-81,-95,14
31,RL,0,500,7,-84.4285714285714,-81,-95,14
31,RL,0,500,7,-85,-82,-95,13
31,RL,0,500,1,-82,-82,-82,0
31,RL,0,500,4,-84.5,-83,-86,3
31,RL,0,500,8,-83.625,-81,-86,5
31,RL,0,500,5,-82.8,-81,-84,3
31,RL,0,500,7,-83.4285714285714,-81,-86,5
31,RL,0,500,4,-83.25,-81,-86,5
31,RL,0,500,2,-84.5,-83,-86,3
31,RL,0,500,7,-84.8571428571429,-84,-86,2
31,RL,0,500,1,-84,-84,-84,0
31,RL,0,500,4,-85,-84,-86,2
31,RL,0,500,5,-85.4,-85,-86,1
31,RL,0,500,2,-85.5,-85,-86,1
31,RL,1,500,9,-86.1111111111111,-83,-100,17
31,RL,0,500,6,-87,-84,-100,16
31,RL,0,500,3,-89.3333333333333,-84,-100,16
31,RL,0,500,4,-84,-84,-84,0
31,RL,0,500,7,-83,-80,-84,4
31,RL,0,500,5,-82.6,-80,-84,4
31,RL,0,500,4,-82.25,-80,-84,4
31,RL,0,500,5,-82.6,-80,-84,4
31,RL,0,500,7,-86,-80,-98,18
31,RL,0,500,4,-86.5,-80,-98,18
31,RL,1,500,10,-87,-80,-98,18
31,RL,0,500,7,-84.7142857142857,-80,-96,16
31,RL,0,500,8,-84.875,-80,-96,16
31,RL,0,500,4,-84.5,-80,-96,16
31,RL,0,500,1,-80,-80,-80,0
31,RL,0,500,2,-82,-81,-83,2
31,RL,0,500,3,-86.3333333333333,-81,-96,15
31,RL,1,500,9,-85.2222222222222,-80,-96,16
31,RL,0,500,6,-83.6666666666667,-80,-91,11
31,RL,0,500,5,-84,-80,-91,11
31,RL,0,500,2,-81,-80,-82,2
31,RL,0,500,2,-84,-82,-86,4
31,RL,0,500,8,-84.75,-82,-86,4
31,RL,0,500,5,-84,-82,-86,4
31,RL,0,500,6,-84.1666666666667,-82,-86,4
31,RL,1,500,10,-83.9,-82,-86,4
31,RL,0,500,4,-85,-82,-86,4
31,RL,0,500,8,-83.875,-82,-86,4
31,RL,0,500,6,-83.8333333333333,-82,-86,4
31,RL,1,500,10,-84.2,-82,-90,8
31,RL,0,500,7,-83.8571428571429,-82,-88,6
31,RL,1,500,10,-84.5,-82,-90,8
31,RL,0,500,3,-82.6666666666667,-82,-83,1
31,RL,0,500,5,-85,-82,-90,8
31,RL,0,500,3,-86.6666666666667,-82,-90,8
31,RL,0,500,3,-87,-83,-90,7
31,RL,0,500,1,-90,-90,-90,0
31,RL,0,500,4,-86,-82,-90,8
31,RL,0,500,6,-85.1666666666667,-82,-90,8
31,RL,0,500,2,-88,-86,-90,4
31,RL,0,500,7,-85.1428571428571,-82,-88,6
31,RL,1,500,9,-85.2222222222222,-82,-88,6
31,RL,0,500,8,-85.5,-82,-88,6
31,RL,0,500,2,-87,-87,-87,0
31,RL,0,500,1,-87,-87,-87,0
31,RL,0,500,4,-86.5,-85,-88,3
31,RL,1,500,9,-85.6666666666667,-82,-91,9
31,RL,1,500,10,-84.8,-82,-91,9
31,RL,0,500,5,-84.4,-82,-91,9
31,RL,0,500,4,-84.25,-82,-91,9
31,RL,0,500,6,-85.1666666666667,-82,-91,9
31,RL,0,500,8,-84.625,-82,-90,8
31,RL,1,500,10,-85.4,-82,-90,8
31,RL,0,500,1,-90,-90,-90,0
31,RL,0,500,8,-85.25,-82,-90,8
31,RL,0,500,5,-86.8,-82,-90,8
31,RL,0,500,4,-88,-85,-90,5
31,RL,0,500,2,-87.5,-85,-90,5
31,RL,0,500,4,-84,-82,-87,5
31,RL,0,500,4,-82.75,-82,-84,2
31,RL,0,500,2,-83.5,-83,-84,1
31,RL,0,500,3,-83,-82,-84,2
31,RL,1,500,10,-84.6,-81,-93,12
31,RL,0,500,8,-85.125,-81,-93,12
31,RL,1,500,9,-84.4444444444444,-81,-93,12
31,RL,0,500,2,-88,-83,-93,10
31,RL,0,500,1,-93,-93,-93,0
31,RL,1,500,9,-82.7777777777778,-80,-91,11
31,RL,0,500,6,-83.5,-81,-91,10
31,RL,1,500,10,-82.6,-80,-91,11
31,RL,0,500,1,-81,-81,-81,0
31,RL,0,500,7,-81.5714285714286,-80,-83,3
31,RL,1,500,9,-84,-80,-94,14
31,RL,0,500,5,-84.2,-81,-94,13
31,RL,0,500,3,-81.3333333333333,-81,-82,1
31,RL,0,500,6,-85.1666666666667,-81,-94,13
31,RL,0,500,5,-86,-81,-94,13
31,RL,0,500,3,-85.6666666666667,-81,-94,13
31,RL,1,500,10,-87.2,-80,-94,14
31,RL,0,500,3,-88.6666666666667,-82,-92,10
31,RL,0,500,6,-89,-80,-94,14
31,RL,0,500,8,-87.25,-80,-94,14
31,RL,0,500,1,-80,-80,-80,0
31,RL,0,500,6,-83.3333333333333,-80,-92,12
31,RL,0,500,8,-82.5,-80,-92,12
31,RL,0,500,5,-82.8,-80,-92,12
31,RL,0,500,4,-83.5,-80,-92,12
31,RL,0,500,6,-82.8333333333333,-80,-92,12
31,RL,0,500,4,-83.75,-80,-92,12
31,RL,0,500,7,-82.2857142857143,-80,-92,12
31,RL,0,500,1,-82,-82,-82,0
31,RL,0,500,2,-80.5,-80,-81,1
31,RL,0,500,6,-80.6666666666667,-80,-82,2
31,RL,1,500,10,-81.7,-79,-92,13
31,RL,0,500,2,-79.5,-79,-80,1
31,RL,0,500,1,-80,-80,-80,0
31,RL,0,500,4,-79.25,-79,-80,1
31,RL,0,500,6,-79.1666666666667,-78,-80,2
31,LR,0,500,2,-84.5,-83,-86,3
31,LR,0,500,5,-83.6,-80,-86,6
31,LR,0,500,3,-83.3333333333333,-80,-86,6
31,LR,0,500,4,-84,-80,-88,8
31,LR,0,500,5,-87.6,-82,-94,12
31,LR,1,500,10,-88.6,-82,-95,13
31,LR,0,500,1,-88,-88,-88,0
31,LR,1,500,9,-88.4444444444444,-84,-95,11
31,LR,0,500,4,-88.25,-84,-92,8
31,LR,0,500,2,-91,-90,-92,2
31,LR,0,500,1,-92,-92,-92,0
31,LR,0,500,6,-86.6666666666667,-84,-91,7
31,LR,0,500,8,-87,-84,-92,8
31,LR,0,500,8,-87.75,-84,-92,8
31,LR,0,500,5,-87.2,-84,-92,8
31,LR,0,500,5,-86.8,-84,-92,8
31,LR,0,500,1,-92,-92,-92,0
31,LR,0,500,1,-85,-85,-85,0
31,LR,0,500,5,-82,-74,-90,16
31,LR,1,500,10,-80.3,-74,-86,12
31,LR,1,500,10,-80.1,-74,-86,12
31,LR,0,500,6,-80.5,-74,-86,12
31,LR,0,500,3,-80.3333333333333,-75,-84,9
31,LR,1,500,9,-83.1111111111111,-76,-91,15
31,LR,0,500,3,-81.3333333333333,-76,-86,10
31,LR,0,500,5,-81.2,-76,-84,8
31,LR,0,500,7,-85.5714285714286,-81,-91,10
31,LR,1,500,10,-86.6,-81,-95,14
31,LR,0,500,1,-91,-91,-91,0
31,LR,0,500,4,-88.75,-83,-95,12
31,LR,0,500,3,-90.6666666666667,-87,-95,8
31,LR,1,500,9,-89.3333333333333,-82,-98,16
31,LR,1,500,10,-90.5,-82,-98,16
31,LR,1,500,9,-90,-82,-98,16
31,LR,0,500,5,-90,-82,-98,16
31,LR,0,500,8,-91.375,-82,-98,16
31,LR,0,500,5,-91.4,-83,-98,15
31,LR,0,500,8,-90.125,-80,-98,18
31,LR,1,500,9,-91.3333333333333,-80,-98,18
31,LR,0,500,4,-93,-90,-98,8
31,LR,0,500,1,-90,-90,-90,0
31,LR,0,500,2,-96,-94,-98,4
31,LR,0,500,8,-89.5,-80,-94,14
31,LR,0,500,5,-89.2,-80,-94,14
31,LR,0,500,6,-89,-80,-94,14
31,LR,1,500,9,-90.1111111111111,-84,-96,12
31,LR,0,500,1,-92,-92,-92,0
31,LR,0,500,7,-89.1428571428571,-84,-96,12
31,LR,1,500,9,-89.2222222222222,-83,-96,13
31,LR,0,500,7,-89.1428571428571,-83,-96,13
31,LR,0,500,3,-87,-84,-91,7
31,LR,0,500,7,-88.1428571428571,-83,-93,10
31,LR,0,500,3,-88.3333333333333,-83,-91,8
31,LR,0,500,3,-89,-83,-93,10
31,LR,0,500,6,-89.8333333333333,-83,-98,15
31,LR,0,500,2,-92,-91,-93,2
31,LR,0,500,5,-91.2,-84,-98,14
31,LR,0,500,8,-90.875,-84,-98,14
31,LR,0,500,5,-93.4,-90,-98,8
31,LR,0,500,5,-92.2,-84,-98,14
31,LR,0,500,6,-90.8333333333333,-84,-93,9
31,LR,1,500,9,-89.3333333333333,-82,-98,16
31,LR,0,500,6,-88.5,-83,-93,10
31,LR,0,500,4,-88.75,-84,-92,8
31,LR,0,500,7,-88.8571428571429,-82,-98,16
31,LR,0,500,2,-89.5,-89,-90,1
31,LR,0,500,1,-89,-89,-89,0
31,LR,0,500,7,-89.4285714285714,-82,-98,16
31,LR,0,500,5,-90.6,-82,-98,16
31,LR,0,500,5,-89,-82,-96,14
31,LR,0,500,8,-91.625,-86,-98,12
31,LR,0,500,4,-92.25,-89,-96,7
31,LR,0,500,4,-89.75,-86,-94,8
31,LR,0,500,6,-91,-86,-98,12
31,LR,0,500,2,-92,-86,-98,12
31,LR,0,500,3,-87.3333333333333,-84,-92,8
31,LR,0,500,5,-88,-84,-95,11
31,LR,0,500,7,-88.8571428571429,-84,-95,11
31,LR,0,500,5,-89.4,-85,-95,10
31,LR,1,500,9,-89.6666666666667,-83,-98,15
31,LR,0,500,2,-88,-85,-91,6
31,LR,1,500,10,-89.3,-83,-98,15
31,LR,0,500,4,-89,-83,-96,13
31,LR,0,500,6,-89.6666666666667,-83,-98,15
31,LR,1,500,10,-89.9,-83,-99,16
31,LR,1,500,10,-90.1,-83,-99,16
31,LR,1,500,9,-89.4444444444444,-83,-99,16
31,LR,0,500,5,-89,-83,-99,16
31,LR,0,500,2,-87.5,-87,-88,1
31,LR,0,500,5,-88,-83,-98,15
31,LR,0,500,5,-86.8,-81,-98,17
31,LR,1,500,10,-89.3,-81,-102,21
31,LR,1,500,9,-88.3333333333333,-81,-102,21
31,LR,0,500,7,-89,-81,-102,21
31,LR,1,500,10,-90.4,-83,-102,19
31,LR,0,500,1,-102,-102,-102,0
31,LR,0,500,3,-87.6666666666667,-87,-88,1
31,LR,0,500,2,-89,-88,-90,2
31,LR,0,500,6,-90.6666666666667,-83,-94,11
31,LR,0,500,2,-92.5,-92,-93,1
31,LR,0,500,1,-93,-93,-93,0
31,LR,0,500,7,-89.4285714285714,-83,-99,16
31,LR,1,500,10,-89.1,-83,-99,16
31,LR,0,500,3,-89.6666666666667,-85,-93,8
31,LR,0,500,2,-89,-85,-93,8
31,LR,0,500,2,-92,-85,-99,14
31,LR,0,500,7,-86.4285714285714,-83,-90,7
31,LR,0,500,3,-87.6666666666667,-86,-90,4
31,LR,0,500,6,-88,-85,-92,7
31,LR,0,500,6,-88.1666666666667,-85,-92,7
31,LR,0,500,7,-90.2857142857143,-85,-94,9
31,LR,0,500,1,-85,-85,-85,0
31,LR,1,500,9,-89.6666666666667,-85,-94,9
31,LR,0,500,6,-90.5,-85,-94,9
31,LR,0,500,2,-94,-94,-94,0
31,LR,0,500,1,-94,-94,-94,0
31,LR,0,500,6,-87.5,-85,-92,7
31,LR,0,500,7,-87.5714285714286,-83,-92,9
31,LR,0,500,7,-85.7142857142857,-82,-90,8
31,LR,1,500,10,-88.2,-82,-97,15
31,LR,0,500,1,-90,-90,-90,0
31,LR,0,500,2,-86.5,-83,-90,7
31,LR,0,500,3,-83.6666666666667,-82,-86,4
31,LR,0,500,8,-92.375,-83,-97,14
31,LR,1,500,9,-93.5555555555556,-86,-97,11
31,LR,0,500,2,-96,-95,-97,2
31,LR,0,500,5,-94.6,-90,-97,7
31,LR,0,500,3,-93.6666666666667,-90,-96,6
31,LR,0,500,5,-94.8,-92,-97,5
31,LR,0,500,8,-92.75,-87,-97,10
31,LR,0,500,7,-92.4285714285714,-87,-97,10
31,LR,0,500,3,-91.6666666666667,-87,-94,7
31,LR,0,500,4,-91.5,-87,-101,14
31,LR,0,500,5,-92,-89,-101,12
31,LR,0,500,2,-90.5,-89,-92,3
31,LR,0,500,4,-90.5,-89,-92,3
31,LR,0,500,8,-89.875,-88,-93,5
31,LR,0,500,1,-91,-91,-91,0
31,LR,0,500,2,-90.5,-88,-93,5
31,LR,0,500,4,-90.25,-88,-93,5
31,LR,0,500,4,-89.25,-88,-92,4
31,LR,0,500,4,-90.75,-88,-96,8
31,LR,1,500,9,-90,-86,-97,11
31,LR,1,500,9,-90.4444444444444,-86,-97,11
31,LR,0,500,3,-87.6666666666667,-87,-88,1
31,LR,0,500,5,-88,-86,-89,3
31,LR,0,500,3,-87.6666666666667,-86,-89,3
31,LR,0,500,6,-90.1666666666667,-86,-97,11
31,LR,0,500,1,-89,-89,-89,0
31,LR,0,500,1,-97,-97,-97,0
31,LR,0,500,1,-94,-94,-94,0
31,LR,0,500,8,-89.875,-86,-99,13
31,LR,0,500,1,-88,-88,-88,0
31,LR,0,500,6,-90.8333333333333,-87,-99,12
31,LR,1,500,10,-91.8,-87,-99,12
31,LR,0,500,5,-91.6,-87,-99,12
31,LR,0,500,3,-94.3333333333333,-88,-99,11
31,LR,0,500,4,-90.75,-88,-99,11
31,LR,1,500,9,-91.7777777777778,-84,-99,15
31,LR,0,500,8,-90.875,-84,-98,14
31,LR,1,500,9,-90.3333333333333,-84,-98,14
31,LR,0,500,2,-96.5,-95,-98,3
31,LR,0,500,5,-89,-84,-96,12
31,LR,0,500,8,-89.25,-84,-96,12
31,LR,0,500,7,-90,-86,-96,10
31,LR,1,500,9,-89.6666666666667,-86,-94,8
31,LR,0,500,8,-90.125,-86,-94,8
31,LR,0,500,3,-91,-87,-94,7
31,LR,0,500,3,-91.3333333333333,-88,-94,6
31,LR,0,500,8,-90.25,-84,-94,10
31,LR,0,500,8,-89.75,-84,-94,10
31,LR,1,500,10,-90.7,-84,-94,10
31,LR,0,500,8,-90,-84,-94,10
31,LR,0,500,6,-89.1666666666667,-84,-94,10
31,LR,0,500,1,-91,-91,-91,0
31,LR,0,500,4,-91.25,-88,-94,6
31,LR,0,500,6,-91.1666666666667,-88,-94,6
31,LR,0,500,6,-91.6666666666667,-90,-94,4
31,LR,0,500,1,-91,-91,-91,0
31,LR,0,500,7,-92.4285714285714,-90,-96,6
31,LR,1,500,9,-91.8888888888889,-90,-96,6
31,LR,0,500,5,-92.2,-90,-96,6
31,LR,0,500,6,-92.1666666666667,-90,-96,6
31,LR,0,500,3,-93.3333333333333,-91,-96,5
31,LR,1,500,10,-91.8,-88,-96,8
31,LR,1,500,9,-91.6666666666667,-88,-96,8
31,LR,0,500,4,-91,-90,-92,2
31,LR,0,500,2,-91,-90,-92,2
31,LR,0,500,8,-89.625,-86,-94,8
31,LR,0,500,2,-92.5,-91,-94,3
31,LR,0,500,7,-87.8571428571429,-85,-92,7
31,LR,0,500,2,-88,-88,-88,0
31,LR,0,500,2,-87,-86,-88,2
31,LR,0,500,2,-87,-86,-88,2
31,LR,1,500,9,-89.8888888888889,-85,-93,8
31,LR,0,500,4,-88.75,-85,-92,7
31,LR,0,500,2,-89,-88,-90,2
31,LR,0,500,3,-91.3333333333333,-90,-92,2
31,LR,0,500,5,-91.6,-90,-93,3
31,LR,0,500,2,-92.5,-92,-93,1
31,LR,0,500,5,-90.8,-90,-93,3
31,LR,0,500,6,-89,-86,-91,5
31,LR,0,500,5,-89.4,-86,-94,8
31,LR,0,500,2,-90,-86,-94,8
31,LR,0,500,7,-88.1428571428571,-85,-94,9
31,LR,0,500,8,-89.375,-85,-94,9
31,LR,0,500,1,-90,-90,-90,0
31,LR,0,500,4,-89.75,-85,-94,9
31,LR,0,500,7,-93.4285714285714,-87,-100,13
31,LR,0,500,5,-92.4,-87,-100,13
31,LR,0,500,8,-93.25,-88,-100,12
31,LR,1,500,10,-93.6,-88,-100,12
31,LR,0,500,8,-93.75,-88,-100,12
31,LR,0,500,1,-100,-100,-100,0
31,LR,0,500,4,-92.75,-90,-98,8
31,LR,0,500,7,-93.5714285714286,-91,-99,8
31,LR,0,500,3,-94,-91,-99,8
31,LR,0,500,1,-92,-92,-92,0
31,LR,1,500,9,-93.2222222222222,-90,-99,9
31,LR,0,500,8,-92.5,-90,-97,7
31,LR,0,500,1,-92,-92,-92,0
31,LR,0,500,8,-91.375,-85,-97,12
31,LR,0,500,7,-90.5714285714286,-85,-94,9
31,LR,0,500,8,-90.5,-85,-94,9
31,LR,1,500,10,-89.8,-85,-94,9
31,LR,1,500,9,-89.7777777777778,-85,-94,9
31,LR,1,500,9,-89.8888888888889,-85,-94,9
31,LR,1,500,10,-90.6,-87,-95,8
31,LR,1,500,9,-90.4444444444444,-87,-95,8
31,LR,0,500,7,-89.2857142857143,-87,-92,5
31,LR,0,500,7,-90.1428571428571,-87,-95,8
31,LR,1,500,10,-91,-86,-98,12
31,LR,1,500,10,-91,-86,-98,12
31,LR,0,500,8,-91.375,-86,-98,12
31,LR,0,500,5,-91.2,-87,-95,8
31,LR,0,500,4,-91,-86,-95,9
31,LR,0,500,6,-89.8333333333333,-85,-98,13
31,LR,0,500,3,-92.3333333333333,-86,-98,12
31,LR,1,500,10,-89.6,-85,-98,13
31,LR,0,500,2,-92.5,-87,-98,11
31,LR,0,500,1,-87,-87,-87,0
31,LR,0,500,6,-89.6666666666667,-85,-98,13
31,LR,0,500,4,-88.75,-86,-93,7
31,LR,1,500,9,-90,-85,-98,13
31,LR,0,500,7,-89.8571428571429,-85,-98,13
31,LR,0,500,7,-90.2857142857143,-85,-98,13
31,LR,0,500,3,-89.6666666666667,-85,-96,11
31,LR,0,500,6,-90.8333333333333,-85,-98,13
31,LR,0,500,3,-91,-85,-98,13
31,LR,1,500,9,-90.3333333333333,-86,-98,12
31,LR,0,500,5,-88.8,-86,-90,4
31,LR,1,500,9,-89.2222222222222,-82,-93,11
31,LR,0,500,5,-89.8,-88,-92,4
31,LR,0,500,3,-89.6666666666667,-89,-90,1
31,LR,0,500,4,-91,-89,-93,4
31,LR,1,500,9,-90.8888888888889,-82,-98,16
31,LR,0,500,2,-92.5,-92,-93,1
31,LR,0,500,8,-91.875,-82,-98,16
31,LR,1,500,9,-92.4444444444444,-82,-98,16
31,LR,0,500,2,-85,-82,-88,6
31,LR,1,500,10,-92.9,-84,-99,15
31,LR,0,500,2,-92.5,-87,-98,11
31,LR,0,500,3,-97.3333333333333,-96,-98,2
31,LR,1,500,9,-92.2222222222222,-84,-99,15
31,LR,0,500,8,-90.75,-84,-99,15
31,LR,0,500,7,-89.8571428571429,-84,-99,15
31,LR,0,500,7,-89,-84,-99,15
31,LR,0,500,3,-91.3333333333333,-86,-99,13
31,LR,1,500,10,-89.7,-86,-99,13
31,LR,1,500,9,-88.6666666666667,-86,-96,10
31,LR,0,500,1,-90,-90,-90,0
31,LR,0,500,1,-87,-87,-87,0
31,LR,1,500,9,-88.3333333333333,-86,-96,10
31,LR,0,500,1,-86,-86,-86,0
31,LR,0,500,7,-88.8571428571429,-86,-96,10
31,LR,0,500,3,-87.3333333333333,-86,-90,4
31,LR,0,500,8,-87.25,-84,-92,8
31,LR,0,500,5,-88,-86,-92,6
31,LR,1,500,9,-87.3333333333333,-84,-92,8
31,LR,0,500,2,-87,-86,-88,2
31,LR,0,500,8,-88,-84,-95,11
31,LR,1,500,9,-88.2222222222222,-84,-95,11
31,LR,0,500,8,-88.75,-86,-95,9
31,LR,0,500,3,-89.3333333333333,-86,-95,9
31,LR,1,500,10,-90,-86,-95,9
31,LR,0,500,5,-91.6,-88,-95,7
31,LR,0,500,4,-90.75,-88,-95,7
31,LR,0,500,6,-90,-86,-95,9
31,LR,0,500,5,-90,-86,-95,9
31,LR,0,500,5,-89.2,-86,-92,6
31,LR,0,500,8,-90.875,-88,-96,8
31,LR,0,500,1,-88,-88,-88,0
31,LR,0,500,5,-91.6,-88,-96,8
31,LR,0,500,3,-90.3333333333333,-88,-94,6
31,LR,0,500,2,-91,-88,-94,6
31,LR,0,500,5,-90.2,-86,-96,10
31,LR,0,500,8,-91.375,-86,-99,13
31,LR,1,500,10,-89.9,-86,-96,10
31,LR,1,500,10,-90.1,-86,-96,10
31,LR,0,500,1,-87,-87,-87,0
31,LR,0,500,7,-90.8571428571429,-86,-96,10
31,LR,0,500,5,-90,-87,-95,8
31,LR,0,500,4,-93.5,-90,-99,9
31,LR,1,500,10,-91.6,-86,-99,13
26,RL,0,500,7,-86.2857142857143,-81,-91,10
26,RL,0,500,2,-82.5,-81,-84,3
26,RL,0,500,1,-81,-81,-81,0
26,RL,0,500,5,-88.8,-86,-91,5
26,RL,0,500,2,-90.5,-90,-91,1
26,RL,0,500,3,-88.3333333333333,-86,-90,4
26,RL,0,500,8,-84.75,-78,-89,11
26,RL,0,500,5,-84.4,-78,-88,10
26,RL,0,500,1,-88,-88,-88,0
26,RL,0,500,3,-84,-81,-86,5
26,RL,0,500,1,-86,-86,-86,0
26,RL,0,500,1,-81,-81,-81,0
26,RL,0,500,4,-80.75,-78,-86,8
26,RL,0,500,8,-81,-79,-86,7
26,RL,0,500,6,-80,-79,-81,2
26,RL,0,500,4,-80.5,-79,-82,3
26,RL,0,500,2,-79.5,-79,-80,1
26,RL,0,500,8,-80.875,-79,-83,4
26,RL,0,500,6,-81.3333333333333,-80,-83,3
26,RL,1,500,10,-80.7,-79,-83,4
26,RL,0,500,7,-80.5714285714286,-80,-82,2
26,RL,1,500,9,-80.3333333333333,-79,-82,3
26,RL,0,500,4,-80.25,-80,-81,1
26,RL,0,500,2,-80.5,-80,-81,1
26,RL,1,500,9,-80,-77,-82,5
26,RL,0,500,7,-80.2857142857143,-79,-82,3
26,RL,0,500,3,-80.3333333333333,-79,-81,2
26,RL,0,500,8,-80.5,-77,-84,7
26,RL,0,500,2,-80,-79,-81,2
26,RL,0,500,8,-80.75,-77,-85,8
26,RL,0,500,6,-81.6666666666667,-77,-85,8
26,RL,1,500,10,-83,-77,-90,13
26,RL,0,500,4,-82,-77,-85,8
26,RL,0,500,5,-83.4,-77,-90,13
26,RL,1,500,9,-84.6666666666667,-77,-99,22
26,RL,0,500,8,-84.625,-77,-99,22
26,RL,0,500,7,-85.7142857142857,-77,-99,22
26,RL,0,500,2,-83.5,-77,-90,13
26,RL,0,500,5,-86,-79,-99,20
26,RL,0,500,8,-86.25,-79,-97,18
26,RL,1,500,9,-86.2222222222222,-80,-97,17
26,RL,0,500,1,-80,-80,-80,0
26,RL,0,500,3,-88.6666666666667,-86,-93,7
26,RL,0,500,5,-88.4,-83,-97,14
26,RL,0,500,4,-89,-83,-97,14
26,RL,1,500,10,-85.6,-82,-97,15
26,RL,0,500,1,-83,-83,-83,0
26,RL,0,500,1,-83,-83,-83,0
26,RL,0,500,2,-86,-85,-87,2
26,RL,0,500,4,-85,-82,-87,5
26,RL,0,500,4,-83.75,-82,-87,5
26,RL,1,500,9,-83.2222222222222,-78,-88,10
26,RL,0,500,7,-83.1428571428571,-78,-88,10
26,RL,0,500,6,-83.3333333333333,-78,-88,10
26,RL,1,500,10,-82.2,-78,-88,10
26,RL,0,500,7,-81.8571428571429,-78,-86,8
26,RL,1,500,9,-82.6666666666667,-79,-86,7
26,RL,1,500,9,-81.8888888888889,-79,-86,7
26,RL,0,500,3,-82.3333333333333,-79,-86,7
26,RL,1,500,9,-81.5555555555556,-79,-86,7
26,RL,0,500,1,-82,-82,-82,0
26,RL,0,500,8,-82.375,-80,-86,6
26,RL,0,500,7,-82.7142857142857,-80,-86,6
26,RL,0,500,3,-82.3333333333333,-80,-86,6
26,RL,0,500,8,-82,-79,-86,7
26,RL,1,500,10,-83,-79,-86,7
26,RL,0,500,2,-81.5,-80,-83,3
26,RL,0,500,5,-82.4,-79,-86,7
26,RL,1,500,9,-84.1111111111111,-82,-89,7
26,RL,0,500,4,-83.5,-82,-86,4
26,RL,0,500,1,-82,-82,-82,0
26,RL,0,500,5,-83,-82,-84,2
26,RL,0,500,3,-83.6666666666667,-83,-84,1
26,RL,1,500,10,-83.7,-80,-89,9
26,RL,0,500,5,-83,-80,-89,9
26,RL,0,500,1,-82,-82,-82,0
26,RL,0,500,6,-83.5,-80,-89,9
26,RL,1,500,9,-84.7777777777778,-80,-89,9
26,RL,1,500,10,-84.9,-81,-89,8
26,RL,0,500,2,-85,-84,-86,2
26,RL,0,500,5,-85.4,-81,-89,8
26,RL,0,500,7,-85.4285714285714,-81,-89,8
26,RL,0,500,2,-88,-87,-89,2
26,RL,0,500,5,-86,-82,-89,7
26,RL,0,500,3,-86.3333333333333,-84,-89,5
26,RL,1,500,9,-81,-78,-85,7
26,RL,0,500,4,-80.5,-79,-82,3
26,RL,0,500,6,-79.8333333333333,-78,-82,4
26,RL,0,500,7,-80,-77,-83,6
26,RL,0,500,4,-80.25,-79,-83,4
26,RL,0,500,6,-80.6666666666667,-77,-83,6
26,RL,0,500,6,-82.5,-77,-90,13
26,RL,0,500,4,-80.5,-77,-83,6
26,RL,0,500,4,-91,-83,-99,16
26,RL,0,500,8,-88,-81,-99,18
26,RL,0,500,8,-83.125,-80,-90,10
26,RL,0,500,7,-82.1428571428571,-80,-86,6
26,RL,0,500,4,-82,-81,-84,3
26,RL,0,500,8,-81.75,-80,-83,3
26,RL,0,500,5,-81.6,-80,-83,3
26,RL,1,500,10,-82.9,-80,-86,6
26,RL,0,500,1,-83,-83,-83,0
26,RL,0,500,5,-83,-82,-84,2
26,RL,1,500,9,-83.5555555555556,-81,-86,5
26,RL,0,500,3,-84,-82,-86,4
26,RL,0,500,3,-84.6666666666667,-84,-86,2
26,RL,1,500,9,-83,-81,-86,5
26,RL,0,500,5,-83.2,-81,-86,5
26,RL,0,500,6,-82.5,-81,-84,3
26,RL,0,500,5,-82.8,-81,-84,3
26,RL,0,500,2,-82.5,-81,-84,3
26,RL,0,500,8,-85.875,-81,-92,11
26,RL,0,500,2,-82.5,-81,-84,3
26,RL,1,500,10,-87.9,-81,-92,11
26,RL,0,500,3,-89,-85,-92,7
26,RL,1,500,10,-90,-87,-98,11
26,RL,0,500,4,-90,-88,-92,4
26,RL,0,500,4,-88.75,-87,-90,3
26,RL,0,500,4,-88.5,-87,-90,3
26,RL,0,500,4,-87.75,-87,-89,2
26,RL,0,500,6,-89.6666666666667,-87,-98,11
26,RL,0,500,8,-90.875,-87,-98,11
26,RL,1,500,9,-91.6666666666667,-88,-98,10
26,RL,1,500,9,-90.7777777777778,-88,-95,7
26,RL,0,500,4,-92.5,-90,-95,5
26,RL,0,500,5,-91.8,-90,-95,5
26,RL,0,500,7,-89.2857142857143,-83,-94,11
26,RL,0,500,5,-88.2,-83,-92,9
26,RL,0,500,8,-87.625,-83,-95,12
26,RL,0,500,8,-87.625,-83,-95,12
26,RL,0,500,3,-86.6666666666667,-84,-90,6
26,RL,1,500,9,-86.6666666666667,-83,-95,12
26,RL,1,500,10,-85.6,-82,-95,13
26,RL,1,500,9,-85.7777777777778,-82,-95,13
26,RL,0,500,2,-85.5,-83,-88,5
26,RL,0,500,3,-85.3333333333333,-83,-89,6
26,RL,1,500,10,-85.4,-81,-90,9
26,RL,0,500,1,-89,-89,-89,0
26,RL,0,500,1,-82,-82,-82,0
26,RL,1,500,10,-84.5,-81,-90,9
26,RL,1,500,10,-84.4,-80,-90,10
26,RL,1,500,9,-83.8888888888889,-80,-90,10
26,RL,0,500,2,-87,-84,-90,6
26,RL,0,500,6,-84,-82,-90,8
26,RL,0,500,8,-82.5,-79,-87,8
26,RL,0,500,2,-83.5,-82,-85,3
26,RL,0,500,7,-82.4285714285714,-79,-87,8
26,RL,0,500,8,-82.5,-79,-87,8
26,RL,0,500,8,-82.75,-79,-87,8
26,RL,0,500,2,-83.5,-80,-87,7
26,RL,0,500,8,-84.25,-79,-90,11
26,RL,0,500,6,-85.3333333333333,-82,-90,8
26,RL,0,500,7,-85,-82,-90,8
26,RL,0,500,1,-83,-83,-83,0
26,RL,0,500,8,-84.125,-79,-90,11
26,RL,0,500,2,-89,-88,-90,2
26,RL,1,500,10,-82.5,-79,-88,9
26,RL,1,500,10,-81.6,-79,-86,7
26,RL,0,500,3,-82.6666666666667,-80,-84,4
26,RL,0,500,6,-81.6666666666667,-79,-86,7
26,RL,0,500,3,-81.6666666666667,-79,-84,5
26,RL,0,500,8,-80.875,-79,-86,7
26,RL,0,500,7,-81.1428571428571,-79,-86,7
26,RL,0,500,6,-81,-79,-86,7
26,RL,0,500,8,-81,-79,-86,7
26,RL,0,500,1,-81,-81,-81,0
26,RL,0,500,5,-81.6,-79,-86,7
26,RL,0,500,3,-82,-79,-86,7
26,RL,0,500,6,-81,-79,-83,4
26,RL,1,500,10,-82.4,-79,-86,7
26,RL,0,500,1,-81,-81,-81,0
26,RL,1,500,9,-82.5555555555556,-79,-86,7
26,RL,0,500,2,-83.5,-83,-84,1
26,RL,0,500,5,-82.8,-79,-86,7
26,RL,0,500,2,-82,-79,-85,6
26,RL,0,500,8,-82.75,-80,-85,5
26,RL,0,500,1,-81,-81,-81,0
26,RL,1,500,9,-82.5555555555556,-79,-84,5
26,RL,0,500,7,-82.7142857142857,-79,-84,5
26,RL,0,500,6,-82.6666666666667,-79,-84,5
26,RL,0,500,3,-83.6666666666667,-83,-84,1
26,RL,0,500,3,-82,-79,-84,5
26,RL,1,500,9,-82.5555555555556,-79,-86,7
26,RL,0,500,3,-81.3333333333333,-79,-83,4
26,RL,1,500,10,-82.8,-79,-86,7
26,RL,0,500,3,-83.3333333333333,-82,-86,4
26,RL,1,500,10,-83.1,-79,-87,8
26,RL,1,500,9,-83.2222222222222,-79,-87,8
26,RL,0,500,4,-82.75,-79,-86,7
26,RL,0,500,7,-83,-80,-87,7
26,RL,0,500,6,-81.8333333333333,-80,-87,7
26,RL,0,500,7,-81.8571428571429,-80,-87,7
26,RL,0,500,5,-80.8,-80,-81,1
26,RL,0,500,8,-80.75,-79,-82,3
26,RL,0,500,6,-81,-80,-82,2
26,RL,1,500,10,-81.1,-79,-83,4
26,RL,0,500,5,-81,-79,-83,4
26,RL,0,500,1,-80,-80,-80,0
26,RL,0,500,2,-80.5,-79,-82,3
26,RL,0,500,5,-81.2,-79,-83,4
26,RL,0,500,1,-80,-80,-80,0
26,RL,0,500,3,-82,-82,-82,0
26,RL,0,500,5,-80.8,-79,-82,3
26,RL,0,500,1,-79,-79,-79,0
26,RL,0,500,4,-81.25,-79,-82,3
26,RL,0,500,7,-81.5714285714286,-79,-83,4
26,RL,0,500,6,-81.5,-79,-83,4
26,RL,1,500,9,-81.5555555555556,-79,-83,4
26,RL,0,500,4,-81.25,-79,-83,4
26,RL,0,500,3,-82,-80,-83,3
26,RL,0,500,4,-82.5,-82,-83,1
26,RL,1,500,10,-81.3,-80,-84,4
26,RL,0,500,8,-81.25,-80,-84,4
26,RL,0,500,4,-81.25,-80,-84,4
26,RL,0,500,2,-80.5,-80,-81,1
26,RL,0,500,4,-81.5,-80,-84,4
26,RL,0,500,8,-82,-79,-85,6
26,RL,0,500,3,-81,-81,-81,0
26,RL,0,500,7,-81.5714285714286,-79,-85,6
26,RL,0,500,4,-81.25,-79,-85,6
26,RL,0,500,7,-81.1428571428571,-79,-85,6
26,RL,0,500,1,-85,-85,-85,0
26,RL,0,500,4,-80.75,-79,-85,6
26,RL,1,500,9,-82.1111111111111,-77,-86,9
26,RL,1,500,9,-81.6666666666667,-77,-86,9
26,RL,0,500,5,-82.2,-79,-86,7
26,RL,0,500,8,-81.875,-77,-86,9
26,RL,0,500,6,-81.1666666666667,-77,-86,9
26,RL,0,500,3,-78.6666666666667,-77,-81,4
26,RL,0,500,5,-82.2,-78,-87,9
26,RL,1,500,9,-81.3333333333333,-77,-87,10
26,RL,0,500,8,-81.375,-77,-87,10
26,RL,1,500,10,-80.9,-77,-87,10
26,RL,0,500,2,-78.5,-78,-79,1
26,RL,0,500,4,-81.5,-78,-84,6
26,RL,1,500,10,-83.4,-77,-97,20
26,RL,0,500,1,-83,-83,-83,0
26,RL,1,500,10,-83,-77,-97,20
26,RL,0,500,2,-78,-78,-78,0
26,RL,0,500,1,-78,-78,-78,0
26,RL,0,500,5,-85.8,-77,-97,20
26,RL,1,500,10,-83.6,-77,-97,20
26,RL,0,500,2,-79,-77,-81,4
26,RL,0,500,4,-80.5,-78,-83,5
26,RL,0,500,5,-82.4,-78,-90,12
26,RL,1,500,9,-82.1111111111111,-77,-90,13
26,RL,1,500,10,-81.4,-77,-90,13
26,RL,0,500,4,-82.25,-79,-89,10
26,RL,0,500,7,-80.5714285714286,-77,-89,12
26,RL,0,500,1,-79,-79,-79,0
26,RL,1,500,10,-82.5,-77,-94,17
26,RL,0,500,3,-79.6666666666667,-78,-81,3
26,RL,0,500,2,-79.5,-78,-81,3
26,RL,0,500,3,-80,-79,-81,2
26,RL,0,500,6,-85.3333333333333,-80,-94,14
26,RL,0,500,3,-89.6666666666667,-82,-94,12
26,RL,1,500,10,-83.3,-81,-94,13
26,RL,0,500,3,-85.6666666666667,-81,-94,13
26,RL,0,500,3,-81.3333333333333,-81,-82,1
26,RL,0,500,3,-81.6666666666667,-81,-82,1
26,RL,0,500,8,-82.625,-81,-84,3
26,RL,0,500,6,-83,-81,-84,3
26,RL,0,500,6,-85.3333333333333,-81,-98,17
26,RL,0,500,1,-81,-81,-81,0
26,RL,0,500,8,-84.75,-82,-98,16
26,RL,0,500,6,-85.6666666666667,-83,-98,15
26,RL,1,500,10,-85.7,-80,-99,19
26,RL,0,500,8,-86.375,-80,-99,19
26,RL,0,500,1,-83,-83,-83,0
26,RL,0,500,3,-87,-80,-99,19
26,RL,0,500,8,-84.5,-78,-99,21
26,RL,0,500,2,-91,-83,-99,16
26,RL,1,500,10,-82,-78,-93,15
26,RL,0,500,8,-81.25,-78,-93,15
26,RL,0,500,8,-81.875,-78,-93,15
26,RL,0,500,6,-79.1666666666667,-78,-81,3
26,RL,0,500,8,-80,-78,-87,9
26,RL,1,500,10,-82.1,-78,-87,9
26,RL,0,500,7,-81.5714285714286,-78,-87,9
26,RL,0,500,7,-82.2857142857143,-78,-87,9
26,RL,0,500,4,-81.75,-78,-87,9
26,RL,0,500,5,-82.2,-78,-86,8
26,RL,0,500,8,-82.875,-80,-87,7
26,RL,0,500,8,-83.75,-80,-88,8
26,RL,0,500,6,-83.5,-80,-87,7
26,RL,1,500,9,-83.6666666666667,-80,-88,8
26,RL,1,500,9,-84.2222222222222,-80,-90,10
26,RL,1,500,10,-84.8,-81,-90,9
26,RL,0,500,5,-85.6,-82,-90,8
26,RL,1,500,9,-85.7777777777778,-81,-94,13
26,RL,1,500,9,-86.5555555555556,-81,-94,13
26,RL,0,500,6,-87,-81,-94,13
26,RL,0,500,3,-85.6666666666667,-83,-88,5
26,RL,0,500,6,-86.6666666666667,-81,-94,13
26,RL,0,500,6,-86.8333333333333,-81,-94,13
26,RL,0,500,2,-87.5,-81,-94,13
26,RL,0,500,4,-85.25,-81,-89,8
26,RL,0,500,1,-82,-82,-82,0
26,RL,1,500,10,-85.9,-80,-94,14
26,RL,0,500,6,-86.5,-81,-94,13
26,RL,0,500,8,-85,-80,-94,14
26,RL,0,500,2,-86,-81,-91,10
26,RL,0,500,5,-87.6,-81,-94,13
26,RL,0,500,5,-87.4,-80,-94,14
26,RL,0,500,3,-83.6666666666667,-80,-90,10
26,RL,0,500,6,-84.5,-80,-92,12
26,RL,0,500,6,-82.8333333333333,-80,-92,12
26,RL,1,500,10,-83.8,-79,-92,13
26,RL,0,500,8,-83.375,-80,-92,12
26,RL,0,500,8,-82.875,-79,-92,13
26,RL,0,500,7,-83.1428571428571,-79,-92,13
26,RL,1,500,10,-82.4,-76,-92,16
26,RL,0,500,3,-84,-80,-92,12
26,RL,0,500,5,-81.6,-76,-92,16
26,RL,1,500,10,-83.1,-76,-91,15
26,RL,0,500,7,-86.2857142857143,-81,-91,10
26,RL,1,500,10,-86,-78,-91,13
26,RL,1,500,10,-86.6,-78,-91,13
26,RL,0,500,3,-88.3333333333333,-86,-90,4
26,RL,0,500,3,-86.6666666666667,-85,-89,4
26,RL,0,500,8,-83.375,-78,-88,10
26,RL,1,500,9,-82.3333333333333,-78,-88,10
26,RL,0,500,4,-82.5,-78,-86,8
26,RL,0,500,5,-83.2,-78,-86,8
26,RL,0,500,8,-81.5,-78,-86,8
26,RL,0,500,5,-80.8,-78,-86,8
26,RL,0,500,5,-80.8,-78,-86,8
26,RL,0,500,1,-86,-86,-86,0
26,RL,0,500,1,-80,-80,-80,0
26,RL,0,500,7,-80.4285714285714,-79,-82,3
26,RL,0,500,5,-80.6,-79,-82,3
26,RL,0,500,8,-80.875,-79,-83,4
26,RL,0,500,7,-81.1428571428571,-80,-83,3
26,RL,1,500,10,-80.8,-80,-83,3
26,RL,0,500,7,-80.8571428571429,-80,-83,3
26,RL,0,500,8,-80.375,-79,-82,3
26,RL,0,500,2,-81,-80,-82,2
26,RL,0,500,2,-80,-80,-80,0
26,RL,0,500,4,-80.5,-80,-81,1
26,RL,0,500,8,-80.125,-77,-82,5
26,RL,0,500,3,-79.6666666666667,-79,-81,2
26,RL,0,500,8,-81.25,-77,-85,8
26,RL,0,500,6,-80.6666666666667,-77,-84,7
26,RL,1,500,10,-83,-77,-90,13
26,RL,0,500,4,-82,-77,-85,8
26,RL,0,500,2,-83,-82,-84,2
26,RL,0,500,4,-83.5,-77,-88,11
26,RL,0,500,6,-86.8333333333333,-77,-99,22
26,RL,0,500,3,-85.6666666666667,-77,-90,13
26,RL,0,500,2,-83.5,-77,-90,13
26,RL,1,500,10,-86.6,-77,-99,22
26,RL,0,500,5,-83.4,-79,-87,8
26,RL,0,500,2,-82.5,-80,-85,5
26,RL,0,500,5,-88.6,-80,-97,17
26,RL,1,500,10,-86.9,-82,-97,15
26,RL,0,500,4,-89.75,-83,-97,14
26,RL,0,500,4,-89,-83,-97,14
26,RL,0,500,2,-90,-83,-97,14
26,RL,0,500,6,-84.3333333333333,-82,-87,5
26,RL,0,500,4,-84,-82,-86,4
26,RL,0,500,1,-82,-82,-82,0
26,RL,0,500,1,-86,-86,-86,0
26,RL,0,500,7,-84.5714285714286,-82,-87,5
26,RL,0,500,7,-83.2857142857143,-78,-88,10
26,RL,1,500,9,-83.2222222222222,-78,-88,10
26,RL,0,500,5,-82.8,-78,-88,10
26,RL,0,500,2,-83,-81,-85,4
26,RL,0,500,5,-83,-78,-88,10
26,RL,0,500,4,-83.5,-78,-88,10
26,RL,0,500,4,-81.75,-79,-86,7
26,RL,0,500,2,-83,-80,-86,6
26,RL,0,500,2,-82.5,-79,-86,7
26,RL,0,500,7,-81.8571428571429,-80,-86,6
26,RL,1,500,9,-83,-80,-86,6
26,RL,0,500,4,-81.75,-80,-86,6
26,RL,0,500,5,-82,-80,-86,6
26,RL,1,500,9,-82.3333333333333,-79,-86,7
26,RL,1,500,9,-83,-79,-86,7
26,RL,0,500,6,-82.6666666666667,-79,-86,7
26,RL,1,500,9,-83.1111111111111,-79,-86,7
26,RL,0,500,8,-82.75,-79,-86,7
26,RL,0,500,5,-82.6,-79,-86,7
26,RL,0,500,1,-80,-80,-80,0
26,RL,0,500,2,-82,-79,-85,6
26,RL,0,500,5,-83.8,-82,-86,4
26,RL,0,500,1,-86,-86,-86,0
26,RL,0,500,3,-82.6666666666667,-82,-84,2
26,RL,0,500,7,-83.4285714285714,-80,-89,9
26,RL,0,500,4,-84.5,-82,-89,7
26,RL,0,500,1,-83,-83,-83,0
26,RL,0,500,8,-83.75,-80,-89,9
26,RL,1,500,9,-84.7777777777778,-80,-89,9
26,RL,0,500,1,-80,-80,-80,0
26,RL,0,500,4,-83,-81,-86,5
26,RL,0,500,1,-86,-86,-86,0
26,RL,1,500,9,-85,-81,-89,8
26,RL,0,500,1,-87,-87,-87,0
26,RL,1,500,10,-83.1,-79,-89,10
26,RL,0,500,2,-86.5,-84,-89,5
26,RL,0,500,1,-84,-84,-84,0
26,RL,0,500,4,-83,-82,-85,3
26,RL,0,500,1,-83,-83,-83,0
26,RL,0,500,4,-81.5,-79,-85,6
26,RL,0,500,6,-79.8333333333333,-78,-82,4
26,RL,1,500,10,-79.7,-78,-82,4
26,RL,1,500,9,-79.6666666666667,-78,-82,4
26,RL,0,500,7,-79.8571428571429,-78,-82,4
26,RL,0,500,4,-80.25,-79,-82,3
26,RL,0,500,6,-80.5,-79,-83,4
26,RL,0,500,7,-79.7142857142857,-77,-83,6
26,RL,0,500,3,-80.3333333333333,-79,-83,4
26,RL,0,500,2,-81,-79,-83,4
26,RL,0,500,3,-80,-77,-83,6
26,RL,1,500,10,-86.3,-77,-99,22
26,RL,0,500,7,-88,-80,-99,19
26,RL,0,500,8,-88.25,-82,-99,17
26,RL,1,500,9,-87.4444444444444,-81,-99,18
26,RL,0,500,1,-92,-92,-92,0
26,RL,0,500,8,-85.5,-81,-99,18
26,RL,1,500,9,-82,-80,-84,4
26,RL,0,500,7,-82,-80,-83,3
26,RL,1,500,9,-82.7777777777778,-80,-86,6
26,RL,0,500,7,-82.5714285714286,-80,-84,4
26,RL,1,500,10,-83.4,-81,-86,5
26,RL,0,500,1,-83,-83,-83,0
26,RL,1,500,10,-83.5,-81,-86,5
26,RL,0,500,2,-82.5,-82,-83,1
26,RL,0,500,6,-83.6666666666667,-81,-86,5
26,RL,1,500,10,-83.3,-81,-86,5
26,RL,0,500,7,-83.1428571428571,-81,-86,5
26,RL,0,500,3,-82.6666666666667,-81,-86,5
26,RL,0,500,1,-86,-86,-86,0
26,RL,1,500,10,-84.3,-81,-92,11
26,RL,0,500,4,-82.5,-81,-84,3
26,RL,0,500,6,-82.6666666666667,-81,-85,4
26,RL,0,500,6,-84.1666666666667,-81,-90,9
26,RL,0,500,6,-85.5,-81,-92,11
26,RL,0,500,3,-83.3333333333333,-81,-85,4
26,RL,1,500,9,-90.1111111111111,-87,-98,11
26,RL,0,500,1,-90,-90,-90,0
26,RL,0,500,6,-89.8333333333333,-87,-98,11
26,RL,0,500,3,-88,-87,-89,2
26,RL,0,500,6,-90.5,-87,-98,11
26,RL,0,500,7,-91.5714285714286,-88,-98,10
26,RL,0,500,8,-90.875,-88,-95,7
26,RL,0,500,8,-91,-88,-95,7
26,RL,0,500,7,-90.4285714285714,-83,-95,12
26,RL,1,500,10,-89.4,-83,-95,12
26,RL,1,500,9,-89.3333333333333,-83,-95,12
26,RL,1,500,9,-88.1111111111111,-83,-95,12
26,RL,1,500,10,-87.4,-83,-95,12
26,RL,0,500,3,-87,-83,-92,9
26,RL,0,500,7,-88.2857142857143,-83,-95,12
26,RL,0,500,1,-86,-86,-86,0
26,RL,0,500,5,-88,-83,-95,12
26,RL,0,500,2,-89.5,-84,-95,11
26,RL,0,500,1,-95,-95,-95,0
26,RL,1,500,9,-84.2222222222222,-81,-89,8
26,RL,0,500,6,-85,-82,-89,7
26,RL,0,500,8,-85,-81,-89,8
26,RL,1,500,10,-85.2,-81,-90,9
26,RL,0,500,5,-84.6,-81,-89,8
26,RL,0,500,7,-85.2857142857143,-81,-90,9
26,RL,0,500,3,-86.6666666666667,-84,-89,5
26,RL,0,500,3,-87,-84,-90,6
26,RL,0,500,1,-84,-84,-84,0
26,RL,0,500,4,-84.75,-82,-90,8
26,RL,0,500,8,-82.5,-79,-87,8
26,RL,0,500,2,-83.5,-82,-85,3
26,RL,0,500,1,-83,-83,-83,0
26,RL,0,500,7,-82.4285714285714,-79,-87,8
26,RL,0,500,7,-82.8571428571429,-79,-87,8
26,RL,0,500,4,-83,-79,-87,8
26,RL,0,500,7,-84.4285714285714,-79,-90,11
26,RL,0,500,4,-83.5,-82,-85,3
26,RL,1,500,10,-83.8,-79,-90,11
26,RL,0,500,6,-85.5,-83,-90,7
26,RL,0,500,4,-86.5,-83,-90,7
26,RL,0,500,7,-84,-79,-90,11
26,RL,0,500,7,-82.8571428571429,-79,-88,9
26,RL,1,500,10,-81.6,-79,-86,7
26,RL,1,500,10,-81.4,-79,-86,7
26,RL,0,500,8,-81.125,-79,-86,7
26,RL,1,500,9,-81.2222222222222,-79,-86,7
26,RL,1,500,9,-81.4444444444444,-79,-86,7
26,RL,1,500,10,-81.3,-79,-86,7
26,RL,0,500,4,-81.5,-79,-86,7
26,RL,0,500,4,-81.75,-79,-86,7
26,RL,1,500,10,-82.3,-79,-86,7
26,RL,0,500,6,-81.5,-79,-86,7
26,RL,0,500,1,-79,-79,-79,0
26,RL,0,500,8,-82,-79,-86,7
26,RL,0,500,2,-81,-81,-81,0
26,RL,0,500,3,-81.6666666666667,-81,-83,2
26,RL,0,500,4,-83,-79,-86,7
26,RL,0,500,6,-83,-79,-86,7
26,RL,0,500,4,-82.5,-79,-86,7
26,RL,1,500,10,-82.4,-79,-85,6
26,RL,1,500,10,-82.9,-80,-85,5
26,RL,0,500,5,-82,-80,-84,4
26,RL,0,500,4,-82.5,-81,-84,3
26,RL,0,500,2,-82.5,-82,-83,1
26,RL,1,500,9,-83,-79,-86,7
26,RL,0,500,8,-83,-79,-86,7
26,RL,0,500,3,-83.6666666666667,-83,-84,1
26,RL,0,500,2,-82.5,-82,-83,1
26,RL,0,500,8,-82.75,-79,-86,7
26,RL,1,500,9,-82.8888888888889,-79,-86,7
26,RL,0,500,6,-82.5,-79,-86,7
26,RL,0,500,7,-83.1428571428571,-79,-86,7
26,RL,1,500,10,-82.9,-79,-87,8
26,RL,0,500,1,-86,-86,-86,0
26,RL,1,500,9,-82.2222222222222,-80,-87,7
26,RL,1,500,10,-81.4,-80,-87,7
26,RL,1,500,9,-80.7777777777778,-79,-82,3
26,RL,0,500,6,-80.8333333333333,-80,-82,2
26,RL,1,500,9,-81.2222222222222,-79,-83,4
26,RL,0,500,1,-81,-81,-81,0
26,RL,0,500,5,-80.8,-79,-83,4
26,RL,0,500,7,-81,-79,-83,4
26,RL,0,500,5,-81.8,-80,-83,3
26,RL,0,500,8,-81,-79,-82,3
26,RL,0,500,4,-80.5,-79,-82,3
26,RL,1,500,10,-81.1,-79,-83,4
26,RL,0,500,5,-80.8,-79,-82,3
26,RL,0,500,1,-82,-82,-82,0
26,RL,0,500,4,-81.5,-79,-83,4
26,RL,0,500,1,-82,-82,-82,0
26,RL,0,500,5,-82.2,-80,-83,3
26,RL,0,500,7,-81.5714285714286,-80,-83,3
26,RL,0,500,4,-82.5,-82,-83,1
26,RL,1,500,10,-81.3,-80,-84,4
26,RL,1,500,9,-81.1111111111111,-80,-84,4
26,RL,0,500,2,-80.5,-80,-81,1
26,RL,0,500,5,-81.4,-80,-84,4
26,RL,0,500,1,-80,-80,-80,0
26,RL,1,500,10,-81.5,-79,-85,6
26,RL,0,500,7,-81.7142857142857,-79,-85,6
26,RL,0,500,2,-81,-81,-81,0
26,RL,0,500,3,-82,-80,-85,5
26,RL,1,500,10,-82,-79,-86,7
26,RL,0,500,7,-81.4285714285714,-79,-85,6
26,RL,0,500,6,-80.8333333333333,-79,-85,6
26,RL,0,500,2,-82.5,-80,-85,5
26,RL,0,500,7,-82.4285714285714,-79,-86,7
26,RL,0,500,6,-82.8333333333333,-79,-86,7
26,RL,0,500,6,-82.5,-77,-86,9
26,RL,0,500,8,-81.875,-77,-86,9
26,RL,0,500,3,-85.3333333333333,-84,-86,2
26,RL,1,500,9,-82.1111111111111,-77,-87,10
26,RL,0,500,6,-81.3333333333333,-77,-86,9
26,RL,0,500,7,-81.2857142857143,-77,-87,10
26,RL,0,500,6,-82,-78,-87,9
26,RL,1,500,10,-81,-77,-87,10
26,RL,0,500,2,-83,-81,-85,4
26,RL,0,500,8,-81.375,-77,-87,10
26,RL,1,500,10,-80.9,-77,-87,10
26,RL,0,500,5,-79,-77,-81,4
26,RL,0,500,8,-80.25,-77,-84,7
26,RL,0,500,3,-79.3333333333333,-78,-81,3
26,RL,0,500,4,-81.5,-78,-84,6
26,RL,1,500,10,-83.7,-77,-97,20
26,RL,0,500,5,-81,-78,-84,6
26,RL,0,500,1,-82,-82,-82,0
26,RL,0,500,5,-85.8,-77,-97,20
26,RL,1,500,9,-84.7777777777778,-77,-97,20
26,RL,1,500,10,-83.6,-77,-97,20
26,RL,1,500,10,-81.8,-77,-90,13
26,RL,0,500,1,-80,-80,-80,0
26,RL,1,500,10,-81.8,-77,-90,13
26,RL,0,500,7,-80.5714285714286,-77,-89,12
26,RL,0,500,5,-81,-77,-89,12
26,RL,0,500,2,-79.5,-79,-80,1
26,RL,0,500,8,-80.875,-77,-93,16
26,RL,0,500,1,-77,-77,-77,0
26,RL,1,500,9,-83.1111111111111,-78,-94,16
26,RL,1,500,9,-83.3333333333333,-78,-94,16
26,RL,0,500,2,-80,-79,-81,2
26,RL,0,500,2,-79.5,-79,-80,1
26,RL,0,500,1,-80,-80,-80,0
26,RL,0,500,3,-89.6666666666667,-82,-94,12
26,RL,1,500,9,-83.4444444444444,-81,-94,13
26,RL,0,500,3,-85.6666666666667,-81,-94,13
26,RL,1,500,9,-82.2222222222222,-81,-84,3
26,RL,0,500,7,-82.2857142857143,-81,-84,3
26,RL,1,500,10,-84.4,-81,-98,17
26,RL,0,500,6,-83,-81,-84,3
26,RL,1,500,10,-84.3,-81,-98,17
26,RL,0,500,5,-85.6,-81,-98,17
26,RL,0,500,4,-86.75,-82,-98,16
26,RL,0,500,1,-83,-83,-83,0
26,RL,0,500,8,-86.5,-80,-99,19
26,RL,1,500,9,-85.8888888888889,-80,-99,19
26,RL,0,500,1,-83,-83,-83,0
26,RL,0,500,3,-81.6666666666667,-80,-83,3
26,RL,0,500,3,-87,-80,-99,19
26,RL,0,500,4,-86,-80,-99,19
26,RL,0,500,3,-88,-82,-99,17
26,RL,1,500,10,-81.5,-78,-93,15
26,RL,0,500,1,-81,-81,-81,0
26,RL,1,500,10,-80.7,-78,-87,9
26,RL,0,500,6,-80.1666666666667,-78,-87,9
26,RL,0,500,3,-78.6666666666667,-78,-80,2
26,RL,0,500,6,-80.8333333333333,-78,-87,9
26,RL,1,500,10,-82.4,-78,-87,9
26,RL,0,500,8,-83.125,-78,-87,9
26,RL,1,500,10,-82.9,-78,-88,10
26,RL,0,500,3,-82.6666666666667,-81,-86,5
26,RL,0,500,6,-83.3333333333333,-80,-87,7
26,RL,0,500,6,-83.5,-80,-87,7
26,RL,1,500,9,-83.6666666666667,-80,-88,8
26,RL,0,500,4,-82.5,-80,-87,7
26,RL,1,500,10,-84.2,-80,-90,10
26,RL,0,500,1,-81,-81,-81,0
26,RL,0,500,6,-85.1666666666667,-82,-90,8
26,RL,0,500,2,-82,-82,-82,0
26,RL,0,500,1,-82,-82,-82,0
26,RL,0,500,2,-88,-86,-90,4
26,RL,0,500,1,-90,-90,-90,0
26,RL,0,500,7,-86.1428571428571,-81,-94,13
26,RL,0,500,6,-86.6666666666667,-81,-94,13
26,RL,0,500,6,-86.8333333333333,-81,-94,13
26,RL,0,500,3,-85.6666666666667,-81,-94,13
26,RL,1,500,9,-85.1111111111111,-81,-91,10
26,RL,0,500,3,-86.6666666666667,-82,-89,7
26,RL,0,500,1,-89,-89,-89,0
26,RL,1,500,9,-85.5555555555556,-80,-94,14
26,RL,0,500,4,-83.75,-81,-91,10
26,RL,0,500,2,-86,-81,-91,10
26,RL,0,500,7,-85.8571428571429,-80,-94,14
26,RL,1,500,10,-85.2,-80,-94,14
26,RL,0,500,4,-85.75,-80,-92,12
26,RL,0,500,8,-84.625,-80,-92,12
26,RL,0,500,5,-83.4,-80,-92,12
26,RL,1,500,10,-83.8,-79,-92,13
26,RL,1,500,9,-82.8888888888889,-79,-92,13
26,RL,0,500,2,-81.5,-81,-82,1
26,RL,1,500,9,-84.8888888888889,-80,-94,14
26,RL,1,500,9,-84.6666666666667,-80,-94,14
26,RL,0,500,5,-84.2,-79,-92,13
26,RL,1,500,9,-84.1111111111111,-80,-92,12
26,RL,1,500,9,-84.3333333333333,-80,-92,12
26,RL,0,500,1,-79,-79,-79,0
26,RL,0,500,2,-78.5,-76,-81,5
26,LR,1,500,9,-85.1111111111111,-73,-94,21
26,LR,0,500,6,-88.1666666666667,-84,-94,10
26,LR,1,500,9,-83.1111111111111,-73,-94,21
26,LR,0,500,8,-80.25,-73,-93,20
26,LR,0,500,2,-76.5,-73,-80,7
26,LR,0,500,4,-75,-73,-76,3
26,LR,0,500,2,-75.5,-75,-76,1
26,LR,0,500,5,-79.2,-76,-85,9
26,LR,1,500,9,-81.4444444444444,-76,-87,11
26,LR,0,500,5,-81.8,-78,-87,9
26,LR,0,500,7,-83,-78,-87,9
26,LR,1,500,9,-85.4444444444444,-78,-93,15
26,LR,1,500,9,-87.3333333333333,-81,-95,14
26,LR,0,500,4,-82.75,-81,-84,3
26,LR,0,500,1,-81,-81,-81,0
26,LR,0,500,6,-88.6666666666667,-81,-95,14
26,LR,1,500,9,-89.6666666666667,-81,-95,14
26,LR,0,500,7,-88.1428571428571,-81,-95,14
26,LR,0,500,1,-92,-92,-92,0
26,LR,0,500,8,-86.75,-79,-95,16
26,LR,0,500,3,-88.6666666666667,-83,-95,12
26,LR,0,500,1,-95,-95,-95,0
26,LR,0,500,1,-83,-83,-83,0
26,LR,0,500,3,-84.3333333333333,-79,-92,13
26,LR,0,500,3,-87.6666666666667,-79,-92,13
26,LR,0,500,2,-85.5,-79,-92,13
26,LR,0,500,6,-88.8333333333333,-84,-92,8
26,LR,0,500,1,-90,-90,-90,0
26,LR,0,500,1,-89,-89,-89,0
26,LR,0,500,3,-88.3333333333333,-86,-92,6
26,LR,0,500,6,-88,-84,-95,11
26,LR,1,500,10,-88.5,-82,-100,18
26,LR,0,500,3,-88.6666666666667,-85,-95,10
26,LR,0,500,2,-90,-85,-95,10
26,LR,0,500,8,-89.75,-82,-100,18
26,LR,0,500,6,-88.8333333333333,-82,-100,18
26,LR,0,500,5,-89.8,-82,-100,18
26,LR,0,500,4,-87.25,-82,-92,10
26,LR,0,500,3,-88.3333333333333,-82,-92,10
26,LR,0,500,3,-87.6666666666667,-82,-91,9
26,LR,0,500,8,-85.875,-82,-90,8
26,LR,0,500,8,-85.875,-82,-93,11
26,LR,0,500,7,-85.5714285714286,-82,-93,11
26,LR,0,500,7,-86.2857142857143,-82,-93,11
26,LR,0,500,7,-85.4285714285714,-82,-93,11
26,LR,0,500,4,-86.5,-82,-93,11
26,LR,0,500,2,-83,-82,-84,2
26,LR,0,500,7,-85.1428571428571,-82,-89,7
26,LR,0,500,6,-84.8333333333333,-82,-89,7
26,LR,1,500,9,-88.2222222222222,-83,-97,14
26,LR,0,500,2,-86.5,-84,-89,5
26,LR,0,500,2,-86,-83,-89,6
26,LR,0,500,8,-89.25,-83,-97,14
26,LR,0,500,7,-91.7142857142857,-85,-97,12
26,LR,0,500,6,-90.8333333333333,-85,-95,10
26,LR,0,500,1,-95,-95,-95,0
26,LR,0,500,7,-89.2857142857143,-85,-94,9
26,LR,0,500,8,-89.625,-85,-94,9
26,LR,0,500,6,-89.3333333333333,-85,-94,9
26,LR,1,500,10,-91,-85,-98,13
26,LR,0,500,2,-90,-89,-91,2
26,LR,0,500,3,-88,-85,-90,5
26,LR,0,500,1,-85,-85,-85,0
26,LR,1,500,10,-90.9,-82,-98,16
26,LR,0,500,7,-92.1428571428571,-87,-98,11
26,LR,0,500,2,-92.5,-87,-98,11
26,LR,0,500,7,-90.8571428571429,-82,-98,16
26,LR,1,500,9,-88.2222222222222,-80,-98,18
26,LR,0,500,4,-89.25,-82,-98,16
26,LR,0,500,8,-87.125,-80,-98,18
26,LR,1,500,10,-86.8,-80,-96,16
26,LR,0,500,8,-87,-81,-95,14
26,LR,0,500,1,-84,-84,-84,0
26,LR,0,500,3,-92.3333333333333,-90,-95,5
26,LR,0,500,3,-88.6666666666667,-81,-95,14
26,LR,0,500,8,-87.75,-81,-95,14
26,LR,0,500,3,-88.3333333333333,-81,-94,13
26,LR,0,500,7,-88,-84,-94,10
26,LR,0,500,1,-94,-94,-94,0
26,LR,1,500,10,-88.3,-84,-98,14
26,LR,0,500,6,-88,-84,-93,9
26,LR,0,500,7,-89.2857142857143,-84,-98,14
26,LR,0,500,4,-91.25,-86,-98,12
26,LR,0,500,2,-93,-88,-98,10
26,LR,0,500,6,-89.8333333333333,-85,-99,14
26,LR,0,500,3,-85.6666666666667,-85,-86,1
26,LR,0,500,6,-87.8333333333333,-85,-99,14
26,LR,1,500,10,-87.6,-84,-99,15
26,LR,0,500,1,-85,-85,-85,0
26,LR,0,500,5,-88.6,-85,-99,14
26,LR,1,500,9,-87.3333333333333,-84,-91,7
26,LR,1,500,9,-87.4444444444444,-84,-91,7
26,LR,0,500,7,-87.8571428571429,-84,-91,7
26,LR,0,500,7,-87.8571428571429,-84,-91,7
26,LR,0,500,8,-88.375,-85,-91,6
26,LR,0,500,7,-88.2857142857143,-85,-91,6
26,LR,0,500,5,-88.6,-85,-91,6
26,LR,0,500,7,-87,-84,-91,7
26,LR,0,500,2,-88,-85,-91,6
26,LR,1,500,9,-88.2222222222222,-84,-99,15
26,LR,0,500,5,-87,-84,-89,5
26,LR,0,500,1,-86,-86,-86,0
26,LR,0,500,1,-89,-89,-89,0
26,LR,0,500,3,-87.3333333333333,-86,-88,2
26,LR,0,500,2,-87,-86,-88,2
26,LR,0,500,5,-91,-86,-99,13
26,LR,0,500,1,-99,-99,-99,0
26,LR,0,500,2,-92,-89,-95,6
26,LR,1,500,9,-92.2222222222222,-86,-100,14
26,LR,0,500,4,-93.25,-86,-100,14
26,LR,0,500,2,-98.5,-97,-100,3
26,LR,1,500,10,-91.2,-86,-101,15
26,LR,0,500,1,-90,-90,-90,0
26,LR,0,500,5,-89.6,-86,-98,12
26,LR,0,500,2,-94,-90,-98,8
26,LR,1,500,10,-90.7,-86,-101,15
26,LR,0,500,1,-87,-87,-87,0
26,LR,1,500,9,-90.7777777777778,-86,-101,15
26,LR,0,500,8,-91.375,-86,-101,15
26,LR,0,500,3,-92,-87,-101,14
26,LR,1,500,9,-89.4444444444444,-86,-99,13
26,LR,0,500,7,-89.8571428571429,-86,-99,13
26,LR,0,500,8,-89.5,-86,-99,13
26,LR,0,500,4,-89,-86,-95,9
26,LR,1,500,10,-89.4,-86,-100,14
26,LR,0,500,5,-87.4,-86,-88,2
26,LR,0,500,7,-89.2857142857143,-86,-100,14
26,LR,0,500,1,-88,-88,-88,0
26,LR,1,500,9,-90.3333333333333,-86,-100,14
26,LR,0,500,8,-88.875,-85,-98,13
26,LR,0,500,2,-87.5,-86,-89,3
26,LR,0,500,2,-87.5,-86,-89,3
26,LR,0,500,3,-92.3333333333333,-89,-98,9
26,LR,0,500,4,-90,-85,-98,13
26,LR,0,500,1,-90,-90,-90,0
26,LR,1,500,9,-87.1111111111111,-85,-91,6
26,LR,0,500,8,-87.375,-85,-91,6
26,LR,0,500,4,-87.5,-86,-91,5
26,LR,0,500,7,-88,-85,-91,6
26,LR,1,500,9,-87.7777777777778,-83,-92,9
26,LR,1,500,10,-88.1,-83,-92,9
26,LR,0,500,2,-90,-90,-90,0
26,LR,0,500,2,-89,-86,-92,6
26,LR,1,500,10,-88.2,-83,-92,9
26,LR,0,500,7,-87.1428571428571,-83,-91,8
26,LR,0,500,1,-89,-89,-89,0
26,LR,0,500,1,-85,-85,-85,0
26,LR,1,500,10,-89.9,-86,-98,12
26,LR,0,500,2,-89,-87,-91,4
26,LR,0,500,3,-88.6666666666667,-87,-92,5
26,LR,0,500,7,-90.4285714285714,-86,-98,12
26,LR,0,500,6,-91,-86,-98,12
26,LR,0,500,5,-90.8,-86,-98,12
26,LR,0,500,3,-90.3333333333333,-84,-98,14
26,LR,0,500,7,-89.7142857142857,-84,-93,9
26,LR,0,500,2,-90,-89,-91,2
26,LR,1,500,10,-92.2,-89,-96,7
26,LR,0,500,7,-92.8571428571429,-89,-96,7
26,LR,0,500,8,-92.75,-90,-96,6
26,LR,0,500,1,-90,-90,-90,0
26,LR,0,500,2,-94.5,-93,-96,3
26,LR,1,500,10,-91.2,-86,-96,10
26,LR,0,500,8,-91.25,-86,-96,10
26,LR,0,500,3,-92.3333333333333,-90,-96,6
26,LR,1,500,10,-89.7,-86,-92,6
26,LR,0,500,1,-91,-91,-91,0
26,LR,0,500,8,-89.75,-86,-92,6
26,LR,0,500,5,-88.6,-86,-92,6
26,LR,0,500,1,-86,-86,-86,0
26,LR,0,500,4,-90.75,-88,-92,4
26,LR,1,500,10,-88.6,-86,-92,6
26,LR,0,500,5,-88.6,-86,-92,6
26,LR,0,500,4,-87.75,-86,-91,5
26,LR,1,500,10,-87.7,-83,-93,10
26,LR,1,500,10,-87.5,-83,-93,10
26,LR,0,500,6,-88.5,-86,-93,7
26,LR,1,500,9,-87.5555555555556,-83,-93,10
26,LR,0,500,3,-90,-88,-93,5
26,LR,0,500,8,-87.625,-83,-93,10
26,LR,0,500,7,-87.5714285714286,-83,-93,10
26,LR,0,500,5,-86.8,-83,-91,8
26,LR,0,500,2,-85.5,-85,-86,1
26,LR,0,500,7,-89.1428571428571,-85,-98,13
26,LR,1,500,9,-89.5555555555556,-84,-98,14
26,LR,0,500,6,-88.5,-84,-98,14
26,LR,1,500,10,-89.6,-84,-98,14
26,LR,0,500,6,-89.6666666666667,-84,-98,14
26,LR,0,500,3,-89.3333333333333,-84,-98,14
26,LR,1,500,10,-90.3,-84,-98,14
26,LR,0,500,5,-91,-85,-97,12
26,LR,0,500,7,-90.8571428571429,-85,-97,12
26,LR,0,500,8,-91.5,-85,-99,14
26,LR,1,500,10,-93.4,-86,-99,13
26,LR,0,500,3,-92,-86,-96,10
26,LR,0,500,3,-93.6666666666667,-86,-99,13
26,LR,0,500,6,-94.1666666666667,-88,-99,11
26,LR,0,500,3,-94.6666666666667,-89,-99,10
26,LR,0,500,2,-92.5,-89,-96,7
26,LR,0,500,3,-93.6666666666667,-88,-97,9
26,LR,1,500,9,-91.4444444444444,-87,-97,10
26,LR,0,500,8,-91.25,-87,-97,10
26,LR,0,500,7,-90.8571428571429,-87,-97,10
26,LR,0,500,3,-88.3333333333333,-87,-90,3
26,LR,0,500,1,-90,-90,-90,0
26,LR,0,500,5,-90.8,-87,-93,6
26,LR,0,500,8,-90.125,-86,-93,7
26,LR,1,500,10,-90.1,-86,-93,7
26,LR,0,500,3,-89,-86,-91,5
26,LR,0,500,1,-86,-86,-86,0
26,LR,1,500,9,-89.5555555555556,-85,-98,13
26,LR,1,500,9,-89.2222222222222,-85,-98,13
26,LR,0,500,6,-89.6666666666667,-85,-98,13
26,LR,0,500,5,-89.6,-85,-98,13
26,LR,1,500,9,-89.3333333333333,-85,-98,13
26,LR,0,500,1,-85,-85,-85,0
26,LR,0,500,7,-89.2857142857143,-86,-92,6
26,LR,0,500,3,-91,-90,-92,2
26,LR,0,500,1,-90,-90,-90,0
26,LR,0,500,2,-86.5,-86,-87,1
26,LR,1,500,9,-88.3333333333333,-83,-94,11
26,LR,0,500,2,-89.5,-89,-90,1
26,LR,0,500,4,-88,-83,-94,11
26,LR,1,500,10,-87.5,-83,-94,11
26,LR,1,500,9,-87.6666666666667,-83,-94,11
26,LR,0,500,6,-87.5,-83,-94,11
26,LR,0,500,5,-86.8,-83,-91,8
26,LR,1,500,9,-88.8888888888889,-83,-98,15
26,LR,0,500,2,-84,-83,-85,2
26,LR,0,500,3,-88.6666666666667,-85,-91,6
26,LR,0,500,4,-91.25,-86,-98,12
26,LR,0,500,3,-91.3333333333333,-86,-98,12
26,LR,0,500,1,-98,-98,-98,0
26,LR,0,500,7,-90.2857142857143,-85,-94,9
26,LR,1,500,10,-88.8,-81,-94,13
26,LR,0,500,4,-90,-88,-93,5
26,LR,0,500,7,-88.2857142857143,-81,-94,13
26,LR,0,500,8,-88.25,-81,-94,13
26,LR,1,500,10,-88.7,-81,-99,18
26,LR,0,500,6,-87.5,-81,-94,13
26,LR,0,500,3,-84,-81,-86,5
26,LR,0,500,2,-85.5,-85,-86,1
26,LR,0,500,5,-89.6,-84,-99,15
26,LR,0,500,1,-90,-90,-90,0
26,LR,1,500,10,-89.3,-81,-99,18
26,LR,0,500,2,-91.5,-84,-99,15
26,LR,0,500,7,-88.1428571428571,-81,-97,16
26,LR,0,500,3,-91.3333333333333,-85,-97,12
26,LR,0,500,6,-88.6666666666667,-81,-97,16
26,LR,0,500,2,-89.5,-85,-94,9
26,LR,0,500,3,-86.3333333333333,-81,-94,13
26,LR,0,500,2,-82.5,-81,-84,3
26,LR,0,500,1,-84,-84,-84,0
26,LR,0,500,8,-90.25,-86,-96,10
26,LR,1,500,9,-89.5555555555556,-86,-93,7
26,LR,0,500,2,-89,-88,-90,2
26,LR,1,500,10,-89.9,-86,-94,8
26,LR,0,500,6,-90,-86,-93,7
26,LR,0,500,1,-86,-86,-86,0
26,LR,0,500,2,-91,-90,-92,2
26,LR,0,500,7,-89.4285714285714,-86,-94,8
26,LR,0,500,6,-89,-86,-94,8
26,LR,0,500,3,-90.3333333333333,-86,-94,8
26,LR,0,500,2,-90,-86,-94,8
26,LR,0,500,5,-88,-86,-94,8
26,LR,0,500,1,-86,-86,-86,0
26,LR,0,500,1,-86,-86,-86,0
26,LR,0,500,1,-88,-88,-88,0
26,LR,0,500,5,-85.4,-83,-91,8
26,LR,0,500,6,-86.1666666666667,-83,-91,8
26,LR,0,500,1,-83,-83,-83,0
26,LR,0,500,3,-86,-83,-89,6
26,LR,0,500,1,-89,-89,-89,0
26,LR,0,500,3,-86.6666666666667,-86,-87,1
26,LR,0,500,3,-86,-84,-87,3
26,LR,0,500,3,-87,-84,-91,7
26,LR,0,500,3,-89.6666666666667,-86,-95,9
26,LR,0,500,8,-89.375,-86,-95,9
26,LR,0,500,4,-87.5,-86,-89,3
26,LR,0,500,4,-87.25,-86,-88,2
26,LR,0,500,2,-86.5,-86,-87,1
26,LR,1,500,9,-88.8888888888889,-87,-94,7
26,LR,0,500,5,-89,-87,-94,7
26,LR,1,500,9,-88.2222222222222,-84,-94,10
26,LR,0,500,5,-88.6,-87,-92,5
26,LR,0,500,1,-88,-88,-88,0
26,LR,0,500,2,-90,-88,-92,4
26,LR,0,500,7,-88,-84,-94,10
26,LR,1,500,10,-85.4,-73,-94,21
26,LR,1,500,10,-84.1,-73,-94,21
26,LR,0,500,6,-88.1666666666667,-84,-94,10
26,LR,0,500,4,-87.75,-84,-94,10
26,LR,0,500,6,-83.8333333333333,-73,-93,20
26,LR,0,500,1,-84,-84,-84,0
26,LR,0,500,7,-78.7142857142857,-73,-93,20
26,LR,0,500,8,-79.5,-75,-87,12
26,LR,0,500,5,-79.2,-76,-85,9
26,LR,1,500,9,-81.4444444444444,-76,-87,11
26,LR,1,500,9,-83.3333333333333,-78,-88,10
26,LR,0,500,2,-85,-83,-87,4
26,LR,0,500,5,-83.8,-81,-88,7
26,LR,0,500,1,-81,-81,-81,0
26,LR,0,500,8,-88.5,-81,-95,14
26,LR,0,500,7,-89.1428571428571,-81,-95,14
26,LR,1,500,9,-89.6666666666667,-81,-95,14
26,LR,0,500,7,-89.4285714285714,-81,-95,14
26,LR,0,500,4,-87.75,-81,-95,14
26,LR,1,500,10,-87.7,-79,-95,16
26,LR,0,500,6,-87.1666666666667,-82,-95,13
26,LR,0,500,3,-88.6666666666667,-83,-95,12
26,LR,0,500,5,-86.2,-79,-95,16
26,LR,1,500,9,-86.8888888888889,-79,-92,13
26,LR,0,500,5,-88.8,-79,-92,13
26,LR,0,500,2,-91.5,-91,-92,1
26,LR,0,500,5,-88.2,-84,-91,7
26,LR,0,500,1,-90,-90,-90,0
26,LR,0,500,2,-86.5,-84,-89,5
26,LR,0,500,2,-89.5,-87,-92,5
26,LR,0,500,6,-89.3333333333333,-84,-100,16
26,LR,0,500,6,-89,-84,-100,16
26,LR,1,500,10,-89.3,-82,-100,18
26,LR,0,500,7,-89.7142857142857,-82,-100,18
26,LR,0,500,1,-84,-84,-84,0
26,LR,0,500,7,-89.8571428571429,-82,-100,18
26,LR,0,500,5,-87.8,-82,-92,10
26,LR,0,500,8,-87.375,-82,-92,10
26,LR,0,500,5,-87.4,-82,-91,9
26,LR,0,500,3,-87.3333333333333,-82,-90,8
26,LR,0,500,8,-87.25,-82,-93,11
26,LR,0,500,2,-87,-84,-90,6
26,LR,0,500,8,-86.125,-82,-93,11
26,LR,0,500,4,-85.25,-82,-88,6
26,LR,0,500,8,-85.75,-82,-93,11
26,LR,1,500,9,-85.7777777777778,-82,-93,11
26,LR,0,500,7,-85.8571428571429,-82,-93,11
26,LR,0,500,6,-84.6666666666667,-82,-87,5
26,LR,0,500,7,-84.8571428571429,-82,-89,7
26,LR,0,500,8,-84.75,-82,-89,7
26,LR,0,500,5,-85.6,-82,-89,7
26,LR,1,500,9,-88.2222222222222,-83,-97,14
26,LR,0,500,5,-85.2,-83,-89,6
26,LR,0,500,1,-89,-89,-89,0
26,LR,0,500,7,-88.5714285714286,-83,-97,14
26,LR,0,500,2,-91,-85,-97,12
26,LR,0,500,6,-91.3333333333333,-85,-97,12
26,LR,0,500,4,-90.25,-85,-95,10
26,LR,0,500,1,-85,-85,-85,0
26,LR,0,500,6,-90,-85,-94,9
26,LR,0,500,7,-90.1428571428571,-85,-95,10
26,LR,0,500,4,-88.75,-85,-91,6
26,LR,0,500,1,-85,-85,-85,0
26,LR,0,500,7,-91.1428571428571,-87,-98,11
26,LR,0,500,7,-91.7142857142857,-87,-98,11
26,LR,0,500,4,-93.5,-87,-98,11
26,LR,0,500,1,-94,-94,-94,0
26,LR,0,500,8,-90.375,-82,-98,16
26,LR,1,500,10,-89.3,-80,-98,18
26,LR,0,500,6,-89.6666666666667,-82,-98,16
26,LR,0,500,6,-91.1666666666667,-82,-98,16
26,LR,1,500,9,-87.1111111111111,-80,-98,18
26,LR,0,500,3,-88.6666666666667,-80,-96,16
26,LR,0,500,6,-89,-84,-95,11
26,LR,0,500,8,-89.125,-81,-95,14
26,LR,0,500,1,-87,-87,-87,0
26,LR,0,500,2,-91,-90,-92,2
26,LR,0,500,6,-88.3333333333333,-81,-95,14
26,LR,0,500,8,-87.125,-81,-94,13
26,LR,0,500,1,-90,-90,-90,0
26,LR,0,500,1,-85,-85,-85,0
26,LR,0,500,6,-88,-84,-93,9
26,LR,0,500,2,-86,-84,-88,4
26,LR,0,500,6,-89.8333333333333,-84,-98,14
26,LR,0,500,4,-92.25,-88,-98,10
26,LR,0,500,1,-93,-93,-93,0
26,LR,0,500,5,-88.6,-85,-98,13
26,LR,0,500,3,-90,-86,-98,12
26,LR,0,500,2,-86,-86,-86,0
26,LR,0,500,4,-88.75,-85,-99,14
26,LR,0,500,2,-85,-85,-85,0
26,LR,0,500,6,-88,-85,-99,14
26,LR,0,500,3,-90.3333333333333,-85,-99,14
26,LR,0,500,3,-86,-85,-87,2
26,LR,0,500,1,-85,-85,-85,0
26,LR,1,500,9,-87.4444444444444,-84,-91,7
26,LR,0,500,2,-85,-84,-86,2
26,LR,0,500,2,-86.5,-84,-89,5
26,LR,0,500,6,-88.8333333333333,-85,-91,6
26,LR,0,500,7,-86.7142857142857,-84,-91,7
26,LR,0,500,3,-87.3333333333333,-85,-91,6
26,LR,0,500,8,-87.125,-84,-91,7
26,LR,0,500,3,-86.6666666666667,-84,-91,7
26,LR,1,500,9,-88.2222222222222,-84,-99,15
26,LR,0,500,2,-85,-84,-86,2
26,LR,0,500,7,-89.2857142857143,-86,-99,13
26,LR,0,500,3,-88.3333333333333,-88,-89,1
26,LR,0,500,1,-88,-88,-88,0
26,LR,0,500,8,-92.5,-86,-100,14
26,LR,0,500,1,-86,-86,-86,0
26,LR,0,500,5,-93.8,-86,-100,14
26,LR,0,500,6,-92.8333333333333,-86,-100,14
26,LR,0,500,2,-93,-86,-100,14
26,LR,0,500,3,-95.6666666666667,-90,-100,10
26,LR,0,500,5,-92.4,-87,-98,11
26,LR,1,500,10,-90.2,-86,-101,15
26,LR,0,500,2,-88.5,-87,-90,3
26,LR,0,500,6,-91.6666666666667,-86,-101,15
26,LR,0,500,3,-90.3333333333333,-86,-98,12
26,LR,1,500,10,-90.4,-86,-101,15
26,LR,0,500,2,-87,-86,-88,2
26,LR,0,500,7,-90.8571428571429,-86,-101,15
26,LR,0,500,6,-90.3333333333333,-86,-99,13
26,LR,1,500,9,-89.2222222222222,-86,-99,13
26,LR,0,500,7,-90,-86,-99,13
26,LR,0,500,2,-91,-87,-95,8
26,LR,0,500,8,-89.875,-86,-100,14
26,LR,0,500,4,-90.5,-86,-100,14
26,LR,0,500,6,-89.8333333333333,-86,-100,14
26,LR,0,500,5,-90.2,-86,-100,14
26,LR,0,500,6,-89.8333333333333,-86,-98,12
26,LR,0,500,5,-90.4,-86,-98,12
26,LR,0,500,3,-91,-86,-98,12
26,LR,0,500,4,-90.5,-85,-98,13
26,LR,0,500,3,-91,-85,-98,13
26,LR,0,500,8,-87.125,-85,-91,6
26,LR,0,500,4,-86.25,-85,-87,2
26,LR,0,500,2,-86.5,-86,-87,1
26,LR,0,500,2,-89,-87,-91,4
26,LR,0,500,6,-88.1666666666667,-85,-91,6
26,LR,0,500,4,-87,-85,-90,5
26,LR,0,500,7,-88.1428571428571,-83,-92,9
26,LR,1,500,10,-88.1,-83,-92,9
26,LR,0,500,8,-88,-83,-92,9
26,LR,1,500,9,-87.5555555555556,-83,-92,9
26,LR,0,500,1,-92,-92,-92,0
26,LR,0,500,5,-87.2,-83,-91,8
26,LR,0,500,8,-88.75,-85,-92,7
26,LR,1,500,10,-89.9,-86,-98,12
26,LR,0,500,6,-89.5,-87,-92,5
26,LR,1,500,9,-89.3333333333333,-84,-98,14
26,LR,0,500,4,-89.75,-87,-92,5
26,LR,0,500,7,-89.5714285714286,-84,-98,14
26,LR,0,500,4,-91.5,-86,-98,12
26,LR,0,500,4,-89.5,-84,-98,14
26,LR,1,500,10,-91.2,-84,-98,14
26,LR,0,500,8,-90.75,-84,-98,14
26,LR,0,500,1,-84,-84,-84,0
26,LR,1,500,9,-92.3333333333333,-89,-96,7
26,LR,0,500,7,-93,-90,-96,6
26,LR,0,500,2,-91.5,-90,-93,3
26,LR,0,500,3,-94.3333333333333,-93,-96,3
26,LR,0,500,8,-92.5,-90,-96,6
26,LR,0,500,4,-92.75,-90,-96,6
26,LR,1,500,10,-89.7,-86,-92,6
26,LR,0,500,6,-89.5,-86,-92,6
26,LR,0,500,3,-89.6666666666667,-86,-92,6
26,LR,1,500,9,-89.4444444444444,-86,-92,6
26,LR,0,500,8,-89.25,-86,-92,6
26,LR,0,500,3,-88.6666666666667,-86,-92,6
26,LR,0,500,8,-89.25,-86,-92,6
26,LR,0,500,5,-90,-88,-92,4
26,LR,0,500,4,-90.5,-88,-92,4
26,LR,0,500,1,-92,-92,-92,0
26,LR,0,500,8,-87.875,-86,-91,5
26,LR,1,500,9,-88.2222222222222,-86,-93,7
26,LR,0,500,2,-86,-86,-86,0
26,LR,0,500,3,-87,-86,-88,2
26,LR,0,500,4,-89.5,-88,-93,5
26,LR,0,500,4,-89,-86,-93,7
26,LR,0,500,8,-87.125,-83,-92,9
26,LR,0,500,1,-89,-89,-89,0
26,LR,1,500,9,-88.1111111111111,-84,-98,14
26,LR,0,500,8,-88.5,-84,-98,14
26,LR,0,500,8,-90,-84,-98,14
26,LR,0,500,1,-85,-85,-85,0
26,LR,0,500,1,-86,-86,-86,0
26,LR,0,500,3,-89.3333333333333,-84,-98,14
26,LR,0,500,6,-92.1666666666667,-84,-98,14
26,LR,1,500,9,-90.7777777777778,-84,-98,14
26,LR,0,500,2,-92,-86,-98,12
26,LR,0,500,4,-89.5,-85,-95,10
26,LR,0,500,1,-92,-92,-92,0
26,LR,0,500,8,-93.125,-86,-99,13
26,LR,1,500,9,-93,-86,-99,13
26,LR,0,500,1,-86,-86,-86,0
26,LR,1,500,10,-93.6,-88,-99,11
26,LR,0,500,1,-99,-99,-99,0
26,LR,0,500,8,-92.625,-88,-97,9
26,LR,0,500,3,-93.6666666666667,-88,-97,9
26,LR,0,500,5,-93.6,-88,-97,9
26,LR,0,500,3,-94.3333333333333,-92,-97,5
26,LR,1,500,9,-91.4444444444444,-87,-97,10
26,LR,0,500,7,-90.8571428571429,-87,-97,10
26,LR,0,500,4,-88.75,-87,-90,3
26,LR,1,500,9,-89.7777777777778,-86,-93,7
26,LR,0,500,7,-90.5714285714286,-86,-93,7
26,LR,1,500,10,-90.1,-86,-93,7
26,LR,0,500,1,-93,-93,-93,0
26,LR,0,500,3,-89,-86,-91,5
26,LR,0,500,1,-91,-91,-91,0
26,LR,0,500,7,-89.1428571428571,-86,-93,7
26,LR,0,500,7,-89.1428571428571,-86,-93,7
26,LR,1,500,10,-89.3,-85,-98,13
26,LR,0,500,3,-91,-90,-93,3
26,LR,0,500,4,-90,-86,-93,7
26,LR,0,500,6,-88.8333333333333,-85,-98,13
26,LR,0,500,8,-89.125,-85,-98,13
26,LR,0,500,7,-90.4285714285714,-85,-98,13
26,LR,0,500,6,-90.8333333333333,-85,-98,13
26,LR,1,500,10,-88.9,-85,-92,7
26,LR,0,500,5,-90.4,-87,-92,5
26,LR,0,500,4,-91.25,-90,-92,2
26,LR,0,500,2,-91.5,-91,-92,1
26,LR,0,500,7,-89,-86,-91,5
26,LR,0,500,4,-88,-86,-90,4
26,LR,0,500,1,-86,-86,-86,0
26,LR,0,500,5,-88.8,-86,-90,4
26,LR,0,500,1,-89,-89,-89,0
26,LR,0,500,5,-88.4,-83,-94,11
26,LR,0,500,8,-87.25,-83,-94,11
26,LR,0,500,7,-87,-83,-94,11
26,LR,0,500,2,-88.5,-83,-94,11
26,LR,0,500,4,-89.25,-86,-94,8
26,LR,0,500,4,-86.5,-83,-89,6
26,LR,0,500,4,-85.75,-83,-89,6
26,LR,1,500,10,-88.8,-83,-98,15
26,LR,0,500,5,-89.4,-83,-98,15
26,LR,0,500,8,-89.5,-85,-98,13
26,LR,0,500,5,-90,-85,-98,13
26,LR,0,500,4,-89.75,-85,-98,13
26,LR,1,500,10,-89.7,-81,-98,17
26,LR,0,500,8,-89.25,-81,-94,13
26,LR,1,500,9,-88.3333333333333,-81,-94,13
26,LR,0,500,7,-88,-81,-94,13
26,LR,0,500,6,-88,-81,-94,13
26,LR,0,500,1,-94,-94,-94,0
26,LR,1,500,9,-88,-81,-99,18
26,LR,1,500,10,-89.3,-84,-99,15
26,LR,0,500,2,-87,-85,-89,4
26,LR,1,500,9,-90.6666666666667,-84,-99,15
26,LR,0,500,6,-91.3333333333333,-84,-99,15
26,LR,1,500,9,-89.6666666666667,-81,-99,18
26,LR,0,500,3,-91,-84,-97,13
26,LR,1,500,10,-89.8,-81,-97,16
26,LR,1,500,10,-89.6,-81,-97,16
26,LR,0,500,4,-86,-81,-94,13
26,LR,0,500,1,-94,-94,-94,0
26,LR,0,500,7,-88.5714285714286,-81,-96,15
26,LR,0,500,6,-89.8333333333333,-84,-96,12
26,LR,0,500,2,-93.5,-91,-96,5
26,LR,1,500,10,-90.1,-86,-96,10
26,LR,0,500,1,-90,-90,-90,0
26,LR,0,500,7,-89,-86,-93,7
26,LR,0,500,5,-89,-86,-93,7
26,LR,1,500,9,-89.4444444444444,-86,-93,7
26,LR,0,500,8,-89.625,-86,-93,7
26,LR,1,500,10,-87.8,-85,-94,9
26,LR,0,500,2,-90,-86,-94,8
26,LR,0,500,8,-86.25,-83,-91,8
26,LR,1,500,9,-86.2222222222222,-83,-91,8
26,LR,0,500,3,-86.3333333333333,-85,-88,3
26,LR,0,500,8,-86.25,-83,-91,8
26,LR,0,500,5,-85.4,-83,-91,8
26,LR,0,500,3,-86.3333333333333,-83,-91,8
26,LR,0,500,6,-86.5,-83,-91,8
26,LR,0,500,6,-85.8333333333333,-83,-89,6
26,LR,0,500,6,-86,-83,-89,6
26,LR,0,500,7,-87.1428571428571,-84,-91,7
26,LR,0,500,5,-87,-84,-91,7
26,LR,1,500,9,-88.3333333333333,-84,-95,11
26,LR,0,500,4,-87,-84,-91,7
26,LR,0,500,5,-88.8,-84,-95,11
26,LR,0,500,4,-90,-86,-95,9
26,LR,0,500,7,-88.4285714285714,-86,-95,9
26,LR,1,500,9,-89.1111111111111,-86,-95,9
26,LR,0,500,1,-86,-86,-86,0
26,LR,1,500,10,-88.2,-84,-95,11
26,LR,0,500,6,-88.6666666666667,-86,-94,8
26,LR,0,500,3,-87.6666666666667,-87,-88,1
26,LR,0,500,2,-87.5,-87,-88,1
26,LR,0,500,2,-88,-88,-88,0
26,LR,0,500,2,-88,-88,-88,0
26,LR,0,500,3,-89.3333333333333,-88,-92,4
